Município,Cód. IBGE,UF,Região,Fabricante,Doses Aplicadas,Dose 1,Dose 2
Abadia De Goiás,520005,GO,Centro-Oeste,BUTANTAN/SINOVAC,2557,1295,1262
Abadia De Goiás,520005,GO,Centro-Oeste,FIOCRUZ/ASTRAZENECA,2077,1971,106
Abadia Dos Dourados,310010,MG,Sudeste,FIOCRUZ/ASTRAZENECA,1642,1531,111
Abadia Dos Dourados,310010,MG,Sudeste,BUTANTAN/SINOVAC,1532,781,751
Abadia Dos Dourados,310010,MG,Sudeste,PFIZER/BIONTECH,107,107,0
Abadiânia,520010,GO,Centro-Oeste,FIOCRUZ/ASTRAZENECA,5233,4991,242
Abadiânia,520010,GO,Centro-Oeste,BUTANTAN/SINOVAC,3300,1756,1544
Abadiânia,520010,GO,Centro-Oeste,PFIZER/BIONTECH,308,308,0
Abaeté,310020,MG,Sudeste,BUTANTAN/SINOVAC,5428,2752,2676
Abaeté,310020,MG,Sudeste,FIOCRUZ/ASTRAZENECA,5152,4623,529
Abaeté,310020,MG,Sudeste,PFIZER/BIONTECH,294,294,0
Abaetetuba,150010,PA,Norte,FIOCRUZ/ASTRAZENECA,42668,34760,7908
Abaetetuba,150010,PA,Norte,BUTANTAN/SINOVAC,16049,9173,6876
Abaiara,230010,CE,Nordeste,BUTANTAN/SINOVAC,979,769,210
Abaiara,230010,CE,Nordeste,FIOCRUZ/ASTRAZENECA,224,223,1
Abaíra,290010,BA,Nordeste,FIOCRUZ/ASTRAZENECA,3910,3398,512
Abaíra,290010,BA,Nordeste,BUTANTAN/SINOVAC,2902,1469,1433
Abaíra,290010,BA,Nordeste,PFIZER/BIONTECH,100,100,0
Abaré,290020,BA,Nordeste,BUTANTAN/SINOVAC,4780,2424,2356
Abaré,290020,BA,Nordeste,FIOCRUZ/ASTRAZENECA,3581,3199,382
Abaré,290020,BA,Nordeste,PFIZER/BIONTECH,337,335,2
Abatiá,410010,PR,Sul,FIOCRUZ/ASTRAZENECA,2443,2329,114
Abatiá,410010,PR,Sul,BUTANTAN/SINOVAC,1936,991,945
Abdon Batista,420005,SC,Sul,FIOCRUZ/ASTRAZENECA,950,806,144
Abdon Batista,420005,SC,Sul,BUTANTAN/SINOVAC,771,393,378
Abdon Batista,420005,SC,Sul,PFIZER/BIONTECH,148,148,0
Abel Figueiredo,150013,PA,Norte,FIOCRUZ/ASTRAZENECA,1219,1137,82
Abel Figueiredo,150013,PA,Norte,BUTANTAN/SINOVAC,383,197,186
Abelardo Luz,420010,SC,Sul,FIOCRUZ/ASTRAZENECA,3459,3191,268
Abelardo Luz,420010,SC,Sul,BUTANTAN/SINOVAC,3005,1596,1409
Abelardo Luz,420010,SC,Sul,PFIZER/BIONTECH,171,171,0
Abre Campo,310030,MG,Sudeste,FIOCRUZ/ASTRAZENECA,3050,2689,361
Abre Campo,310030,MG,Sudeste,BUTANTAN/SINOVAC,2874,1449,1425
Abre Campo,310030,MG,Sudeste,PFIZER/BIONTECH,318,318,0
Abreu E Lima,260005,PE,Nordeste,BUTANTAN/SINOVAC,14611,7640,6971
Abreu E Lima,260005,PE,Nordeste,FIOCRUZ/ASTRAZENECA,9064,8213,851
Abreu E Lima,260005,PE,Nordeste,PFIZER/BIONTECH,151,151,0
Abreulândia,170025,TO,Norte,FIOCRUZ/ASTRAZENECA,640,614,26
Abreulândia,170025,TO,Norte,BUTANTAN/SINOVAC,462,254,208
Acaiaca,310040,MG,Sudeste,FIOCRUZ/ASTRAZENECA,1176,1108,68
Acaiaca,310040,MG,Sudeste,BUTANTAN/SINOVAC,1038,532,506
Acaiaca,310040,MG,Sudeste,PFIZER/BIONTECH,28,28,0
Açailândia,210005,MA,Nordeste,FIOCRUZ/ASTRAZENECA,22850,22005,845
Açailândia,210005,MA,Nordeste,BUTANTAN/SINOVAC,11453,6164,5289
Açailândia,210005,MA,Nordeste,PFIZER/BIONTECH,265,265,0
Acajutiba,290030,BA,Nordeste,BUTANTAN/SINOVAC,1167,501,666
Acajutiba,290030,BA,Nordeste,FIOCRUZ/ASTRAZENECA,975,839,136
Acajutiba,290030,BA,Nordeste,PFIZER/BIONTECH,22,22,0
Acará,150020,PA,Norte,FIOCRUZ/ASTRAZENECA,5121,4850,271
Acará,150020,PA,Norte,BUTANTAN/SINOVAC,4547,3088,1459
Acarape,230015,CE,Nordeste,BUTANTAN/SINOVAC,2222,1194,1028
Acarape,230015,CE,Nordeste,FIOCRUZ/ASTRAZENECA,492,280,212
Acaraú,230020,CE,Nordeste,BUTANTAN/SINOVAC,8112,4206,3906
Acaraú,230020,CE,Nordeste,FIOCRUZ/ASTRAZENECA,1521,999,522
Acaraú,230020,CE,Nordeste,PFIZER/BIONTECH,1,1,0
Acari,240010,RN,Nordeste,BUTANTAN/SINOVAC,2483,1270,1213
Acari,240010,RN,Nordeste,FIOCRUZ/ASTRAZENECA,1807,1694,113
Acari,240010,RN,Nordeste,PFIZER/BIONTECH,182,182,0
Acauã,220005,PI,Nordeste,FIOCRUZ/ASTRAZENECA,1626,1420,206
Acauã,220005,PI,Nordeste,BUTANTAN/SINOVAC,1029,538,491
Acauã,220005,PI,Nordeste,PFIZER/BIONTECH,19,19,0
Aceguá,430003,RS,Sul,FIOCRUZ/ASTRAZENECA,1637,1494,143
Aceguá,430003,RS,Sul,BUTANTAN/SINOVAC,1346,647,699
Aceguá,430003,RS,Sul,PFIZER/BIONTECH,243,243,0
Acopiara,230030,CE,Nordeste,BUTANTAN/SINOVAC,8015,4267,3748
Acopiara,230030,CE,Nordeste,FIOCRUZ/ASTRAZENECA,2972,2480,492
Acorizal,510010,MT,Centro-Oeste,BUTANTAN/SINOVAC,1308,660,648
Acorizal,510010,MT,Centro-Oeste,FIOCRUZ/ASTRAZENECA,1254,1196,58
Acrelândia,120001,AC,Norte,FIOCRUZ/ASTRAZENECA,3163,2955,208
Acrelândia,120001,AC,Norte,BUTANTAN/SINOVAC,1213,636,577
Acrelândia,120001,AC,Norte,PFIZER/BIONTECH,161,161,0
Acreúna,520013,GO,Centro-Oeste,FIOCRUZ/ASTRAZENECA,4839,4589,250
Acreúna,520013,GO,Centro-Oeste,BUTANTAN/SINOVAC,3524,1872,1652
Acreúna,520013,GO,Centro-Oeste,PFIZER/BIONTECH,37,37,0
Açu,240020,RN,Nordeste,FIOCRUZ/ASTRAZENECA,10930,10040,890
Açu,240020,RN,Nordeste,BUTANTAN/SINOVAC,8614,4516,4098
Açu,240020,RN,Nordeste,PFIZER/BIONTECH,1675,1669,6
Açucena,310050,MG,Sudeste,BUTANTAN/SINOVAC,2096,1130,966
Açucena,310050,MG,Sudeste,FIOCRUZ/ASTRAZENECA,1986,1817,169
Açucena,310050,MG,Sudeste,PFIZER/BIONTECH,157,157,0
Adamantina,350010,SP,Sudeste,BUTANTAN/SINOVAC,10662,5742,4920
Adamantina,350010,SP,Sudeste,FIOCRUZ/ASTRAZENECA,8893,8148,745
Adamantina,350010,SP,Sudeste,PFIZER/BIONTECH,423,423,0
Adelândia,520015,GO,Centro-Oeste,FIOCRUZ/ASTRAZENECA,596,561,35
Adelândia,520015,GO,Centro-Oeste,BUTANTAN/SINOVAC,467,257,210
Adolfo,350020,SP,Sudeste,BUTANTAN/SINOVAC,1335,780,555
Adolfo,350020,SP,Sudeste,FIOCRUZ/ASTRAZENECA,1097,989,108
Adolfo,350020,SP,Sudeste,PFIZER/BIONTECH,79,79,0
Adrianópolis,410020,PR,Sul,FIOCRUZ/ASTRAZENECA,1861,1778,83
Adrianópolis,410020,PR,Sul,BUTANTAN/SINOVAC,1571,818,753
Adustina,290035,BA,Nordeste,FIOCRUZ/ASTRAZENECA,4701,4205,496
Adustina,290035,BA,Nordeste,BUTANTAN/SINOVAC,3096,1606,1490
Adustina,290035,BA,Nordeste,PFIZER/BIONTECH,171,171,0
Afogados Da Ingazeira,260010,PE,Nordeste,BUTANTAN/SINOVAC,8777,4865,3912
Afogados Da Ingazeira,260010,PE,Nordeste,FIOCRUZ/ASTRAZENECA,6938,6378,560
Afogados Da Ingazeira,260010,PE,Nordeste,PFIZER/BIONTECH,770,768,2
Afonso Bezerra,240030,RN,Nordeste,FIOCRUZ/ASTRAZENECA,1578,1526,52
Afonso Bezerra,240030,RN,Nordeste,BUTANTAN/SINOVAC,1416,722,694
Afonso Bezerra,240030,RN,Nordeste,PFIZER/BIONTECH,79,79,0
Afonso Cláudio,320010,ES,Sudeste,BUTANTAN/SINOVAC,9014,4921,4093
Afonso Cláudio,320010,ES,Sudeste,FIOCRUZ/ASTRAZENECA,7725,7395,330
Afonso Cláudio,320010,ES,Sudeste,PFIZER/BIONTECH,1275,1275,0
Afonso Cunha,210010,MA,Nordeste,FIOCRUZ/ASTRAZENECA,1388,1290,98
Afonso Cunha,210010,MA,Nordeste,BUTANTAN/SINOVAC,1314,947,367
Afrânio,260020,PE,Nordeste,FIOCRUZ/ASTRAZENECA,4958,4634,324
Afrânio,260020,PE,Nordeste,BUTANTAN/SINOVAC,3266,1645,1621
Afrânio,260020,PE,Nordeste,PFIZER/BIONTECH,508,508,0
Afuá,150030,PA,Norte,FIOCRUZ/ASTRAZENECA,6240,6018,222
Afuá,150030,PA,Norte,BUTANTAN/SINOVAC,1904,992,912
Agrestina,260030,PE,Nordeste,BUTANTAN/SINOVAC,3750,2085,1665
Agrestina,260030,PE,Nordeste,FIOCRUZ/ASTRAZENECA,2446,2282,164
Agrestina,260030,PE,Nordeste,PFIZER/BIONTECH,98,98,0
Agricolândia,220010,PI,Nordeste,BUTANTAN/SINOVAC,1110,649,461
Agricolândia,220010,PI,Nordeste,FIOCRUZ/ASTRAZENECA,922,834,88
Agrolândia,420020,SC,Sul,FIOCRUZ/ASTRAZENECA,2062,1899,163
Agrolândia,420020,SC,Sul,BUTANTAN/SINOVAC,2024,1076,948
Agrolândia,420020,SC,Sul,PFIZER/BIONTECH,349,349,0
Agronômica,420030,SC,Sul,FIOCRUZ/ASTRAZENECA,1204,1127,77
Agronômica,420030,SC,Sul,BUTANTAN/SINOVAC,1071,564,507
Agronômica,420030,SC,Sul,PFIZER/BIONTECH,119,119,0
Água Azul Do Norte,150034,PA,Norte,FIOCRUZ/ASTRAZENECA,2689,1901,788
Água Azul Do Norte,150034,PA,Norte,BUTANTAN/SINOVAC,1881,1015,866
Água Boa,310060,MG,Sudeste,BUTANTAN/SINOVAC,2208,1123,1085
Água Boa,310060,MG,Sudeste,FIOCRUZ/ASTRAZENECA,2006,1824,182
Água Boa,310060,MG,Sudeste,PFIZER/BIONTECH,80,80,0
Água Boa,510020,MT,Centro-Oeste,BUTANTAN/SINOVAC,6246,3325,2921
Água Boa,510020,MT,Centro-Oeste,FIOCRUZ/ASTRAZENECA,3929,3570,359
Água Boa,510020,MT,Centro-Oeste,PFIZER/BIONTECH,360,360,0
Água Branca,220020,PI,Nordeste,FIOCRUZ/ASTRAZENECA,3909,3633,276
Água Branca,220020,PI,Nordeste,BUTANTAN/SINOVAC,3731,1942,1789
Água Branca,220020,PI,Nordeste,PFIZER/BIONTECH,225,225,0
Água Branca,250010,PB,Nordeste,BUTANTAN/SINOVAC,2065,1055,1010
Água Branca,250010,PB,Nordeste,FIOCRUZ/ASTRAZENECA,1659,1511,148
Água Branca,250010,PB,Nordeste,PFIZER/BIONTECH,167,167,0
Água Branca,270010,AL,Nordeste,BUTANTAN/SINOVAC,4172,2110,2062
Água Branca,270010,AL,Nordeste,FIOCRUZ/ASTRAZENECA,3922,3478,444
Água Clara,500020,MS,Centro-Oeste,FIOCRUZ/ASTRAZENECA,2747,2629,118
Água Clara,500020,MS,Centro-Oeste,BUTANTAN/SINOVAC,2105,1114,991
Água Clara,500020,MS,Centro-Oeste,PFIZER/BIONTECH,380,380,0
Água Comprida,310070,MG,Sudeste,BUTANTAN/SINOVAC,696,355,341
Água Comprida,310070,MG,Sudeste,FIOCRUZ/ASTRAZENECA,581,521,60
Água Comprida,310070,MG,Sudeste,PFIZER/BIONTECH,29,29,0
Água Doce,420040,SC,Sul,FIOCRUZ/ASTRAZENECA,1938,1713,225
Água Doce,420040,SC,Sul,BUTANTAN/SINOVAC,1868,1099,769
Água Doce,420040,SC,Sul,PFIZER/BIONTECH,167,167,0
Água Doce Do Maranhão,210015,MA,Nordeste,FIOCRUZ/ASTRAZENECA,2044,1822,222
Água Doce Do Maranhão,210015,MA,Nordeste,BUTANTAN/SINOVAC,2002,1050,952
Água Doce Do Norte,320016,ES,Sudeste,BUTANTAN/SINOVAC,3068,1739,1329
Água Doce Do Norte,320016,ES,Sudeste,FIOCRUZ/ASTRAZENECA,2083,1962,121
Água Doce Do Norte,320016,ES,Sudeste,PFIZER/BIONTECH,452,452,0
Água Fria,290040,BA,Nordeste,BUTANTAN/SINOVAC,2753,1699,1054
Água Fria,290040,BA,Nordeste,FIOCRUZ/ASTRAZENECA,1057,1051,6
Água Fria,290040,BA,Nordeste,PFIZER/BIONTECH,149,149,0
Água Fria De Goiás,520017,GO,Centro-Oeste,FIOCRUZ/ASTRAZENECA,1571,1375,196
Água Fria De Goiás,520017,GO,Centro-Oeste,BUTANTAN/SINOVAC,525,295,230
Água Fria De Goiás,520017,GO,Centro-Oeste,PFIZER/BIONTECH,78,78,0
Água Limpa,520020,GO,Centro-Oeste,FIOCRUZ/ASTRAZENECA,771,707,64
Água Limpa,520020,GO,Centro-Oeste,BUTANTAN/SINOVAC,598,306,292
Água Nova,240040,RN,Nordeste,BUTANTAN/SINOVAC,870,443,427
Água Nova,240040,RN,Nordeste,FIOCRUZ/ASTRAZENECA,640,610,30
Água Nova,240040,RN,Nordeste,PFIZER/BIONTECH,124,124,0
Água Preta,260040,PE,Nordeste,FIOCRUZ/ASTRAZENECA,3927,3706,221
Água Preta,260040,PE,Nordeste,BUTANTAN/SINOVAC,3485,1889,1596
Água Preta,260040,PE,Nordeste,PFIZER/BIONTECH,184,184,0
Água Santa,430005,RS,Sul,BUTANTAN/SINOVAC,1081,602,479
Água Santa,430005,RS,Sul,FIOCRUZ/ASTRAZENECA,982,923,59
Água Santa,430005,RS,Sul,PFIZER/BIONTECH,146,146,0
Aguaí,350030,SP,Sudeste,FIOCRUZ/ASTRAZENECA,6540,6002,538
Aguaí,350030,SP,Sudeste,BUTANTAN/SINOVAC,6416,3273,3143
Aguaí,350030,SP,Sudeste,PFIZER/BIONTECH,426,426,0
Aguanil,310080,MG,Sudeste,BUTANTAN/SINOVAC,1367,697,670
Aguanil,310080,MG,Sudeste,FIOCRUZ/ASTRAZENECA,1267,1145,122
Aguanil,310080,MG,Sudeste,PFIZER/BIONTECH,21,20,1
Águas Belas,260050,PE,Nordeste,FIOCRUZ/ASTRAZENECA,12079,11021,1058
Águas Belas,260050,PE,Nordeste,BUTANTAN/SINOVAC,11532,5883,5649
Águas Belas,260050,PE,Nordeste,PFIZER/BIONTECH,1126,1126,0
Águas Da Prata,350040,SP,Sudeste,BUTANTAN/SINOVAC,2275,1180,1095
Águas Da Prata,350040,SP,Sudeste,FIOCRUZ/ASTRAZENECA,2197,1930,267
Águas Da Prata,350040,SP,Sudeste,PFIZER/BIONTECH,181,181,0
Águas De Chapecó,420050,SC,Sul,FIOCRUZ/ASTRAZENECA,1539,1393,146
Águas De Chapecó,420050,SC,Sul,BUTANTAN/SINOVAC,1176,645,531
Águas De Lindóia,350050,SP,Sudeste,BUTANTAN/SINOVAC,4938,2501,2437
Águas De Lindóia,350050,SP,Sudeste,FIOCRUZ/ASTRAZENECA,4539,4094,445
Águas De Lindóia,350050,SP,Sudeste,PFIZER/BIONTECH,112,112,0
Águas De Santa Bárbara,350055,SP,Sudeste,BUTANTAN/SINOVAC,1570,880,690
Águas De Santa Bárbara,350055,SP,Sudeste,FIOCRUZ/ASTRAZENECA,1493,1384,109
Águas De Santa Bárbara,350055,SP,Sudeste,PFIZER/BIONTECH,85,85,0
Águas De São Pedro,350060,SP,Sudeste,BUTANTAN/SINOVAC,1719,863,856
Águas De São Pedro,350060,SP,Sudeste,FIOCRUZ/ASTRAZENECA,1073,931,142
Águas De São Pedro,350060,SP,Sudeste,PFIZER/BIONTECH,136,136,0
Águas Formosas,310090,MG,Sudeste,BUTANTAN/SINOVAC,1890,1034,856
Águas Formosas,310090,MG,Sudeste,FIOCRUZ/ASTRAZENECA,529,527,2
Águas Frias,420055,SC,Sul,BUTANTAN/SINOVAC,802,435,367
Águas Frias,420055,SC,Sul,FIOCRUZ/ASTRAZENECA,705,653,52
Águas Frias,420055,SC,Sul,PFIZER/BIONTECH,30,30,0
Águas Lindas De Goiás,520025,GO,Centro-Oeste,FIOCRUZ/ASTRAZENECA,23119,21036,2083
Águas Lindas De Goiás,520025,GO,Centro-Oeste,BUTANTAN/SINOVAC,17960,9758,8202
Águas Mornas,420060,SC,Sul,FIOCRUZ/ASTRAZENECA,1806,1696,110
Águas Mornas,420060,SC,Sul,BUTANTAN/SINOVAC,1649,858,791
Águas Mornas,420060,SC,Sul,PFIZER/BIONTECH,103,103,0
Águas Vermelhas,310100,MG,Sudeste,BUTANTAN/SINOVAC,2553,1324,1229
Águas Vermelhas,310100,MG,Sudeste,FIOCRUZ/ASTRAZENECA,2363,2114,249
Águas Vermelhas,310100,MG,Sudeste,PFIZER/BIONTECH,142,142,0
Agudo,430010,RS,Sul,BUTANTAN/SINOVAC,4077,2061,2016
Agudo,430010,RS,Sul,FIOCRUZ/ASTRAZENECA,3938,3632,306
Agudo,430010,RS,Sul,PFIZER/BIONTECH,366,364,2
Agudos,350070,SP,Sudeste,BUTANTAN/SINOVAC,8834,4738,4096
Agudos,350070,SP,Sudeste,FIOCRUZ/ASTRAZENECA,8613,7913,700
Agudos,350070,SP,Sudeste,PFIZER/BIONTECH,461,461,0
Agudos Do Sul,410030,PR,Sul,FIOCRUZ/ASTRAZENECA,2861,2785,76
Agudos Do Sul,410030,PR,Sul,BUTANTAN/SINOVAC,1851,1045,806
Águia Branca,320013,ES,Sudeste,BUTANTAN/SINOVAC,2486,1398,1088
Águia Branca,320013,ES,Sudeste,FIOCRUZ/ASTRAZENECA,2004,1923,81
Águia Branca,320013,ES,Sudeste,PFIZER/BIONTECH,362,362,0
Aguiar,250020,PB,Nordeste,BUTANTAN/SINOVAC,1563,822,741
Aguiar,250020,PB,Nordeste,FIOCRUZ/ASTRAZENECA,1258,1121,137
Aguiar,250020,PB,Nordeste,PFIZER/BIONTECH,82,82,0
Aguiarnópolis,170030,TO,Norte,FIOCRUZ/ASTRAZENECA,765,725,40
Aguiarnópolis,170030,TO,Norte,BUTANTAN/SINOVAC,720,376,344
Aimorés,310110,MG,Sudeste,BUTANTAN/SINOVAC,3150,1477,1673
Aimorés,310110,MG,Sudeste,FIOCRUZ/ASTRAZENECA,1022,1018,4
Aimorés,310110,MG,Sudeste,PFIZER/BIONTECH,2,2,0
Aiquara,290060,BA,Nordeste,BUTANTAN/SINOVAC,1189,613,576
Aiquara,290060,BA,Nordeste,FIOCRUZ/ASTRAZENECA,1107,989,118
Aiquara,290060,BA,Nordeste,PFIZER/BIONTECH,117,117,0
Aiuaba,230040,CE,Nordeste,BUTANTAN/SINOVAC,2915,1541,1374
Aiuaba,230040,CE,Nordeste,FIOCRUZ/ASTRAZENECA,1481,1185,296
Aiuruoca,310120,MG,Sudeste,BUTANTAN/SINOVAC,2161,1147,1014
Aiuruoca,310120,MG,Sudeste,FIOCRUZ/ASTRAZENECA,1620,1504,116
Aiuruoca,310120,MG,Sudeste,PFIZER/BIONTECH,51,51,0
Ajuricaba,430020,RS,Sul,BUTANTAN/SINOVAC,2264,1151,1113
Ajuricaba,430020,RS,Sul,FIOCRUZ/ASTRAZENECA,1712,1539,173
Ajuricaba,430020,RS,Sul,PFIZER/BIONTECH,260,260,0
Alagoa,310130,MG,Sudeste,FIOCRUZ/ASTRAZENECA,880,805,75
Alagoa,310130,MG,Sudeste,BUTANTAN/SINOVAC,731,378,353
Alagoa,310130,MG,Sudeste,PFIZER/BIONTECH,40,40,0
Alagoa Grande,250030,PB,Nordeste,BUTANTAN/SINOVAC,8248,4330,3918
Alagoa Grande,250030,PB,Nordeste,FIOCRUZ/ASTRAZENECA,4487,4136,351
Alagoa Grande,250030,PB,Nordeste,PFIZER/BIONTECH,383,383,0
Alagoa Nova,250040,PB,Nordeste,BUTANTAN/SINOVAC,4483,2253,2230
Alagoa Nova,250040,PB,Nordeste,FIOCRUZ/ASTRAZENECA,2683,2438,245
Alagoa Nova,250040,PB,Nordeste,PFIZER/BIONTECH,69,69,0
Alagoinha,250050,PB,Nordeste,BUTANTAN/SINOVAC,2727,1356,1371
Alagoinha,250050,PB,Nordeste,FIOCRUZ/ASTRAZENECA,2241,2012,229
Alagoinha,250050,PB,Nordeste,PFIZER/BIONTECH,270,270,0
Alagoinha,260060,PE,Nordeste,FIOCRUZ/ASTRAZENECA,5387,4730,657
Alagoinha,260060,PE,Nordeste,BUTANTAN/SINOVAC,2683,1362,1321
Alagoinha,260060,PE,Nordeste,PFIZER/BIONTECH,92,92,0
Alagoinha Do Piauí,220025,PI,Nordeste,BUTANTAN/SINOVAC,1450,738,712
Alagoinha Do Piauí,220025,PI,Nordeste,FIOCRUZ/ASTRAZENECA,1270,1152,118
Alagoinhas,290070,BA,Nordeste,BUTANTAN/SINOVAC,26307,13470,12837
Alagoinhas,290070,BA,Nordeste,FIOCRUZ/ASTRAZENECA,21007,18943,2064
Alagoinhas,290070,BA,Nordeste,PFIZER/BIONTECH,6218,6216,2
Alambari,350075,SP,Sudeste,BUTANTAN/SINOVAC,1285,622,663
Alambari,350075,SP,Sudeste,FIOCRUZ/ASTRAZENECA,1017,915,102
Alambari,350075,SP,Sudeste,PFIZER/BIONTECH,52,52,0
Albertina,310140,MG,Sudeste,FIOCRUZ/ASTRAZENECA,795,762,33
Albertina,310140,MG,Sudeste,BUTANTAN/SINOVAC,780,408,372
Albertina,310140,MG,Sudeste,PFIZER/BIONTECH,41,41,0
Alcântara,210020,MA,Nordeste,FIOCRUZ/ASTRAZENECA,19936,12874,7062
Alcântara,210020,MA,Nordeste,BUTANTAN/SINOVAC,2250,1496,754
Alcântaras,230050,CE,Nordeste,BUTANTAN/SINOVAC,2176,1149,1027
Alcântaras,230050,CE,Nordeste,FIOCRUZ/ASTRAZENECA,947,780,167
Alcantil,250053,PB,Nordeste,BUTANTAN/SINOVAC,1425,727,698
Alcantil,250053,PB,Nordeste,FIOCRUZ/ASTRAZENECA,913,814,99
Alcantil,250053,PB,Nordeste,PFIZER/BIONTECH,48,48,0
Alcinópolis,500025,MS,Centro-Oeste,FIOCRUZ/ASTRAZENECA,1061,920,141
Alcinópolis,500025,MS,Centro-Oeste,BUTANTAN/SINOVAC,1024,515,509
Alcinópolis,500025,MS,Centro-Oeste,PFIZER/BIONTECH,130,130,0
Alcobaça,290080,BA,Nordeste,BUTANTAN/SINOVAC,3617,2497,1120
Alcobaça,290080,BA,Nordeste,FIOCRUZ/ASTRAZENECA,1143,1086,57
Aldeias Altas,210030,MA,Nordeste,BUTANTAN/SINOVAC,3256,1693,1563
Aldeias Altas,210030,MA,Nordeste,FIOCRUZ/ASTRAZENECA,2512,2315,197
Alecrim,430030,RS,Sul,BUTANTAN/SINOVAC,2450,1243,1207
Alecrim,430030,RS,Sul,FIOCRUZ/ASTRAZENECA,1798,1643,155
Alecrim,430030,RS,Sul,PFIZER/BIONTECH,158,158,0
Alegre,320020,ES,Sudeste,BUTANTAN/SINOVAC,9446,5003,4443
Alegre,320020,ES,Sudeste,FIOCRUZ/ASTRAZENECA,6564,6187,377
Alegre,320020,ES,Sudeste,PFIZER/BIONTECH,1194,1194,0
Alegrete,430040,RS,Sul,BUTANTAN/SINOVAC,21026,10739,10287
Alegrete,430040,RS,Sul,FIOCRUZ/ASTRAZENECA,18454,16843,1611
Alegrete,430040,RS,Sul,PFIZER/BIONTECH,1552,1547,5
Alegrete Do Piauí,220027,PI,Nordeste,BUTANTAN/SINOVAC,897,459,438
Alegrete Do Piauí,220027,PI,Nordeste,FIOCRUZ/ASTRAZENECA,853,786,67
Alegrete Do Piauí,220027,PI,Nordeste,PFIZER/BIONTECH,52,52,0
Alegria,430045,RS,Sul,BUTANTAN/SINOVAC,1317,706,611
Alegria,430045,RS,Sul,FIOCRUZ/ASTRAZENECA,1185,1079,106
Alegria,430045,RS,Sul,PFIZER/BIONTECH,169,169,0
Além Paraíba,310150,MG,Sudeste,BUTANTAN/SINOVAC,8312,4359,3953
Além Paraíba,310150,MG,Sudeste,FIOCRUZ/ASTRAZENECA,6614,5879,735
Alenquer,150040,PA,Norte,FIOCRUZ/ASTRAZENECA,12432,8650,3782
Alenquer,150040,PA,Norte,BUTANTAN/SINOVAC,2047,1060,987
Alexandria,240050,RN,Nordeste,FIOCRUZ/ASTRAZENECA,5666,5205,461
Alexandria,240050,RN,Nordeste,BUTANTAN/SINOVAC,4628,2485,2143
Alexandria,240050,RN,Nordeste,PFIZER/BIONTECH,540,539,1
Alexânia,520030,GO,Centro-Oeste,FIOCRUZ/ASTRAZENECA,7102,6768,334
Alexânia,520030,GO,Centro-Oeste,BUTANTAN/SINOVAC,4209,2271,1938
Alexânia,520030,GO,Centro-Oeste,PFIZER/BIONTECH,365,361,4
Alfenas,310160,MG,Sudeste,BUTANTAN/SINOVAC,5643,3917,1726
Alfenas,310160,MG,Sudeste,FIOCRUZ/ASTRAZENECA,3244,3242,2
Alfenas,310160,MG,Sudeste,PFIZER/BIONTECH,225,225,0
Alfredo Chaves,320030,ES,Sudeste,BUTANTAN/SINOVAC,4723,2447,2276
Alfredo Chaves,320030,ES,Sudeste,FIOCRUZ/ASTRAZENECA,3059,2894,165
Alfredo Chaves,320030,ES,Sudeste,PFIZER/BIONTECH,539,539,0
Alfredo Marcondes,350080,SP,Sudeste,BUTANTAN/SINOVAC,1639,808,831
Alfredo Marcondes,350080,SP,Sudeste,FIOCRUZ/ASTRAZENECA,1336,1175,161
Alfredo Marcondes,350080,SP,Sudeste,PFIZER/BIONTECH,129,129,0
Alfredo Vasconcelos,310163,MG,Sudeste,FIOCRUZ/ASTRAZENECA,1538,1272,266
Alfredo Vasconcelos,310163,MG,Sudeste,BUTANTAN/SINOVAC,1095,619,476
Alfredo Vasconcelos,310163,MG,Sudeste,PFIZER/BIONTECH,85,85,0
Alfredo Wagner,420070,SC,Sul,FIOCRUZ/ASTRAZENECA,2173,2015,158
Alfredo Wagner,420070,SC,Sul,BUTANTAN/SINOVAC,1951,1054,897
Alfredo Wagner,420070,SC,Sul,PFIZER/BIONTECH,203,203,0
Algodão De Jandaíra,250057,PB,Nordeste,BUTANTAN/SINOVAC,597,300,297
Algodão De Jandaíra,250057,PB,Nordeste,FIOCRUZ/ASTRAZENECA,419,380,39
Algodão De Jandaíra,250057,PB,Nordeste,PFIZER/BIONTECH,36,36,0
Alhandra,250060,PB,Nordeste,BUTANTAN/SINOVAC,2275,1243,1032
Alhandra,250060,PB,Nordeste,FIOCRUZ/ASTRAZENECA,2254,2116,138
Alhandra,250060,PB,Nordeste,PFIZER/BIONTECH,12,12,0
Aliança,260070,PE,Nordeste,FIOCRUZ/ASTRAZENECA,7923,7430,493
Aliança,260070,PE,Nordeste,BUTANTAN/SINOVAC,5969,3056,2913
Aliança,260070,PE,Nordeste,PFIZER/BIONTECH,537,537,0
Aliança Do Tocantins,170035,TO,Norte,BUTANTAN/SINOVAC,1291,664,627
Aliança Do Tocantins,170035,TO,Norte,FIOCRUZ/ASTRAZENECA,867,825,42
Almadina,290090,BA,Nordeste,BUTANTAN/SINOVAC,1544,793,751
Almadina,290090,BA,Nordeste,FIOCRUZ/ASTRAZENECA,1071,1006,65
Almadina,290090,BA,Nordeste,PFIZER/BIONTECH,18,18,0
Almas,170040,TO,Norte,FIOCRUZ/ASTRAZENECA,1507,1465,42
Almas,170040,TO,Norte,BUTANTAN/SINOVAC,1281,663,618
Almeirim,150050,PA,Norte,FIOCRUZ/ASTRAZENECA,6290,4512,1778
Almeirim,150050,PA,Norte,BUTANTAN/SINOVAC,1596,882,714
Almenara,310170,MG,Sudeste,BUTANTAN/SINOVAC,8488,4383,4105
Almenara,310170,MG,Sudeste,FIOCRUZ/ASTRAZENECA,8223,7728,495
Almenara,310170,MG,Sudeste,PFIZER/BIONTECH,641,641,0
Almino Afonso,240060,RN,Nordeste,BUTANTAN/SINOVAC,1291,673,618
Almino Afonso,240060,RN,Nordeste,FIOCRUZ/ASTRAZENECA,998,941,57
Almino Afonso,240060,RN,Nordeste,PFIZER/BIONTECH,114,114,0
Almirante Tamandaré,410040,PR,Sul,FIOCRUZ/ASTRAZENECA,15965,15325,640
Almirante Tamandaré,410040,PR,Sul,BUTANTAN/SINOVAC,14349,7409,6940
Almirante Tamandaré,410040,PR,Sul,PFIZER/BIONTECH,2943,2941,2
Almirante Tamandaré Do Sul,430047,RS,Sul,BUTANTAN/SINOVAC,636,318,318
Almirante Tamandaré Do Sul,430047,RS,Sul,FIOCRUZ/ASTRAZENECA,587,505,82
Almirante Tamandaré Do Sul,430047,RS,Sul,PFIZER/BIONTECH,90,90,0
Aloândia,520050,GO,Centro-Oeste,FIOCRUZ/ASTRAZENECA,833,781,52
Aloândia,520050,GO,Centro-Oeste,BUTANTAN/SINOVAC,595,300,295
Aloândia,520050,GO,Centro-Oeste,PFIZER/BIONTECH,6,6,0
Alpercata,310180,MG,Sudeste,BUTANTAN/SINOVAC,1698,867,831
Alpercata,310180,MG,Sudeste,FIOCRUZ/ASTRAZENECA,1184,1085,99
Alpercata,310180,MG,Sudeste,PFIZER/BIONTECH,72,72,0
Alpestre,430050,RS,Sul,BUTANTAN/SINOVAC,1962,1034,928
Alpestre,430050,RS,Sul,FIOCRUZ/ASTRAZENECA,1904,1751,153
Alpestre,430050,RS,Sul,PFIZER/BIONTECH,251,248,3
Alpinópolis,310190,MG,Sudeste,BUTANTAN/SINOVAC,4016,2010,2006
Alpinópolis,310190,MG,Sudeste,FIOCRUZ/ASTRAZENECA,3797,3566,231
Alpinópolis,310190,MG,Sudeste,PFIZER/BIONTECH,155,155,0
Alta Floresta,510025,MT,Centro-Oeste,FIOCRUZ/ASTRAZENECA,8078,7322,756
Alta Floresta,510025,MT,Centro-Oeste,BUTANTAN/SINOVAC,6863,3549,3314
Alta Floresta,510025,MT,Centro-Oeste,PFIZER/BIONTECH,99,99,0
Alta Floresta D'Oeste,110001,RO,Norte,BUTANTAN/SINOVAC,4978,2649,2329
Alta Floresta D'Oeste,110001,RO,Norte,FIOCRUZ/ASTRAZENECA,3892,3632,260
Alta Floresta D'Oeste,110001,RO,Norte,PFIZER/BIONTECH,251,251,0
Altair,350090,SP,Sudeste,FIOCRUZ/ASTRAZENECA,975,879,96
Altair,350090,SP,Sudeste,BUTANTAN/SINOVAC,881,465,416
Altair,350090,SP,Sudeste,PFIZER/BIONTECH,36,36,0
Altamira,150060,PA,Norte,FIOCRUZ/ASTRAZENECA,20201,15180,5021
Altamira,150060,PA,Norte,BUTANTAN/SINOVAC,15354,7919,7435
Altamira Do Maranhão,210040,MA,Nordeste,FIOCRUZ/ASTRAZENECA,1446,1363,83
Altamira Do Maranhão,210040,MA,Nordeste,BUTANTAN/SINOVAC,1030,534,496
Altamira Do Paraná,410045,PR,Sul,FIOCRUZ/ASTRAZENECA,1297,1232,65
Altamira Do Paraná,410045,PR,Sul,BUTANTAN/SINOVAC,580,307,273
Altamira Do Paraná,410045,PR,Sul,PFIZER/BIONTECH,12,12,0
Altaneira,230060,CE,Nordeste,BUTANTAN/SINOVAC,1884,954,930
Altaneira,230060,CE,Nordeste,FIOCRUZ/ASTRAZENECA,1739,1570,169
Altaneira,230060,CE,Nordeste,PFIZER/BIONTECH,5,5,0
Alterosa,310200,MG,Sudeste,FIOCRUZ/ASTRAZENECA,4444,4184,260
Alterosa,310200,MG,Sudeste,BUTANTAN/SINOVAC,2946,1714,1232
Alterosa,310200,MG,Sudeste,PFIZER/BIONTECH,244,244,0
Altinho,260080,PE,Nordeste,FIOCRUZ/ASTRAZENECA,4869,4483,386
Altinho,260080,PE,Nordeste,BUTANTAN/SINOVAC,4481,2311,2170
Altinho,260080,PE,Nordeste,PFIZER/BIONTECH,130,128,2
Altinópolis,350100,SP,Sudeste,FIOCRUZ/ASTRAZENECA,4597,4160,437
Altinópolis,350100,SP,Sudeste,BUTANTAN/SINOVAC,4473,2175,2298
Altinópolis,350100,SP,Sudeste,PFIZER/BIONTECH,369,369,0
Alto Alegre,140005,RR,Norte,BUTANTAN/SINOVAC,7776,4424,3352
Alto Alegre,140005,RR,Norte,FIOCRUZ/ASTRAZENECA,1835,1831,4
Alto Alegre,350110,SP,Sudeste,BUTANTAN/SINOVAC,1344,704,640
Alto Alegre,350110,SP,Sudeste,FIOCRUZ/ASTRAZENECA,1119,962,157
Alto Alegre,350110,SP,Sudeste,PFIZER/BIONTECH,70,70,0
Alto Alegre,430055,RS,Sul,BUTANTAN/SINOVAC,563,289,274
Alto Alegre,430055,RS,Sul,FIOCRUZ/ASTRAZENECA,433,376,57
Alto Alegre,430055,RS,Sul,PFIZER/BIONTECH,84,84,0
Alto Alegre Do Maranhão,210043,MA,Nordeste,FIOCRUZ/ASTRAZENECA,4949,4703,246
Alto Alegre Do Maranhão,210043,MA,Nordeste,BUTANTAN/SINOVAC,2837,1531,1306
Alto Alegre Do Pindaré,210047,MA,Nordeste,FIOCRUZ/ASTRAZENECA,6397,6069,328
Alto Alegre Do Pindaré,210047,MA,Nordeste,BUTANTAN/SINOVAC,5569,3116,2453
Alto Alegre Dos Parecis,110037,RO,Norte,BUTANTAN/SINOVAC,1829,978,851
Alto Alegre Dos Parecis,110037,RO,Norte,FIOCRUZ/ASTRAZENECA,1330,1273,57
Alto Alegre Dos Parecis,110037,RO,Norte,PFIZER/BIONTECH,31,31,0
Alto Araguaia,510030,MT,Centro-Oeste,BUTANTAN/SINOVAC,3215,1735,1480
Alto Araguaia,510030,MT,Centro-Oeste,FIOCRUZ/ASTRAZENECA,3140,2898,242
Alto Araguaia,510030,MT,Centro-Oeste,PFIZER/BIONTECH,24,24,0
Alto Bela Vista,420075,SC,Sul,BUTANTAN/SINOVAC,679,350,329
Alto Bela Vista,420075,SC,Sul,FIOCRUZ/ASTRAZENECA,622,543,79
Alto Bela Vista,420075,SC,Sul,PFIZER/BIONTECH,55,55,0
Alto Boa Vista,510035,MT,Centro-Oeste,BUTANTAN/SINOVAC,1926,1007,919
Alto Boa Vista,510035,MT,Centro-Oeste,FIOCRUZ/ASTRAZENECA,728,665,63
Alto Boa Vista,510035,MT,Centro-Oeste,PFIZER/BIONTECH,48,48,0
Alto Caparaó,310205,MG,Sudeste,BUTANTAN/SINOVAC,1054,546,508
Alto Caparaó,310205,MG,Sudeste,FIOCRUZ/ASTRAZENECA,612,547,65
Alto Caparaó,310205,MG,Sudeste,PFIZER/BIONTECH,29,29,0
Alto Do Rodrigues,240070,RN,Nordeste,FIOCRUZ/ASTRAZENECA,2734,2605,129
Alto Do Rodrigues,240070,RN,Nordeste,BUTANTAN/SINOVAC,1822,1009,813
Alto Do Rodrigues,240070,RN,Nordeste,PFIZER/BIONTECH,384,384,0
Alto Feliz,430057,RS,Sul,FIOCRUZ/ASTRAZENECA,1301,1117,184
Alto Feliz,430057,RS,Sul,BUTANTAN/SINOVAC,1022,428,594
Alto Feliz,430057,RS,Sul,PFIZER/BIONTECH,50,50,0
Alto Garças,510040,MT,Centro-Oeste,FIOCRUZ/ASTRAZENECA,2369,2274,95
Alto Garças,510040,MT,Centro-Oeste,BUTANTAN/SINOVAC,2081,1058,1023
Alto Garças,510040,MT,Centro-Oeste,PFIZER/BIONTECH,133,133,0
Alto Horizonte,520055,GO,Centro-Oeste,FIOCRUZ/ASTRAZENECA,1563,1424,139
Alto Horizonte,520055,GO,Centro-Oeste,BUTANTAN/SINOVAC,919,505,414
Alto Jequitibá,315350,MG,Sudeste,BUTANTAN/SINOVAC,1875,975,900
Alto Jequitibá,315350,MG,Sudeste,FIOCRUZ/ASTRAZENECA,1750,1675,75
Alto Longá,220030,PI,Nordeste,FIOCRUZ/ASTRAZENECA,2723,2423,300
Alto Longá,220030,PI,Nordeste,BUTANTAN/SINOVAC,2632,1342,1290
Alto Longá,220030,PI,Nordeste,PFIZER/BIONTECH,201,201,0
Alto Paraguai,510050,MT,Centro-Oeste,BUTANTAN/SINOVAC,1525,797,728
Alto Paraguai,510050,MT,Centro-Oeste,FIOCRUZ/ASTRAZENECA,1394,1365,29
Alto Paraguai,510050,MT,Centro-Oeste,PFIZER/BIONTECH,8,8,0
Alto Paraíso,110040,RO,Norte,BUTANTAN/SINOVAC,2860,1508,1352
Alto Paraíso,110040,RO,Norte,FIOCRUZ/ASTRAZENECA,2403,2333,70
Alto Paraíso,110040,RO,Norte,PFIZER/BIONTECH,253,253,0
Alto Paraíso,412862,PR,Sul,FIOCRUZ/ASTRAZENECA,1210,1167,43
Alto Paraíso,412862,PR,Sul,BUTANTAN/SINOVAC,604,333,271
Alto Paraíso De Goiás,520060,GO,Centro-Oeste,FIOCRUZ/ASTRAZENECA,1954,1851,103
Alto Paraíso De Goiás,520060,GO,Centro-Oeste,BUTANTAN/SINOVAC,1351,688,663
Alto Paraná,410060,PR,Sul,FIOCRUZ/ASTRAZENECA,3249,3073,176
Alto Paraná,410060,PR,Sul,BUTANTAN/SINOVAC,2648,1371,1277
Alto Parnaíba,210050,MA,Nordeste,FIOCRUZ/ASTRAZENECA,1939,1835,104
Alto Parnaíba,210050,MA,Nordeste,BUTANTAN/SINOVAC,1356,765,591
Alto Piquiri,410070,PR,Sul,BUTANTAN/SINOVAC,2255,1160,1095
Alto Piquiri,410070,PR,Sul,FIOCRUZ/ASTRAZENECA,2231,2062,169
Alto Piquiri,410070,PR,Sul,PFIZER/BIONTECH,80,80,0
Alto Rio Doce,310210,MG,Sudeste,FIOCRUZ/ASTRAZENECA,3253,2809,444
Alto Rio Doce,310210,MG,Sudeste,BUTANTAN/SINOVAC,2866,1474,1392
Alto Rio Novo,320035,ES,Sudeste,BUTANTAN/SINOVAC,1870,1024,846
Alto Rio Novo,320035,ES,Sudeste,FIOCRUZ/ASTRAZENECA,1582,1512,70
Alto Rio Novo,320035,ES,Sudeste,PFIZER/BIONTECH,215,215,0
Alto Santo,230070,CE,Nordeste,BUTANTAN/SINOVAC,3018,1531,1487
Alto Santo,230070,CE,Nordeste,FIOCRUZ/ASTRAZENECA,2012,1741,271
Alto Taquari,510060,MT,Centro-Oeste,FIOCRUZ/ASTRAZENECA,1466,1375,91
Alto Taquari,510060,MT,Centro-Oeste,BUTANTAN/SINOVAC,1173,611,562
Alto Taquari,510060,MT,Centro-Oeste,PFIZER/BIONTECH,77,77,0
Altônia,410050,PR,Sul,FIOCRUZ/ASTRAZENECA,5471,5142,329
Altônia,410050,PR,Sul,BUTANTAN/SINOVAC,4985,2564,2421
Altônia,410050,PR,Sul,PFIZER/BIONTECH,604,604,0
Altos,220040,PI,Nordeste,FIOCRUZ/ASTRAZENECA,6554,5950,604
Altos,220040,PI,Nordeste,BUTANTAN/SINOVAC,5960,3387,2573
Alumínio,350115,SP,Sudeste,FIOCRUZ/ASTRAZENECA,3105,2873,232
Alumínio,350115,SP,Sudeste,BUTANTAN/SINOVAC,2827,1375,1452
Alumínio,350115,SP,Sudeste,PFIZER/BIONTECH,171,171,0
Alvarães,130002,AM,Norte,BUTANTAN/SINOVAC,2966,1515,1451
Alvarães,130002,AM,Norte,FIOCRUZ/ASTRAZENECA,2619,2056,563
Alvarenga,310220,MG,Sudeste,BUTANTAN/SINOVAC,1114,574,540
Alvarenga,310220,MG,Sudeste,FIOCRUZ/ASTRAZENECA,1056,959,97
Alvarenga,310220,MG,Sudeste,PFIZER/BIONTECH,30,30,0
Álvares Florence,350120,SP,Sudeste,BUTANTAN/SINOVAC,1405,717,688
Álvares Florence,350120,SP,Sudeste,FIOCRUZ/ASTRAZENECA,1180,1054,126
Álvares Florence,350120,SP,Sudeste,PFIZER/BIONTECH,63,63,0
Álvares Machado,350130,SP,Sudeste,BUTANTAN/SINOVAC,5878,3190,2688
Álvares Machado,350130,SP,Sudeste,FIOCRUZ/ASTRAZENECA,5516,5127,389
Álvares Machado,350130,SP,Sudeste,PFIZER/BIONTECH,428,428,0
Álvaro De Carvalho,350140,SP,Sudeste,BUTANTAN/SINOVAC,1642,899,743
Álvaro De Carvalho,350140,SP,Sudeste,FIOCRUZ/ASTRAZENECA,850,794,56
Álvaro De Carvalho,350140,SP,Sudeste,PFIZER/BIONTECH,137,137,0
Alvinlândia,350150,SP,Sudeste,FIOCRUZ/ASTRAZENECA,804,730,74
Alvinlândia,350150,SP,Sudeste,BUTANTAN/SINOVAC,783,382,401
Alvinlândia,350150,SP,Sudeste,PFIZER/BIONTECH,40,40,0
Alvinópolis,310230,MG,Sudeste,BUTANTAN/SINOVAC,3850,1993,1857
Alvinópolis,310230,MG,Sudeste,FIOCRUZ/ASTRAZENECA,3201,2937,264
Alvinópolis,310230,MG,Sudeste,PFIZER/BIONTECH,162,162,0
Alvorada,170070,TO,Norte,BUTANTAN/SINOVAC,1572,820,752
Alvorada,170070,TO,Norte,FIOCRUZ/ASTRAZENECA,1274,1200,74
Alvorada,430060,RS,Sul,FIOCRUZ/ASTRAZENECA,45878,43380,2498
Alvorada,430060,RS,Sul,BUTANTAN/SINOVAC,37583,19039,18544
Alvorada,430060,RS,Sul,PFIZER/BIONTECH,6701,6508,193
Alvorada D'Oeste,110034,RO,Norte,BUTANTAN/SINOVAC,2914,1619,1295
Alvorada D'Oeste,110034,RO,Norte,FIOCRUZ/ASTRAZENECA,2465,2378,87
Alvorada D'Oeste,110034,RO,Norte,PFIZER/BIONTECH,177,171,6
Alvorada De Minas,310240,MG,Sudeste,FIOCRUZ/ASTRAZENECA,733,663,70
Alvorada De Minas,310240,MG,Sudeste,BUTANTAN/SINOVAC,696,398,298
Alvorada De Minas,310240,MG,Sudeste,PFIZER/BIONTECH,36,36,0
Alvorada Do Gurguéia,220045,PI,Nordeste,FIOCRUZ/ASTRAZENECA,1056,1004,52
Alvorada Do Gurguéia,220045,PI,Nordeste,BUTANTAN/SINOVAC,937,537,400
Alvorada Do Norte,520080,GO,Centro-Oeste,FIOCRUZ/ASTRAZENECA,2656,2413,243
Alvorada Do Norte,520080,GO,Centro-Oeste,BUTANTAN/SINOVAC,902,522,380
Alvorada Do Sul,410080,PR,Sul,FIOCRUZ/ASTRAZENECA,2770,2584,186
Alvorada Do Sul,410080,PR,Sul,BUTANTAN/SINOVAC,2512,1315,1197
Amajari,140002,RR,Norte,BUTANTAN/SINOVAC,6243,3415,2828
Amajari,140002,RR,Norte,FIOCRUZ/ASTRAZENECA,901,899,2
Amambai,500060,MS,Centro-Oeste,BUTANTAN/SINOVAC,20665,11201,9464
Amambai,500060,MS,Centro-Oeste,FIOCRUZ/ASTRAZENECA,9490,8865,625
Amambai,500060,MS,Centro-Oeste,PFIZER/BIONTECH,798,798,0
Amapá,160010,AP,Norte,BUTANTAN/SINOVAC,1355,685,670
Amapá,160010,AP,Norte,FIOCRUZ/ASTRAZENECA,895,827,68
Amapá,160010,AP,Norte,PFIZER/BIONTECH,69,69,0
Amapá Do Maranhão,210055,MA,Nordeste,FIOCRUZ/ASTRAZENECA,1137,1059,78
Amapá Do Maranhão,210055,MA,Nordeste,BUTANTAN/SINOVAC,1017,511,506
Amaporã,410090,PR,Sul,FIOCRUZ/ASTRAZENECA,1459,1361,98
Amaporã,410090,PR,Sul,BUTANTAN/SINOVAC,920,502,418
Amaporã,410090,PR,Sul,PFIZER/BIONTECH,19,19,0
Amaraji,260090,PE,Nordeste,FIOCRUZ/ASTRAZENECA,2925,2754,171
Amaraji,260090,PE,Nordeste,BUTANTAN/SINOVAC,2488,1407,1081
Amaraji,260090,PE,Nordeste,PFIZER/BIONTECH,89,89,0
Amaral Ferrador,430063,RS,Sul,BUTANTAN/SINOVAC,1454,734,720
Amaral Ferrador,430063,RS,Sul,FIOCRUZ/ASTRAZENECA,777,746,31
Amaral Ferrador,430063,RS,Sul,PFIZER/BIONTECH,196,196,0
Amaralina,520082,GO,Centro-Oeste,FIOCRUZ/ASTRAZENECA,890,855,35
Amaralina,520082,GO,Centro-Oeste,BUTANTAN/SINOVAC,609,338,271
Amarante,220050,PI,Nordeste,FIOCRUZ/ASTRAZENECA,4622,4023,599
Amarante,220050,PI,Nordeste,BUTANTAN/SINOVAC,4506,2174,2332
Amarante,220050,PI,Nordeste,PFIZER/BIONTECH,445,439,6
Amarante Do Maranhão,210060,MA,Nordeste,BUTANTAN/SINOVAC,6983,3837,3146
Amarante Do Maranhão,210060,MA,Nordeste,FIOCRUZ/ASTRAZENECA,5314,4998,316
Amargosa,290100,BA,Nordeste,BUTANTAN/SINOVAC,7473,3866,3607
Amargosa,290100,BA,Nordeste,FIOCRUZ/ASTRAZENECA,6483,5952,531
Amargosa,290100,BA,Nordeste,PFIZER/BIONTECH,675,673,2
Amaturá,130006,AM,Norte,BUTANTAN/SINOVAC,1895,1492,403
Amélia Rodrigues,290110,BA,Nordeste,FIOCRUZ/ASTRAZENECA,4885,4292,593
Amélia Rodrigues,290110,BA,Nordeste,BUTANTAN/SINOVAC,4093,2104,1989
Amélia Rodrigues,290110,BA,Nordeste,PFIZER/BIONTECH,844,839,5
América Dourada,290115,BA,Nordeste,FIOCRUZ/ASTRAZENECA,6685,6177,508
América Dourada,290115,BA,Nordeste,BUTANTAN/SINOVAC,2727,1431,1296
América Dourada,290115,BA,Nordeste,PFIZER/BIONTECH,119,119,0
Americana,350160,SP,Sudeste,FIOCRUZ/ASTRAZENECA,53062,48781,4281
Americana,350160,SP,Sudeste,BUTANTAN/SINOVAC,52066,29612,22454
Americana,350160,SP,Sudeste,PFIZER/BIONTECH,3643,3641,2
Americano Do Brasil,520085,GO,Centro-Oeste,BUTANTAN/SINOVAC,902,494,408
Americano Do Brasil,520085,GO,Centro-Oeste,FIOCRUZ/ASTRAZENECA,745,697,48
Américo Brasiliense,350170,SP,Sudeste,BUTANTAN/SINOVAC,7657,4173,3484
Américo Brasiliense,350170,SP,Sudeste,FIOCRUZ/ASTRAZENECA,6069,5742,327
Américo Brasiliense,350170,SP,Sudeste,PFIZER/BIONTECH,770,769,1
Américo De Campos,350180,SP,Sudeste,FIOCRUZ/ASTRAZENECA,1534,1366,168
Américo De Campos,350180,SP,Sudeste,BUTANTAN/SINOVAC,1517,815,702
Américo De Campos,350180,SP,Sudeste,PFIZER/BIONTECH,131,131,0
Ametista Do Sul,430064,RS,Sul,BUTANTAN/SINOVAC,1748,885,863
Ametista Do Sul,430064,RS,Sul,FIOCRUZ/ASTRAZENECA,1643,1532,111
Ametista Do Sul,430064,RS,Sul,PFIZER/BIONTECH,262,262,0
Amontada,230075,CE,Nordeste,BUTANTAN/SINOVAC,6091,3246,2845
Amontada,230075,CE,Nordeste,FIOCRUZ/ASTRAZENECA,2550,1719,831
Amontada,230075,CE,Nordeste,PFIZER/BIONTECH,2,0,2
Amorinópolis,520090,GO,Centro-Oeste,FIOCRUZ/ASTRAZENECA,972,931,41
Amorinópolis,520090,GO,Centro-Oeste,BUTANTAN/SINOVAC,868,454,414
Amparo,250073,PB,Nordeste,BUTANTAN/SINOVAC,562,298,264
Amparo,250073,PB,Nordeste,FIOCRUZ/ASTRAZENECA,363,321,42
Amparo,250073,PB,Nordeste,PFIZER/BIONTECH,52,52,0
Amparo,350190,SP,Sudeste,FIOCRUZ/ASTRAZENECA,20443,18840,1603
Amparo,350190,SP,Sudeste,BUTANTAN/SINOVAC,18160,9601,8559
Amparo,350190,SP,Sudeste,PFIZER/BIONTECH,911,911,0
Amparo Da Serra,310250,MG,Sudeste,BUTANTAN/SINOVAC,1228,631,597
Amparo Da Serra,310250,MG,Sudeste,FIOCRUZ/ASTRAZENECA,803,734,69
Amparo De São Francisco,280010,SE,Nordeste,FIOCRUZ/ASTRAZENECA,703,672,31
Amparo De São Francisco,280010,SE,Nordeste,BUTANTAN/SINOVAC,649,365,284
Amparo De São Francisco,280010,SE,Nordeste,PFIZER/BIONTECH,43,43,0
Ampére,410100,PR,Sul,FIOCRUZ/ASTRAZENECA,4308,4171,137
Ampére,410100,PR,Sul,BUTANTAN/SINOVAC,3504,1816,1688
Ampére,410100,PR,Sul,PFIZER/BIONTECH,627,627,0
Anadia,270020,AL,Nordeste,FIOCRUZ/ASTRAZENECA,3546,3142,404
Anadia,270020,AL,Nordeste,BUTANTAN/SINOVAC,2862,1533,1329
Anagé,290120,BA,Nordeste,BUTANTAN/SINOVAC,4752,2374,2378
Anagé,290120,BA,Nordeste,FIOCRUZ/ASTRAZENECA,3369,3128,241
Anahy,410105,PR,Sul,FIOCRUZ/ASTRAZENECA,1238,1187,51
Anahy,410105,PR,Sul,BUTANTAN/SINOVAC,753,394,359
Anahy,410105,PR,Sul,PFIZER/BIONTECH,9,9,0
Anajás,150070,PA,Norte,FIOCRUZ/ASTRAZENECA,2709,2502,207
Anajás,150070,PA,Norte,BUTANTAN/SINOVAC,1073,565,508
Anajatuba,210070,MA,Nordeste,FIOCRUZ/ASTRAZENECA,8152,7889,263
Anajatuba,210070,MA,Nordeste,BUTANTAN/SINOVAC,4324,2438,1886
Analândia,350200,SP,Sudeste,BUTANTAN/SINOVAC,1082,544,538
Analândia,350200,SP,Sudeste,FIOCRUZ/ASTRAZENECA,1062,996,66
Analândia,350200,SP,Sudeste,PFIZER/BIONTECH,98,98,0
Anamã,130008,AM,Norte,FIOCRUZ/ASTRAZENECA,2563,2298,265
Anamã,130008,AM,Norte,BUTANTAN/SINOVAC,1467,801,666
Ananás,170100,TO,Norte,BUTANTAN/SINOVAC,1903,988,915
Ananás,170100,TO,Norte,FIOCRUZ/ASTRAZENECA,1402,1323,79
Ananindeua,150080,PA,Norte,BUTANTAN/SINOVAC,87161,47731,39430
Ananindeua,150080,PA,Norte,FIOCRUZ/ASTRAZENECA,50817,50750,67
Ananindeua,150080,PA,Norte,PFIZER/BIONTECH,13978,13972,6
Anápolis,520110,GO,Centro-Oeste,BUTANTAN/SINOVAC,76436,41398,35038
Anápolis,520110,GO,Centro-Oeste,FIOCRUZ/ASTRAZENECA,74641,69149,5492
Anápolis,520110,GO,Centro-Oeste,PFIZER/BIONTECH,20575,20549,26
Anapu,150085,PA,Norte,BUTANTAN/SINOVAC,3150,1607,1543
Anapu,150085,PA,Norte,FIOCRUZ/ASTRAZENECA,2538,2042,496
Anapurus,210080,MA,Nordeste,FIOCRUZ/ASTRAZENECA,2037,1876,161
Anapurus,210080,MA,Nordeste,BUTANTAN/SINOVAC,1816,997,819
Anastácio,500070,MS,Centro-Oeste,FIOCRUZ/ASTRAZENECA,5669,5071,598
Anastácio,500070,MS,Centro-Oeste,BUTANTAN/SINOVAC,5204,2721,2483
Anastácio,500070,MS,Centro-Oeste,PFIZER/BIONTECH,857,857,0
Anaurilândia,500080,MS,Centro-Oeste,BUTANTAN/SINOVAC,2403,1289,1114
Anaurilândia,500080,MS,Centro-Oeste,FIOCRUZ/ASTRAZENECA,2343,2073,270
Anaurilândia,500080,MS,Centro-Oeste,PFIZER/BIONTECH,329,329,0
Anchieta,320040,ES,Sudeste,BUTANTAN/SINOVAC,8235,4356,3879
Anchieta,320040,ES,Sudeste,FIOCRUZ/ASTRAZENECA,6165,5870,295
Anchieta,320040,ES,Sudeste,PFIZER/BIONTECH,948,948,0
Anchieta,420080,SC,Sul,FIOCRUZ/ASTRAZENECA,1893,1732,161
Anchieta,420080,SC,Sul,BUTANTAN/SINOVAC,1568,870,698
Andaraí,290130,BA,Nordeste,FIOCRUZ/ASTRAZENECA,2503,2271,232
Andaraí,290130,BA,Nordeste,BUTANTAN/SINOVAC,2011,1058,953
Andaraí,290130,BA,Nordeste,PFIZER/BIONTECH,162,162,0
Andirá,410110,PR,Sul,FIOCRUZ/ASTRAZENECA,5958,5705,253
Andirá,410110,PR,Sul,BUTANTAN/SINOVAC,5042,2628,2414
Andorinha,290135,BA,Nordeste,FIOCRUZ/ASTRAZENECA,3618,3162,456
Andorinha,290135,BA,Nordeste,BUTANTAN/SINOVAC,2606,1414,1192
Andorinha,290135,BA,Nordeste,PFIZER/BIONTECH,309,309,0
Andradas,310260,MG,Sudeste,BUTANTAN/SINOVAC,8625,4344,4281
Andradas,310260,MG,Sudeste,FIOCRUZ/ASTRAZENECA,8546,7811,735
Andradas,310260,MG,Sudeste,PFIZER/BIONTECH,740,740,0
Andradina,350210,SP,Sudeste,BUTANTAN/SINOVAC,15811,8048,7763
Andradina,350210,SP,Sudeste,FIOCRUZ/ASTRAZENECA,15325,14037,1288
Andradina,350210,SP,Sudeste,PFIZER/BIONTECH,1222,1222,0
André Da Rocha,430066,RS,Sul,FIOCRUZ/ASTRAZENECA,434,378,56
André Da Rocha,430066,RS,Sul,BUTANTAN/SINOVAC,391,227,164
André Da Rocha,430066,RS,Sul,PFIZER/BIONTECH,30,30,0
Andrelândia,310280,MG,Sudeste,BUTANTAN/SINOVAC,2845,1454,1391
Andrelândia,310280,MG,Sudeste,FIOCRUZ/ASTRAZENECA,2763,2539,224
Andrelândia,310280,MG,Sudeste,PFIZER/BIONTECH,250,250,0
Angatuba,350220,SP,Sudeste,FIOCRUZ/ASTRAZENECA,8183,7513,670
Angatuba,350220,SP,Sudeste,BUTANTAN/SINOVAC,7152,3358,3794
Angatuba,350220,SP,Sudeste,PFIZER/BIONTECH,995,989,6
Angelândia,310285,MG,Sudeste,BUTANTAN/SINOVAC,1496,771,725
Angelândia,310285,MG,Sudeste,FIOCRUZ/ASTRAZENECA,1236,1129,107
Angelândia,310285,MG,Sudeste,PFIZER/BIONTECH,45,45,0
Angélica,500085,MS,Centro-Oeste,FIOCRUZ/ASTRAZENECA,2534,2117,417
Angélica,500085,MS,Centro-Oeste,BUTANTAN/SINOVAC,2295,1188,1107
Angélica,500085,MS,Centro-Oeste,PFIZER/BIONTECH,392,392,0
Angelim,260100,PE,Nordeste,FIOCRUZ/ASTRAZENECA,3421,3199,222
Angelim,260100,PE,Nordeste,BUTANTAN/SINOVAC,1991,1029,962
Angelim,260100,PE,Nordeste,PFIZER/BIONTECH,280,279,1
Angelina,420090,SC,Sul,FIOCRUZ/ASTRAZENECA,1301,1204,97
Angelina,420090,SC,Sul,BUTANTAN/SINOVAC,1169,587,582
Angical,290140,BA,Nordeste,BUTANTAN/SINOVAC,2966,1544,1422
Angical,290140,BA,Nordeste,FIOCRUZ/ASTRAZENECA,2209,2131,78
Angical,290140,BA,Nordeste,PFIZER/BIONTECH,17,17,0
Angical Do Piauí,220060,PI,Nordeste,BUTANTAN/SINOVAC,1425,749,676
Angical Do Piauí,220060,PI,Nordeste,FIOCRUZ/ASTRAZENECA,1363,1245,118
Angico,170105,TO,Norte,BUTANTAN/SINOVAC,643,344,299
Angico,170105,TO,Norte,FIOCRUZ/ASTRAZENECA,390,378,12
Angicos,240080,RN,Nordeste,BUTANTAN/SINOVAC,2295,1245,1050
Angicos,240080,RN,Nordeste,FIOCRUZ/ASTRAZENECA,2282,2156,126
Angicos,240080,RN,Nordeste,PFIZER/BIONTECH,91,91,0
Angra Dos Reis,330010,RJ,Sudeste,BUTANTAN/SINOVAC,36477,19125,17352
Angra Dos Reis,330010,RJ,Sudeste,FIOCRUZ/ASTRAZENECA,35176,31876,3300
Angra Dos Reis,330010,RJ,Sudeste,PFIZER/BIONTECH,1296,1295,1
Anguera,290150,BA,Nordeste,BUTANTAN/SINOVAC,2806,1438,1368
Anguera,290150,BA,Nordeste,FIOCRUZ/ASTRAZENECA,2024,1870,154
Anguera,290150,BA,Nordeste,PFIZER/BIONTECH,162,162,0
Ângulo,410115,PR,Sul,FIOCRUZ/ASTRAZENECA,992,942,50
Ângulo,410115,PR,Sul,BUTANTAN/SINOVAC,606,341,265
Anhanguera,520120,GO,Centro-Oeste,FIOCRUZ/ASTRAZENECA,412,389,23
Anhanguera,520120,GO,Centro-Oeste,BUTANTAN/SINOVAC,269,145,124
Anhembi,350230,SP,Sudeste,BUTANTAN/SINOVAC,1523,881,642
Anhembi,350230,SP,Sudeste,FIOCRUZ/ASTRAZENECA,1515,1408,107
Anhembi,350230,SP,Sudeste,PFIZER/BIONTECH,39,39,0
Anhumas,350240,SP,Sudeste,FIOCRUZ/ASTRAZENECA,1245,1108,137
Anhumas,350240,SP,Sudeste,BUTANTAN/SINOVAC,1055,484,571
Anhumas,350240,SP,Sudeste,PFIZER/BIONTECH,97,97,0
Anicuns,520130,GO,Centro-Oeste,FIOCRUZ/ASTRAZENECA,5798,5288,510
Anicuns,520130,GO,Centro-Oeste,BUTANTAN/SINOVAC,4195,2125,2070
Anísio De Abreu,220070,PI,Nordeste,FIOCRUZ/ASTRAZENECA,1867,1755,112
Anísio De Abreu,220070,PI,Nordeste,BUTANTAN/SINOVAC,1406,725,681
Anísio De Abreu,220070,PI,Nordeste,PFIZER/BIONTECH,192,192,0
Anita Garibaldi,420100,SC,Sul,FIOCRUZ/ASTRAZENECA,2042,1874,168
Anita Garibaldi,420100,SC,Sul,BUTANTAN/SINOVAC,1635,853,782
Anitápolis,420110,SC,Sul,FIOCRUZ/ASTRAZENECA,1098,1031,67
Anitápolis,420110,SC,Sul,BUTANTAN/SINOVAC,766,405,361
Anitápolis,420110,SC,Sul,PFIZER/BIONTECH,7,7,0
Anori,130010,AM,Norte,FIOCRUZ/ASTRAZENECA,2122,1678,444
Anori,130010,AM,Norte,BUTANTAN/SINOVAC,723,392,331
Anta Gorda,430070,RS,Sul,BUTANTAN/SINOVAC,2179,1097,1082
Anta Gorda,430070,RS,Sul,FIOCRUZ/ASTRAZENECA,1534,1386,148
Anta Gorda,430070,RS,Sul,PFIZER/BIONTECH,234,234,0
Antas,290160,BA,Nordeste,BUTANTAN/SINOVAC,3996,2171,1825
Antas,290160,BA,Nordeste,FIOCRUZ/ASTRAZENECA,3703,3542,161
Antonina,410120,PR,Sul,FIOCRUZ/ASTRAZENECA,7901,7610,291
Antonina,410120,PR,Sul,BUTANTAN/SINOVAC,5107,2616,2491
Antonina Do Norte,230080,CE,Nordeste,BUTANTAN/SINOVAC,1392,741,651
Antonina Do Norte,230080,CE,Nordeste,FIOCRUZ/ASTRAZENECA,420,272,148
Antônio Almeida,220080,PI,Nordeste,FIOCRUZ/ASTRAZENECA,735,575,160
Antônio Almeida,220080,PI,Nordeste,BUTANTAN/SINOVAC,502,259,243
Antônio Almeida,220080,PI,Nordeste,PFIZER/BIONTECH,42,42,0
Antônio Cardoso,290170,BA,Nordeste,FIOCRUZ/ASTRAZENECA,2438,2330,108
Antônio Cardoso,290170,BA,Nordeste,BUTANTAN/SINOVAC,2025,1041,984
Antônio Cardoso,290170,BA,Nordeste,PFIZER/BIONTECH,152,151,1
Antônio Carlos,310290,MG,Sudeste,FIOCRUZ/ASTRAZENECA,2790,2188,602
Antônio Carlos,310290,MG,Sudeste,BUTANTAN/SINOVAC,2505,1276,1229
Antônio Carlos,310290,MG,Sudeste,PFIZER/BIONTECH,102,102,0
Antônio Carlos,420120,SC,Sul,FIOCRUZ/ASTRAZENECA,2812,2456,356
Antônio Carlos,420120,SC,Sul,BUTANTAN/SINOVAC,2120,1272,848
Antônio Dias,310300,MG,Sudeste,FIOCRUZ/ASTRAZENECA,2207,1974,233
Antônio Dias,310300,MG,Sudeste,BUTANTAN/SINOVAC,1709,899,810
Antônio Dias,310300,MG,Sudeste,PFIZER/BIONTECH,170,170,0
Antônio Gonçalves,290180,BA,Nordeste,FIOCRUZ/ASTRAZENECA,1925,1843,82
Antônio Gonçalves,290180,BA,Nordeste,BUTANTAN/SINOVAC,1768,955,813
Antônio Gonçalves,290180,BA,Nordeste,PFIZER/BIONTECH,4,4,0
Antônio João,500090,MS,Centro-Oeste,BUTANTAN/SINOVAC,3751,1980,1771
Antônio João,500090,MS,Centro-Oeste,FIOCRUZ/ASTRAZENECA,2076,1871,205
Antônio João,500090,MS,Centro-Oeste,PFIZER/BIONTECH,301,300,1
Antônio Martins,240090,RN,Nordeste,BUTANTAN/SINOVAC,1416,726,690
Antônio Martins,240090,RN,Nordeste,FIOCRUZ/ASTRAZENECA,1134,1041,93
Antônio Martins,240090,RN,Nordeste,PFIZER/BIONTECH,65,65,0
Antônio Olinto,410130,PR,Sul,FIOCRUZ/ASTRAZENECA,2305,2191,114
Antônio Olinto,410130,PR,Sul,BUTANTAN/SINOVAC,1532,790,742
Antônio Olinto,410130,PR,Sul,PFIZER/BIONTECH,68,68,0
Antônio Prado,430080,RS,Sul,BUTANTAN/SINOVAC,4223,2120,2103
Antônio Prado,430080,RS,Sul,FIOCRUZ/ASTRAZENECA,4069,3453,616
Antônio Prado,430080,RS,Sul,PFIZER/BIONTECH,313,313,0
Antônio Prado De Minas,310310,MG,Sudeste,BUTANTAN/SINOVAC,807,407,400
Antônio Prado De Minas,310310,MG,Sudeste,FIOCRUZ/ASTRAZENECA,581,522,59
Antônio Prado De Minas,310310,MG,Sudeste,PFIZER/BIONTECH,32,32,0
Aparecida,250077,PB,Nordeste,BUTANTAN/SINOVAC,2016,1057,959
Aparecida,250077,PB,Nordeste,FIOCRUZ/ASTRAZENECA,1450,1322,128
Aparecida,250077,PB,Nordeste,PFIZER/BIONTECH,79,79,0
Aparecida,350250,SP,Sudeste,FIOCRUZ/ASTRAZENECA,9576,9081,495
Aparecida,350250,SP,Sudeste,BUTANTAN/SINOVAC,7737,3943,3794
Aparecida,350250,SP,Sudeste,PFIZER/BIONTECH,502,501,1
Aparecida D'Oeste,350260,SP,Sudeste,FIOCRUZ/ASTRAZENECA,1984,1811,173
Aparecida D'Oeste,350260,SP,Sudeste,BUTANTAN/SINOVAC,1700,833,867
Aparecida D'Oeste,350260,SP,Sudeste,PFIZER/BIONTECH,153,153,0
Aparecida De Goiânia,520140,GO,Centro-Oeste,FIOCRUZ/ASTRAZENECA,81899,74949,6950
Aparecida De Goiânia,520140,GO,Centro-Oeste,BUTANTAN/SINOVAC,79018,42402,36616
Aparecida De Goiânia,520140,GO,Centro-Oeste,PFIZER/BIONTECH,24787,24730,57
Aparecida Do Rio Doce,520145,GO,Centro-Oeste,FIOCRUZ/ASTRAZENECA,669,618,51
Aparecida Do Rio Doce,520145,GO,Centro-Oeste,BUTANTAN/SINOVAC,510,258,252
Aparecida Do Rio Negro,170110,TO,Norte,BUTANTAN/SINOVAC,1014,539,475
Aparecida Do Rio Negro,170110,TO,Norte,FIOCRUZ/ASTRAZENECA,753,726,27
Aparecida Do Taboado,500100,MS,Centro-Oeste,FIOCRUZ/ASTRAZENECA,3768,3613,155
Aparecida Do Taboado,500100,MS,Centro-Oeste,BUTANTAN/SINOVAC,3568,2568,1000
Aparecida Do Taboado,500100,MS,Centro-Oeste,PFIZER/BIONTECH,804,804,0
Aperibé,330015,RJ,Sudeste,BUTANTAN/SINOVAC,3021,1598,1423
Aperibé,330015,RJ,Sudeste,FIOCRUZ/ASTRAZENECA,2708,2432,276
Apiacá,320050,ES,Sudeste,BUTANTAN/SINOVAC,2429,1231,1198
Apiacá,320050,ES,Sudeste,FIOCRUZ/ASTRAZENECA,2020,1928,92
Apiacá,320050,ES,Sudeste,PFIZER/BIONTECH,228,228,0
Apiacás,510080,MT,Centro-Oeste,BUTANTAN/SINOVAC,1459,823,636
Apiacás,510080,MT,Centro-Oeste,FIOCRUZ/ASTRAZENECA,757,704,53
Apiacás,510080,MT,Centro-Oeste,PFIZER/BIONTECH,101,101,0
Apiaí,350270,SP,Sudeste,FIOCRUZ/ASTRAZENECA,5199,4858,341
Apiaí,350270,SP,Sudeste,BUTANTAN/SINOVAC,4830,2609,2221
Apiaí,350270,SP,Sudeste,PFIZER/BIONTECH,597,597,0
Apicum-Açu,210083,MA,Nordeste,FIOCRUZ/ASTRAZENECA,2086,1944,142
Apicum-Açu,210083,MA,Nordeste,BUTANTAN/SINOVAC,1802,955,847
Apiúna,420125,SC,Sul,BUTANTAN/SINOVAC,2504,1233,1271
Apiúna,420125,SC,Sul,FIOCRUZ/ASTRAZENECA,1353,1289,64
Apodi,240100,RN,Nordeste,FIOCRUZ/ASTRAZENECA,10894,10214,680
Apodi,240100,RN,Nordeste,BUTANTAN/SINOVAC,7800,4197,3603
Apodi,240100,RN,Nordeste,PFIZER/BIONTECH,1346,1345,1
Aporá,290190,BA,Nordeste,BUTANTAN/SINOVAC,928,713,215
Aporá,290190,BA,Nordeste,FIOCRUZ/ASTRAZENECA,237,236,1
Aporé,520150,GO,Centro-Oeste,BUTANTAN/SINOVAC,688,353,335
Aporé,520150,GO,Centro-Oeste,FIOCRUZ/ASTRAZENECA,386,323,63
Apuarema,290195,BA,Nordeste,BUTANTAN/SINOVAC,1568,809,759
Apuarema,290195,BA,Nordeste,FIOCRUZ/ASTRAZENECA,1534,1347,187
Apuarema,290195,BA,Nordeste,PFIZER/BIONTECH,100,100,0
Apucarana,410140,PR,Sul,FIOCRUZ/ASTRAZENECA,27861,26609,1252
Apucarana,410140,PR,Sul,BUTANTAN/SINOVAC,24020,13558,10462
Apucarana,410140,PR,Sul,PFIZER/BIONTECH,6109,6038,71
Apuí,130014,AM,Norte,FIOCRUZ/ASTRAZENECA,2196,1964,232
Apuí,130014,AM,Norte,BUTANTAN/SINOVAC,2083,1184,899
Apuiarés,230090,CE,Nordeste,BUTANTAN/SINOVAC,1943,1131,812
Apuiarés,230090,CE,Nordeste,FIOCRUZ/ASTRAZENECA,819,702,117
Aquidabã,280020,SE,Nordeste,FIOCRUZ/ASTRAZENECA,4207,3968,239
Aquidabã,280020,SE,Nordeste,BUTANTAN/SINOVAC,4002,2130,1872
Aquidabã,280020,SE,Nordeste,PFIZER/BIONTECH,302,302,0
Aquidauana,500110,MS,Centro-Oeste,BUTANTAN/SINOVAC,15371,8567,6804
Aquidauana,500110,MS,Centro-Oeste,FIOCRUZ/ASTRAZENECA,9203,8205,998
Aquidauana,500110,MS,Centro-Oeste,PFIZER/BIONTECH,631,624,7
Aquiraz,230100,CE,Nordeste,FIOCRUZ/ASTRAZENECA,6029,5616,413
Aquiraz,230100,CE,Nordeste,BUTANTAN/SINOVAC,6027,3608,2419
Arabutã,420127,SC,Sul,BUTANTAN/SINOVAC,1319,706,613
Arabutã,420127,SC,Sul,FIOCRUZ/ASTRAZENECA,1067,1028,39
Araçagi,250080,PB,Nordeste,BUTANTAN/SINOVAC,3856,1984,1872
Araçagi,250080,PB,Nordeste,FIOCRUZ/ASTRAZENECA,2474,2230,244
Araçagi,250080,PB,Nordeste,PFIZER/BIONTECH,73,73,0
Araçaí,310320,MG,Sudeste,BUTANTAN/SINOVAC,680,348,332
Araçaí,310320,MG,Sudeste,FIOCRUZ/ASTRAZENECA,556,473,83
Araçaí,310320,MG,Sudeste,PFIZER/BIONTECH,53,53,0
Aracaju,280030,SE,Nordeste,FIOCRUZ/ASTRAZENECA,162339,144049,18290
Aracaju,280030,SE,Nordeste,BUTANTAN/SINOVAC,98925,51461,47464
Aracaju,280030,SE,Nordeste,PFIZER/BIONTECH,41973,41955,18
Araçariguama,350275,SP,Sudeste,BUTANTAN/SINOVAC,3032,1554,1478
Araçariguama,350275,SP,Sudeste,FIOCRUZ/ASTRAZENECA,2487,2300,187
Araçariguama,350275,SP,Sudeste,PFIZER/BIONTECH,436,436,0
Araçás,290205,BA,Nordeste,FIOCRUZ/ASTRAZENECA,2273,2190,83
Araçás,290205,BA,Nordeste,BUTANTAN/SINOVAC,1425,793,632
Aracati,230110,CE,Nordeste,BUTANTAN/SINOVAC,13165,6733,6432
Aracati,230110,CE,Nordeste,FIOCRUZ/ASTRAZENECA,3400,2517,883
Aracatu,290200,BA,Nordeste,BUTANTAN/SINOVAC,2393,1535,858
Aracatu,290200,BA,Nordeste,FIOCRUZ/ASTRAZENECA,1785,1745,40
Araçatuba,350280,SP,Sudeste,FIOCRUZ/ASTRAZENECA,49026,44806,4220
Araçatuba,350280,SP,Sudeste,BUTANTAN/SINOVAC,48411,25575,22836
Araçatuba,350280,SP,Sudeste,PFIZER/BIONTECH,2241,2241,0
Araci,290210,BA,Nordeste,BUTANTAN/SINOVAC,8404,4482,3922
Araci,290210,BA,Nordeste,FIOCRUZ/ASTRAZENECA,8139,7124,1015
Araci,290210,BA,Nordeste,PFIZER/BIONTECH,1051,1049,2
Aracitaba,310330,MG,Sudeste,BUTANTAN/SINOVAC,761,381,380
Aracitaba,310330,MG,Sudeste,FIOCRUZ/ASTRAZENECA,581,530,51
Aracitaba,310330,MG,Sudeste,PFIZER/BIONTECH,30,29,1
Aracoiaba,230120,CE,Nordeste,BUTANTAN/SINOVAC,90,90,0
Aracoiaba,230120,CE,Nordeste,FIOCRUZ/ASTRAZENECA,20,20,0
Araçoiaba,260105,PE,Nordeste,BUTANTAN/SINOVAC,3053,1865,1188
Araçoiaba,260105,PE,Nordeste,FIOCRUZ/ASTRAZENECA,1731,1650,81
Araçoiaba,260105,PE,Nordeste,PFIZER/BIONTECH,109,109,0
Araçoiaba Da Serra,350290,SP,Sudeste,BUTANTAN/SINOVAC,5769,3194,2575
Araçoiaba Da Serra,350290,SP,Sudeste,FIOCRUZ/ASTRAZENECA,5504,5037,467
Araçoiaba Da Serra,350290,SP,Sudeste,PFIZER/BIONTECH,462,458,4
Aracruz,320060,ES,Sudeste,BUTANTAN/SINOVAC,23236,12400,10836
Aracruz,320060,ES,Sudeste,FIOCRUZ/ASTRAZENECA,20189,19020,1169
Aracruz,320060,ES,Sudeste,PFIZER/BIONTECH,2113,2108,5
Araçu,520160,GO,Centro-Oeste,FIOCRUZ/ASTRAZENECA,2144,2018,126
Araçu,520160,GO,Centro-Oeste,BUTANTAN/SINOVAC,1419,694,725
Araçuaí,310340,MG,Sudeste,BUTANTAN/SINOVAC,6557,3418,3139
Araçuaí,310340,MG,Sudeste,FIOCRUZ/ASTRAZENECA,5370,4895,475
Araçuaí,310340,MG,Sudeste,PFIZER/BIONTECH,763,763,0
Aragarças,520170,GO,Centro-Oeste,FIOCRUZ/ASTRAZENECA,3493,3360,133
Aragarças,520170,GO,Centro-Oeste,BUTANTAN/SINOVAC,3111,1629,1482
Aragoiânia,520180,GO,Centro-Oeste,FIOCRUZ/ASTRAZENECA,3008,2813,195
Aragoiânia,520180,GO,Centro-Oeste,BUTANTAN/SINOVAC,2184,1154,1030
Aragominas,170130,TO,Norte,FIOCRUZ/ASTRAZENECA,1314,1078,236
Aragominas,170130,TO,Norte,BUTANTAN/SINOVAC,1230,634,596
Araguacema,170190,TO,Norte,BUTANTAN/SINOVAC,1061,599,462
Araguacema,170190,TO,Norte,FIOCRUZ/ASTRAZENECA,842,805,37
Araguaçu,170200,TO,Norte,BUTANTAN/SINOVAC,2186,1102,1084
Araguaçu,170200,TO,Norte,FIOCRUZ/ASTRAZENECA,1524,1417,107
Araguaiana,510100,MT,Centro-Oeste,FIOCRUZ/ASTRAZENECA,1186,1155,31
Araguaiana,510100,MT,Centro-Oeste,BUTANTAN/SINOVAC,614,337,277
Araguaiana,510100,MT,Centro-Oeste,PFIZER/BIONTECH,14,14,0
Araguaína,170210,TO,Norte,BUTANTAN/SINOVAC,29487,15157,14330
Araguaína,170210,TO,Norte,FIOCRUZ/ASTRAZENECA,26021,22987,3034
Araguaína,170210,TO,Norte,PFIZER/BIONTECH,9212,9210,2
Araguainha,510120,MT,Centro-Oeste,BUTANTAN/SINOVAC,360,186,174
Araguainha,510120,MT,Centro-Oeste,FIOCRUZ/ASTRAZENECA,180,169,11
Araguanã,170215,TO,Norte,BUTANTAN/SINOVAC,918,473,445
Araguanã,170215,TO,Norte,FIOCRUZ/ASTRAZENECA,826,775,51
Araguanã,210087,MA,Nordeste,FIOCRUZ/ASTRAZENECA,2062,1934,128
Araguanã,210087,MA,Nordeste,BUTANTAN/SINOVAC,1779,988,791
Araguapaz,520215,GO,Centro-Oeste,FIOCRUZ/ASTRAZENECA,1760,1643,117
Araguapaz,520215,GO,Centro-Oeste,BUTANTAN/SINOVAC,1458,834,624
Araguari,310350,MG,Sudeste,BUTANTAN/SINOVAC,25413,13079,12334
Araguari,310350,MG,Sudeste,FIOCRUZ/ASTRAZENECA,19848,17662,2186
Araguari,310350,MG,Sudeste,PFIZER/BIONTECH,1203,1202,1
Araguatins,170220,TO,Norte,BUTANTAN/SINOVAC,5293,2704,2589
Araguatins,170220,TO,Norte,FIOCRUZ/ASTRAZENECA,3528,3342,186
Araioses,210090,MA,Nordeste,FIOCRUZ/ASTRAZENECA,8086,7912,174
Araioses,210090,MA,Nordeste,BUTANTAN/SINOVAC,5015,2897,2118
Aral Moreira,500124,MS,Centro-Oeste,BUTANTAN/SINOVAC,2603,1486,1117
Aral Moreira,500124,MS,Centro-Oeste,FIOCRUZ/ASTRAZENECA,2412,2044,368
Aral Moreira,500124,MS,Centro-Oeste,PFIZER/BIONTECH,276,275,1
Aramari,290220,BA,Nordeste,BUTANTAN/SINOVAC,1837,980,857
Aramari,290220,BA,Nordeste,FIOCRUZ/ASTRAZENECA,1822,1766,56
Arambaré,430085,RS,Sul,BUTANTAN/SINOVAC,1397,707,690
Arambaré,430085,RS,Sul,FIOCRUZ/ASTRAZENECA,1005,914,91
Arambaré,430085,RS,Sul,PFIZER/BIONTECH,53,53,0
Arame,210095,MA,Nordeste,BUTANTAN/SINOVAC,5178,3069,2109
Arame,210095,MA,Nordeste,FIOCRUZ/ASTRAZENECA,4272,4035,237
Aramina,350300,SP,Sudeste,BUTANTAN/SINOVAC,1273,638,635
Aramina,350300,SP,Sudeste,FIOCRUZ/ASTRAZENECA,1197,1082,115
Aramina,350300,SP,Sudeste,PFIZER/BIONTECH,46,46,0
Arandu,350310,SP,Sudeste,FIOCRUZ/ASTRAZENECA,1596,1472,124
Arandu,350310,SP,Sudeste,BUTANTAN/SINOVAC,1563,882,681
Arandu,350310,SP,Sudeste,PFIZER/BIONTECH,115,105,10
Arantina,310360,MG,Sudeste,BUTANTAN/SINOVAC,718,366,352
Arantina,310360,MG,Sudeste,FIOCRUZ/ASTRAZENECA,402,373,29
Arantina,310360,MG,Sudeste,PFIZER/BIONTECH,30,30,0
Arapeí,350315,SP,Sudeste,BUTANTAN/SINOVAC,617,330,287
Arapeí,350315,SP,Sudeste,FIOCRUZ/ASTRAZENECA,544,483,61
Arapeí,350315,SP,Sudeste,PFIZER/BIONTECH,44,44,0
Arapiraca,270030,AL,Nordeste,BUTANTAN/SINOVAC,39783,20570,19213
Arapiraca,270030,AL,Nordeste,FIOCRUZ/ASTRAZENECA,37359,33861,3498
Arapiraca,270030,AL,Nordeste,PFIZER/BIONTECH,11892,11876,16
Arapoema,170230,TO,Norte,BUTANTAN/SINOVAC,1214,719,495
Arapoema,170230,TO,Norte,FIOCRUZ/ASTRAZENECA,877,806,71
Araponga,310370,MG,Sudeste,BUTANTAN/SINOVAC,1156,655,501
Araponga,310370,MG,Sudeste,FIOCRUZ/ASTRAZENECA,1021,983,38
Araponga,310370,MG,Sudeste,PFIZER/BIONTECH,58,58,0
Arapongas,410150,PR,Sul,FIOCRUZ/ASTRAZENECA,28175,25852,2323
Arapongas,410150,PR,Sul,BUTANTAN/SINOVAC,27892,15139,12753
Arapongas,410150,PR,Sul,PFIZER/BIONTECH,292,291,1
Araporã,310375,MG,Sudeste,BUTANTAN/SINOVAC,1741,881,860
Araporã,310375,MG,Sudeste,FIOCRUZ/ASTRAZENECA,915,855,60
Arapoti,410160,PR,Sul,FIOCRUZ/ASTRAZENECA,5573,5288,285
Arapoti,410160,PR,Sul,BUTANTAN/SINOVAC,4633,2396,2237
Arapoti,410160,PR,Sul,PFIZER/BIONTECH,444,444,0
Arapuá,310380,MG,Sudeste,BUTANTAN/SINOVAC,1083,547,536
Arapuá,310380,MG,Sudeste,FIOCRUZ/ASTRAZENECA,823,717,106
Arapuá,310380,MG,Sudeste,PFIZER/BIONTECH,117,117,0
Arapuã,410165,PR,Sul,FIOCRUZ/ASTRAZENECA,1075,1011,64
Arapuã,410165,PR,Sul,BUTANTAN/SINOVAC,994,519,475
Arapuã,410165,PR,Sul,PFIZER/BIONTECH,17,17,0
Araputanga,510125,MT,Centro-Oeste,FIOCRUZ/ASTRAZENECA,3537,3295,242
Araputanga,510125,MT,Centro-Oeste,BUTANTAN/SINOVAC,2781,1442,1339
Araputanga,510125,MT,Centro-Oeste,PFIZER/BIONTECH,223,222,1
Araquari,420130,SC,Sul,FIOCRUZ/ASTRAZENECA,6585,6286,299
Araquari,420130,SC,Sul,BUTANTAN/SINOVAC,3772,1988,1784
Araquari,420130,SC,Sul,PFIZER/BIONTECH,341,339,2
Arara,250090,PB,Nordeste,BUTANTAN/SINOVAC,3964,2033,1931
Arara,250090,PB,Nordeste,FIOCRUZ/ASTRAZENECA,2606,2325,281
Arara,250090,PB,Nordeste,PFIZER/BIONTECH,39,39,0
Araranguá,420140,SC,Sul,FIOCRUZ/ASTRAZENECA,15273,13797,1476
Araranguá,420140,SC,Sul,BUTANTAN/SINOVAC,12024,6463,5561
Araranguá,420140,SC,Sul,PFIZER/BIONTECH,2031,2031,0
Araraquara,350320,SP,Sudeste,BUTANTAN/SINOVAC,60032,31333,28699
Araraquara,350320,SP,Sudeste,FIOCRUZ/ASTRAZENECA,53505,48261,5244
Araraquara,350320,SP,Sudeste,PFIZER/BIONTECH,3012,3006,6
Araras,350330,SP,Sudeste,FIOCRUZ/ASTRAZENECA,29680,26728,2952
Araras,350330,SP,Sudeste,BUTANTAN/SINOVAC,26395,13723,12672
Araras,350330,SP,Sudeste,PFIZER/BIONTECH,1450,1450,0
Ararendá,230125,CE,Nordeste,BUTANTAN/SINOVAC,2271,1174,1097
Ararendá,230125,CE,Nordeste,FIOCRUZ/ASTRAZENECA,1275,1034,241
Arari,210100,MA,Nordeste,FIOCRUZ/ASTRAZENECA,3886,3681,205
Arari,210100,MA,Nordeste,BUTANTAN/SINOVAC,3623,2001,1622
Araricá,430087,RS,Sul,BUTANTAN/SINOVAC,1901,1002,899
Araricá,430087,RS,Sul,FIOCRUZ/ASTRAZENECA,1354,1350,4
Araricá,430087,RS,Sul,PFIZER/BIONTECH,196,196,0
Araripe,230130,CE,Nordeste,BUTANTAN/SINOVAC,3077,1617,1460
Araripe,230130,CE,Nordeste,FIOCRUZ/ASTRAZENECA,2528,2044,484
Araripina,260110,PE,Nordeste,FIOCRUZ/ASTRAZENECA,16064,14835,1229
Araripina,260110,PE,Nordeste,BUTANTAN/SINOVAC,12610,6416,6194
Araripina,260110,PE,Nordeste,PFIZER/BIONTECH,1154,1154,0
Araruama,330020,RJ,Sudeste,BUTANTAN/SINOVAC,27640,13603,14037
Araruama,330020,RJ,Sudeste,FIOCRUZ/ASTRAZENECA,21489,18915,2574
Araruna,250100,PB,Nordeste,BUTANTAN/SINOVAC,3769,2024,1745
Araruna,250100,PB,Nordeste,FIOCRUZ/ASTRAZENECA,2305,2064,241
Araruna,250100,PB,Nordeste,PFIZER/BIONTECH,247,246,1
Araruna,410170,PR,Sul,FIOCRUZ/ASTRAZENECA,3078,2938,140
Araruna,410170,PR,Sul,BUTANTAN/SINOVAC,2598,1423,1175
Araruna,410170,PR,Sul,PFIZER/BIONTECH,72,72,0
Arataca,290225,BA,Nordeste,BUTANTAN/SINOVAC,1588,876,712
Arataca,290225,BA,Nordeste,FIOCRUZ/ASTRAZENECA,1404,1318,86
Arataca,290225,BA,Nordeste,PFIZER/BIONTECH,16,16,0
Aratiba,430090,RS,Sul,BUTANTAN/SINOVAC,2364,1203,1161
Aratiba,430090,RS,Sul,FIOCRUZ/ASTRAZENECA,1953,1690,263
Aratiba,430090,RS,Sul,PFIZER/BIONTECH,192,192,0
Aratuba,230140,CE,Nordeste,BUTANTAN/SINOVAC,3506,1763,1743
Aratuba,230140,CE,Nordeste,FIOCRUZ/ASTRAZENECA,2083,1878,205
Aratuba,230140,CE,Nordeste,PFIZER/BIONTECH,43,43,0
Aratuípe,290230,BA,Nordeste,BUTANTAN/SINOVAC,1358,743,615
Aratuípe,290230,BA,Nordeste,FIOCRUZ/ASTRAZENECA,1251,1170,81
Aratuípe,290230,BA,Nordeste,PFIZER/BIONTECH,160,160,0
Arauá,280040,SE,Nordeste,FIOCRUZ/ASTRAZENECA,1778,1690,88
Arauá,280040,SE,Nordeste,BUTANTAN/SINOVAC,1766,935,831
Arauá,280040,SE,Nordeste,PFIZER/BIONTECH,222,222,0
Araucária,410180,PR,Sul,FIOCRUZ/ASTRAZENECA,25566,24276,1290
Araucária,410180,PR,Sul,BUTANTAN/SINOVAC,17863,9190,8673
Araucária,410180,PR,Sul,PFIZER/BIONTECH,7214,7212,2
Araújos,310390,MG,Sudeste,FIOCRUZ/ASTRAZENECA,1891,1757,134
Araújos,310390,MG,Sudeste,BUTANTAN/SINOVAC,1571,790,781
Araújos,310390,MG,Sudeste,PFIZER/BIONTECH,24,24,0
Araxá,310400,MG,Sudeste,BUTANTAN/SINOVAC,20231,10339,9892
Araxá,310400,MG,Sudeste,FIOCRUZ/ASTRAZENECA,19776,17681,2095
Araxá,310400,MG,Sudeste,PFIZER/BIONTECH,2050,2050,0
Arceburgo,310410,MG,Sudeste,FIOCRUZ/ASTRAZENECA,2410,2195,215
Arceburgo,310410,MG,Sudeste,BUTANTAN/SINOVAC,2359,1202,1157
Arceburgo,310410,MG,Sudeste,PFIZER/BIONTECH,102,102,0
Arco-Íris,350335,SP,Sudeste,BUTANTAN/SINOVAC,1156,551,605
Arco-Íris,350335,SP,Sudeste,FIOCRUZ/ASTRAZENECA,600,524,76
Arco-Íris,350335,SP,Sudeste,PFIZER/BIONTECH,84,84,0
Arcos,310420,MG,Sudeste,FIOCRUZ/ASTRAZENECA,8381,7771,610
Arcos,310420,MG,Sudeste,BUTANTAN/SINOVAC,7222,3691,3531
Arcos,310420,MG,Sudeste,PFIZER/BIONTECH,592,592,0
Arcoverde,260120,PE,Nordeste,BUTANTAN/SINOVAC,15219,8214,7005
Arcoverde,260120,PE,Nordeste,FIOCRUZ/ASTRAZENECA,13112,11941,1171
Arcoverde,260120,PE,Nordeste,PFIZER/BIONTECH,748,747,1
Areado,310430,MG,Sudeste,BUTANTAN/SINOVAC,3123,1643,1480
Areado,310430,MG,Sudeste,FIOCRUZ/ASTRAZENECA,1829,1738,91
Areado,310430,MG,Sudeste,PFIZER/BIONTECH,8,8,0
Areal,330022,RJ,Sudeste,BUTANTAN/SINOVAC,3483,1819,1664
Areal,330022,RJ,Sudeste,FIOCRUZ/ASTRAZENECA,2836,2624,212
Arealva,350340,SP,Sudeste,BUTANTAN/SINOVAC,2429,1272,1157
Arealva,350340,SP,Sudeste,FIOCRUZ/ASTRAZENECA,1776,1578,198
Arealva,350340,SP,Sudeste,PFIZER/BIONTECH,228,228,0
Areia,250110,PB,Nordeste,BUTANTAN/SINOVAC,5474,3022,2452
Areia,250110,PB,Nordeste,FIOCRUZ/ASTRAZENECA,3729,3393,336
Areia,250110,PB,Nordeste,PFIZER/BIONTECH,149,149,0
Areia Branca,240110,RN,Nordeste,FIOCRUZ/ASTRAZENECA,5325,4907,418
Areia Branca,240110,RN,Nordeste,BUTANTAN/SINOVAC,4285,2200,2085
Areia Branca,240110,RN,Nordeste,PFIZER/BIONTECH,599,599,0
Areia Branca,280050,SE,Nordeste,BUTANTAN/SINOVAC,2766,1447,1319
Areia Branca,280050,SE,Nordeste,FIOCRUZ/ASTRAZENECA,2456,2309,147
Areia Branca,280050,SE,Nordeste,PFIZER/BIONTECH,29,29,0
Areia De Baraúnas,250115,PB,Nordeste,BUTANTAN/SINOVAC,617,316,301
Areia De Baraúnas,250115,PB,Nordeste,FIOCRUZ/ASTRAZENECA,241,213,28
Areia De Baraúnas,250115,PB,Nordeste,PFIZER/BIONTECH,19,19,0
Areial,250120,PB,Nordeste,BUTANTAN/SINOVAC,1517,848,669
Areial,250120,PB,Nordeste,FIOCRUZ/ASTRAZENECA,1173,1042,131
Areial,250120,PB,Nordeste,PFIZER/BIONTECH,96,96,0
Areias,350350,SP,Sudeste,BUTANTAN/SINOVAC,852,446,406
Areias,350350,SP,Sudeste,FIOCRUZ/ASTRAZENECA,675,629,46
Areias,350350,SP,Sudeste,PFIZER/BIONTECH,35,35,0
Areiópolis,350360,SP,Sudeste,FIOCRUZ/ASTRAZENECA,2148,1991,157
Areiópolis,350360,SP,Sudeste,BUTANTAN/SINOVAC,1721,927,794
Areiópolis,350360,SP,Sudeste,PFIZER/BIONTECH,169,169,0
Arenápolis,510130,MT,Centro-Oeste,BUTANTAN/SINOVAC,2004,1140,864
Arenápolis,510130,MT,Centro-Oeste,FIOCRUZ/ASTRAZENECA,1893,1658,235
Arenápolis,510130,MT,Centro-Oeste,PFIZER/BIONTECH,6,6,0
Arenópolis,520235,GO,Centro-Oeste,FIOCRUZ/ASTRAZENECA,719,663,56
Arenópolis,520235,GO,Centro-Oeste,BUTANTAN/SINOVAC,697,356,341
Arês,240120,RN,Nordeste,FIOCRUZ/ASTRAZENECA,2211,2114,97
Arês,240120,RN,Nordeste,BUTANTAN/SINOVAC,2077,1008,1069
Arês,240120,RN,Nordeste,PFIZER/BIONTECH,295,295,0
Argirita,310440,MG,Sudeste,BUTANTAN/SINOVAC,811,415,396
Argirita,310440,MG,Sudeste,FIOCRUZ/ASTRAZENECA,239,238,1
Argirita,310440,MG,Sudeste,PFIZER/BIONTECH,35,35,0
Aricanduva,310445,MG,Sudeste,BUTANTAN/SINOVAC,1315,728,587
Aricanduva,310445,MG,Sudeste,FIOCRUZ/ASTRAZENECA,785,688,97
Aricanduva,310445,MG,Sudeste,PFIZER/BIONTECH,90,90,0
Arinos,310450,MG,Sudeste,BUTANTAN/SINOVAC,3763,2039,1724
Arinos,310450,MG,Sudeste,FIOCRUZ/ASTRAZENECA,2391,2125,266
Arinos,310450,MG,Sudeste,PFIZER/BIONTECH,260,260,0
Aripuanã,510140,MT,Centro-Oeste,BUTANTAN/SINOVAC,2525,1305,1220
Aripuanã,510140,MT,Centro-Oeste,FIOCRUZ/ASTRAZENECA,2081,1948,133
Aripuanã,510140,MT,Centro-Oeste,PFIZER/BIONTECH,231,231,0
Ariquemes,110002,RO,Norte,FIOCRUZ/ASTRAZENECA,15679,15205,474
Ariquemes,110002,RO,Norte,BUTANTAN/SINOVAC,15053,8205,6848
Ariquemes,110002,RO,Norte,PFIZER/BIONTECH,2289,2288,1
Ariranha,350370,SP,Sudeste,BUTANTAN/SINOVAC,2246,1294,952
Ariranha,350370,SP,Sudeste,FIOCRUZ/ASTRAZENECA,2061,1830,231
Ariranha,350370,SP,Sudeste,PFIZER/BIONTECH,185,185,0
Ariranha Do Ivaí,410185,PR,Sul,FIOCRUZ/ASTRAZENECA,682,640,42
Ariranha Do Ivaí,410185,PR,Sul,BUTANTAN/SINOVAC,646,339,307
Armação Dos Búzios,330023,RJ,Sudeste,BUTANTAN/SINOVAC,5785,3324,2461
Armação Dos Búzios,330023,RJ,Sudeste,FIOCRUZ/ASTRAZENECA,5487,5210,277
Armação Dos Búzios,330023,RJ,Sudeste,PFIZER/BIONTECH,142,142,0
Armazém,420150,SC,Sul,FIOCRUZ/ASTRAZENECA,2607,2354,253
Armazém,420150,SC,Sul,BUTANTAN/SINOVAC,1509,868,641
Armazém,420150,SC,Sul,PFIZER/BIONTECH,62,62,0
Arneiroz,230150,CE,Nordeste,BUTANTAN/SINOVAC,910,732,178
Arneiroz,230150,CE,Nordeste,FIOCRUZ/ASTRAZENECA,245,235,10
Aroazes,220090,PI,Nordeste,BUTANTAN/SINOVAC,1508,775,733
Aroazes,220090,PI,Nordeste,FIOCRUZ/ASTRAZENECA,791,760,31
Aroazes,220090,PI,Nordeste,PFIZER/BIONTECH,30,30,0
Aroeiras,250130,PB,Nordeste,BUTANTAN/SINOVAC,4584,2314,2270
Aroeiras,250130,PB,Nordeste,FIOCRUZ/ASTRAZENECA,2668,2419,249
Aroeiras,250130,PB,Nordeste,PFIZER/BIONTECH,130,130,0
Aroeiras Do Itaim,220095,PI,Nordeste,BUTANTAN/SINOVAC,585,293,292
Aroeiras Do Itaim,220095,PI,Nordeste,FIOCRUZ/ASTRAZENECA,556,492,64
Arraial,220100,PI,Nordeste,FIOCRUZ/ASTRAZENECA,1031,950,81
Arraial,220100,PI,Nordeste,BUTANTAN/SINOVAC,907,458,449
Arraial,220100,PI,Nordeste,PFIZER/BIONTECH,94,94,0
Arraial Do Cabo,330025,RJ,Sudeste,BUTANTAN/SINOVAC,7588,4082,3506
Arraial Do Cabo,330025,RJ,Sudeste,FIOCRUZ/ASTRAZENECA,7368,6765,603
Arraial Do Cabo,330025,RJ,Sudeste,PFIZER/BIONTECH,475,475,0
Arraias,170240,TO,Norte,FIOCRUZ/ASTRAZENECA,3165,2941,224
Arraias,170240,TO,Norte,BUTANTAN/SINOVAC,2152,1110,1042
Arroio Do Meio,430100,RS,Sul,FIOCRUZ/ASTRAZENECA,5816,5148,668
Arroio Do Meio,430100,RS,Sul,BUTANTAN/SINOVAC,5773,2912,2861
Arroio Do Meio,430100,RS,Sul,PFIZER/BIONTECH,763,763,0
Arroio Do Padre,430107,RS,Sul,BUTANTAN/SINOVAC,1004,528,476
Arroio Do Padre,430107,RS,Sul,FIOCRUZ/ASTRAZENECA,580,541,39
Arroio Do Padre,430107,RS,Sul,PFIZER/BIONTECH,93,93,0
Arroio Do Sal,430105,RS,Sul,BUTANTAN/SINOVAC,3413,1781,1632
Arroio Do Sal,430105,RS,Sul,FIOCRUZ/ASTRAZENECA,2983,2751,232
Arroio Do Sal,430105,RS,Sul,PFIZER/BIONTECH,381,381,0
Arroio Do Tigre,430120,RS,Sul,FIOCRUZ/ASTRAZENECA,3243,2922,321
Arroio Do Tigre,430120,RS,Sul,BUTANTAN/SINOVAC,2815,1434,1381
Arroio Do Tigre,430120,RS,Sul,PFIZER/BIONTECH,181,181,0
Arroio Dos Ratos,430110,RS,Sul,BUTANTAN/SINOVAC,4207,2208,1999
Arroio Dos Ratos,430110,RS,Sul,FIOCRUZ/ASTRAZENECA,2622,2437,185
Arroio Dos Ratos,430110,RS,Sul,PFIZER/BIONTECH,113,113,0
Arroio Grande,430130,RS,Sul,BUTANTAN/SINOVAC,5292,2690,2602
Arroio Grande,430130,RS,Sul,FIOCRUZ/ASTRAZENECA,4370,4046,324
Arroio Grande,430130,RS,Sul,PFIZER/BIONTECH,623,623,0
Arroio Trinta,420160,SC,Sul,FIOCRUZ/ASTRAZENECA,1131,1036,95
Arroio Trinta,420160,SC,Sul,BUTANTAN/SINOVAC,1002,527,475
Arroio Trinta,420160,SC,Sul,PFIZER/BIONTECH,105,105,0
Artur Nogueira,350380,SP,Sudeste,FIOCRUZ/ASTRAZENECA,9425,8845,580
Artur Nogueira,350380,SP,Sudeste,BUTANTAN/SINOVAC,8887,4846,4041
Artur Nogueira,350380,SP,Sudeste,PFIZER/BIONTECH,719,719,0
Aruanã,520250,GO,Centro-Oeste,BUTANTAN/SINOVAC,1453,752,701
Aruanã,520250,GO,Centro-Oeste,FIOCRUZ/ASTRAZENECA,1446,1365,81
Arujá,350390,SP,Sudeste,FIOCRUZ/ASTRAZENECA,15236,14253,983
Arujá,350390,SP,Sudeste,BUTANTAN/SINOVAC,12659,7036,5623
Arujá,350390,SP,Sudeste,PFIZER/BIONTECH,1356,1352,4
Arvoredo,420165,SC,Sul,FIOCRUZ/ASTRAZENECA,701,648,53
Arvoredo,420165,SC,Sul,BUTANTAN/SINOVAC,615,348,267
Arvoredo,420165,SC,Sul,PFIZER/BIONTECH,70,70,0
Arvorezinha,430140,RS,Sul,FIOCRUZ/ASTRAZENECA,2733,2523,210
Arvorezinha,430140,RS,Sul,BUTANTAN/SINOVAC,2693,1393,1300
Arvorezinha,430140,RS,Sul,PFIZER/BIONTECH,124,124,0
Ascurra,420170,SC,Sul,BUTANTAN/SINOVAC,2227,1116,1111
Ascurra,420170,SC,Sul,FIOCRUZ/ASTRAZENECA,1127,1072,55
Ascurra,420170,SC,Sul,PFIZER/BIONTECH,123,123,0
Aspásia,350395,SP,Sudeste,BUTANTAN/SINOVAC,570,302,268
Aspásia,350395,SP,Sudeste,FIOCRUZ/ASTRAZENECA,565,524,41
Assaí,410190,PR,Sul,FIOCRUZ/ASTRAZENECA,4287,4007,280
Assaí,410190,PR,Sul,BUTANTAN/SINOVAC,3599,1847,1752
Assaí,410190,PR,Sul,PFIZER/BIONTECH,156,156,0
Assaré,230160,CE,Nordeste,BUTANTAN/SINOVAC,4470,2567,1903
Assaré,230160,CE,Nordeste,FIOCRUZ/ASTRAZENECA,1770,1521,249
Assaré,230160,CE,Nordeste,PFIZER/BIONTECH,1,1,0
Assis,350400,SP,Sudeste,BUTANTAN/SINOVAC,33112,16855,16257
Assis,350400,SP,Sudeste,FIOCRUZ/ASTRAZENECA,30424,27498,2926
Assis,350400,SP,Sudeste,PFIZER/BIONTECH,1423,1420,3
Assis Brasil,120005,AC,Norte,BUTANTAN/SINOVAC,2301,1289,1012
Assis Brasil,120005,AC,Norte,FIOCRUZ/ASTRAZENECA,1234,1095,139
Assis Chateaubriand,410200,PR,Sul,FIOCRUZ/ASTRAZENECA,9368,8834,534
Assis Chateaubriand,410200,PR,Sul,BUTANTAN/SINOVAC,8545,4380,4165
Assis Chateaubriand,410200,PR,Sul,PFIZER/BIONTECH,942,942,0
Assunção,250135,PB,Nordeste,BUTANTAN/SINOVAC,961,515,446
Assunção,250135,PB,Nordeste,FIOCRUZ/ASTRAZENECA,626,572,54
Assunção,250135,PB,Nordeste,PFIZER/BIONTECH,82,82,0
Assunção Do Piauí,220105,PI,Nordeste,FIOCRUZ/ASTRAZENECA,1945,1429,516
Assunção Do Piauí,220105,PI,Nordeste,BUTANTAN/SINOVAC,1209,608,601
Astolfo Dutra,310460,MG,Sudeste,BUTANTAN/SINOVAC,2253,1192,1061
Astolfo Dutra,310460,MG,Sudeste,FIOCRUZ/ASTRAZENECA,650,527,123
Astorga,410210,PR,Sul,BUTANTAN/SINOVAC,6003,3083,2920
Astorga,410210,PR,Sul,FIOCRUZ/ASTRAZENECA,5928,5565,363
Astorga,410210,PR,Sul,PFIZER/BIONTECH,722,722,0
Atalaia,270040,AL,Nordeste,FIOCRUZ/ASTRAZENECA,5743,5281,462
Atalaia,270040,AL,Nordeste,BUTANTAN/SINOVAC,5679,2950,2729
Atalaia,270040,AL,Nordeste,PFIZER/BIONTECH,340,340,0
Atalaia,410220,PR,Sul,FIOCRUZ/ASTRAZENECA,1606,1506,100
Atalaia,410220,PR,Sul,BUTANTAN/SINOVAC,1071,563,508
Atalaia,410220,PR,Sul,PFIZER/BIONTECH,21,21,0
Atalaia Do Norte,130020,AM,Norte,BUTANTAN/SINOVAC,4739,2721,2018
Atalaia Do Norte,130020,AM,Norte,FIOCRUZ/ASTRAZENECA,1658,1518,140
Atalanta,420180,SC,Sul,FIOCRUZ/ASTRAZENECA,856,810,46
Atalanta,420180,SC,Sul,BUTANTAN/SINOVAC,812,423,389
Atalanta,420180,SC,Sul,PFIZER/BIONTECH,73,73,0
Ataléia,310470,MG,Sudeste,BUTANTAN/SINOVAC,3584,1886,1698
Ataléia,310470,MG,Sudeste,FIOCRUZ/ASTRAZENECA,1112,928,184
Ataléia,310470,MG,Sudeste,PFIZER/BIONTECH,93,92,1
Atibaia,350410,SP,Sudeste,BUTANTAN/SINOVAC,32991,18271,14720
Atibaia,350410,SP,Sudeste,FIOCRUZ/ASTRAZENECA,27278,24469,2809
Atibaia,350410,SP,Sudeste,PFIZER/BIONTECH,1467,1465,2
Atilio Vivacqua,320070,ES,Sudeste,BUTANTAN/SINOVAC,3305,1729,1576
Atilio Vivacqua,320070,ES,Sudeste,FIOCRUZ/ASTRAZENECA,2352,2252,100
Atilio Vivacqua,320070,ES,Sudeste,PFIZER/BIONTECH,327,327,0
Augustinópolis,170255,TO,Norte,BUTANTAN/SINOVAC,2905,1600,1305
Augustinópolis,170255,TO,Norte,FIOCRUZ/ASTRAZENECA,2797,2503,294
Augusto Corrêa,150090,PA,Norte,FIOCRUZ/ASTRAZENECA,5487,5050,437
Augusto Corrêa,150090,PA,Norte,BUTANTAN/SINOVAC,4063,2452,1611
Augusto De Lima,310480,MG,Sudeste,BUTANTAN/SINOVAC,1122,588,534
Augusto De Lima,310480,MG,Sudeste,FIOCRUZ/ASTRAZENECA,489,449,40
Augusto De Lima,310480,MG,Sudeste,PFIZER/BIONTECH,24,24,0
Augusto Pestana,430150,RS,Sul,BUTANTAN/SINOVAC,2799,1426,1373
Augusto Pestana,430150,RS,Sul,FIOCRUZ/ASTRAZENECA,1924,1653,271
Augusto Pestana,430150,RS,Sul,PFIZER/BIONTECH,265,263,2
Augusto Severo,240130,RN,Nordeste,BUTANTAN/SINOVAC,2999,1584,1415
Augusto Severo,240130,RN,Nordeste,FIOCRUZ/ASTRAZENECA,2583,2434,149
Augusto Severo,240130,RN,Nordeste,PFIZER/BIONTECH,448,448,0
Áurea,430155,RS,Sul,BUTANTAN/SINOVAC,1328,669,659
Áurea,430155,RS,Sul,FIOCRUZ/ASTRAZENECA,969,826,143
Áurea,430155,RS,Sul,PFIZER/BIONTECH,142,142,0
Aurelino Leal,290240,BA,Nordeste,FIOCRUZ/ASTRAZENECA,2221,2045,176
Aurelino Leal,290240,BA,Nordeste,BUTANTAN/SINOVAC,2037,1166,871
Aurelino Leal,290240,BA,Nordeste,PFIZER/BIONTECH,257,257,0
Auriflama,350420,SP,Sudeste,BUTANTAN/SINOVAC,3847,2136,1711
Auriflama,350420,SP,Sudeste,FIOCRUZ/ASTRAZENECA,3284,2949,335
Auriflama,350420,SP,Sudeste,PFIZER/BIONTECH,273,273,0
Aurilândia,520260,GO,Centro-Oeste,FIOCRUZ/ASTRAZENECA,1194,1118,76
Aurilândia,520260,GO,Centro-Oeste,BUTANTAN/SINOVAC,1024,523,501
Aurilândia,520260,GO,Centro-Oeste,PFIZER/BIONTECH,17,17,0
Aurora,230170,CE,Nordeste,BUTANTAN/SINOVAC,4522,2378,2144
Aurora,230170,CE,Nordeste,FIOCRUZ/ASTRAZENECA,2810,2376,434
Aurora,420190,SC,Sul,FIOCRUZ/ASTRAZENECA,1579,1470,109
Aurora,420190,SC,Sul,BUTANTAN/SINOVAC,1265,671,594
Aurora,420190,SC,Sul,PFIZER/BIONTECH,250,250,0
Aurora Do Pará,150095,PA,Norte,FIOCRUZ/ASTRAZENECA,4016,3843,173
Aurora Do Pará,150095,PA,Norte,BUTANTAN/SINOVAC,2743,1485,1258
Aurora Do Tocantins,170270,TO,Norte,BUTANTAN/SINOVAC,853,454,399
Aurora Do Tocantins,170270,TO,Norte,FIOCRUZ/ASTRAZENECA,592,563,29
Autazes,130030,AM,Norte,BUTANTAN/SINOVAC,7285,4063,3222
Autazes,130030,AM,Norte,FIOCRUZ/ASTRAZENECA,5683,4766,917
Avaí,350430,SP,Sudeste,BUTANTAN/SINOVAC,1949,928,1021
Avaí,350430,SP,Sudeste,FIOCRUZ/ASTRAZENECA,1216,1106,110
Avaí,350430,SP,Sudeste,PFIZER/BIONTECH,181,181,0
Avanhandava,350440,SP,Sudeste,FIOCRUZ/ASTRAZENECA,2598,2439,159
Avanhandava,350440,SP,Sudeste,BUTANTAN/SINOVAC,2229,1216,1013
Avanhandava,350440,SP,Sudeste,PFIZER/BIONTECH,289,289,0
Avaré,350450,SP,Sudeste,BUTANTAN/SINOVAC,22199,12338,9861
Avaré,350450,SP,Sudeste,FIOCRUZ/ASTRAZENECA,20001,18368,1633
Avaré,350450,SP,Sudeste,PFIZER/BIONTECH,2010,2010,0
Aveiro,150100,PA,Norte,FIOCRUZ/ASTRAZENECA,1956,1804,152
Aveiro,150100,PA,Norte,BUTANTAN/SINOVAC,1156,600,556
Avelino Lopes,220110,PI,Nordeste,BUTANTAN/SINOVAC,2029,1029,1000
Avelino Lopes,220110,PI,Nordeste,FIOCRUZ/ASTRAZENECA,2018,1891,127
Avelino Lopes,220110,PI,Nordeste,PFIZER/BIONTECH,118,118,0
Avelinópolis,520280,GO,Centro-Oeste,FIOCRUZ/ASTRAZENECA,1034,969,65
Avelinópolis,520280,GO,Centro-Oeste,BUTANTAN/SINOVAC,678,363,315
Axixá,210110,MA,Nordeste,FIOCRUZ/ASTRAZENECA,4589,3764,825
Axixá,210110,MA,Nordeste,BUTANTAN/SINOVAC,1804,929,875
Axixá Do Tocantins,170290,TO,Norte,BUTANTAN/SINOVAC,1750,977,773
Axixá Do Tocantins,170290,TO,Norte,FIOCRUZ/ASTRAZENECA,1567,1512,55
Babaçulândia,170300,TO,Norte,BUTANTAN/SINOVAC,1884,1015,869
Babaçulândia,170300,TO,Norte,FIOCRUZ/ASTRAZENECA,991,948,43
Bacabal,210120,MA,Nordeste,FIOCRUZ/ASTRAZENECA,23472,21623,1849
Bacabal,210120,MA,Nordeste,BUTANTAN/SINOVAC,15610,8322,7288
Bacabal,210120,MA,Nordeste,PFIZER/BIONTECH,230,230,0
Bacabeira,210125,MA,Nordeste,FIOCRUZ/ASTRAZENECA,2544,2344,200
Bacabeira,210125,MA,Nordeste,BUTANTAN/SINOVAC,1976,1016,960
Bacuri,210130,MA,Nordeste,FIOCRUZ/ASTRAZENECA,4024,3567,457
Bacuri,210130,MA,Nordeste,BUTANTAN/SINOVAC,3024,1579,1445
Bacurituba,210135,MA,Nordeste,FIOCRUZ/ASTRAZENECA,2126,1778,348
Bacurituba,210135,MA,Nordeste,BUTANTAN/SINOVAC,961,500,461
Bady Bassitt,350460,SP,Sudeste,BUTANTAN/SINOVAC,4424,2535,1889
Bady Bassitt,350460,SP,Sudeste,FIOCRUZ/ASTRAZENECA,4062,3762,300
Bady Bassitt,350460,SP,Sudeste,PFIZER/BIONTECH,238,238,0
Baependi,310490,MG,Sudeste,BUTANTAN/SINOVAC,5123,2612,2511
Baependi,310490,MG,Sudeste,FIOCRUZ/ASTRAZENECA,4736,4329,407
Bagé,430160,RS,Sul,FIOCRUZ/ASTRAZENECA,32570,30257,2313
Bagé,430160,RS,Sul,BUTANTAN/SINOVAC,28293,16031,12262
Bagé,430160,RS,Sul,PFIZER/BIONTECH,1793,1792,1
Bagre,150110,PA,Norte,FIOCRUZ/ASTRAZENECA,5267,4761,506
Bagre,150110,PA,Norte,BUTANTAN/SINOVAC,950,489,461
Baía Da Traição,250140,PB,Nordeste,BUTANTAN/SINOVAC,7266,3777,3489
Baía Da Traição,250140,PB,Nordeste,FIOCRUZ/ASTRAZENECA,2200,2122,78
Baía Da Traição,250140,PB,Nordeste,PFIZER/BIONTECH,209,209,0
Baía Formosa,240140,RN,Nordeste,FIOCRUZ/ASTRAZENECA,2123,1716,407
Baía Formosa,240140,RN,Nordeste,BUTANTAN/SINOVAC,1336,719,617
Baía Formosa,240140,RN,Nordeste,PFIZER/BIONTECH,202,202,0
Baianópolis,290250,BA,Nordeste,FIOCRUZ/ASTRAZENECA,2934,2681,253
Baianópolis,290250,BA,Nordeste,BUTANTAN/SINOVAC,2055,1121,934
Baianópolis,290250,BA,Nordeste,PFIZER/BIONTECH,121,120,1
Baião,150120,PA,Norte,FIOCRUZ/ASTRAZENECA,7703,7162,541
Baião,150120,PA,Norte,BUTANTAN/SINOVAC,3295,1685,1610
Baixa Grande,290260,BA,Nordeste,BUTANTAN/SINOVAC,4076,2156,1920
Baixa Grande,290260,BA,Nordeste,FIOCRUZ/ASTRAZENECA,2983,2762,221
Baixa Grande Do Ribeiro,220115,PI,Nordeste,FIOCRUZ/ASTRAZENECA,1688,1606,82
Baixa Grande Do Ribeiro,220115,PI,Nordeste,BUTANTAN/SINOVAC,1190,697,493
Baixio,230180,CE,Nordeste,BUTANTAN/SINOVAC,1353,677,676
Baixio,230180,CE,Nordeste,FIOCRUZ/ASTRAZENECA,967,911,56
Baixo Guandu,320080,ES,Sudeste,BUTANTAN/SINOVAC,9455,5143,4312
Baixo Guandu,320080,ES,Sudeste,FIOCRUZ/ASTRAZENECA,7021,6714,307
Baixo Guandu,320080,ES,Sudeste,PFIZER/BIONTECH,1302,1301,1
Balbinos,350470,SP,Sudeste,FIOCRUZ/ASTRAZENECA,1243,1186,57
Balbinos,350470,SP,Sudeste,BUTANTAN/SINOVAC,978,619,359
Balbinos,350470,SP,Sudeste,PFIZER/BIONTECH,5,5,0
Baldim,310500,MG,Sudeste,FIOCRUZ/ASTRAZENECA,2030,1899,131
Baldim,310500,MG,Sudeste,BUTANTAN/SINOVAC,1731,872,859
Baldim,310500,MG,Sudeste,PFIZER/BIONTECH,92,92,0
Baliza,520310,GO,Centro-Oeste,FIOCRUZ/ASTRAZENECA,1008,969,39
Baliza,520310,GO,Centro-Oeste,BUTANTAN/SINOVAC,666,345,321
Balneário Arroio Do Silva,420195,SC,Sul,FIOCRUZ/ASTRAZENECA,3514,3230,284
Balneário Arroio Do Silva,420195,SC,Sul,BUTANTAN/SINOVAC,3174,1631,1543
Balneário Barra Do Sul,420205,SC,Sul,FIOCRUZ/ASTRAZENECA,4021,3570,451
Balneário Barra Do Sul,420205,SC,Sul,BUTANTAN/SINOVAC,2942,1539,1403
Balneário Barra Do Sul,420205,SC,Sul,PFIZER/BIONTECH,343,343,0
Balneário Camboriú,420200,SC,Sul,BUTANTAN/SINOVAC,38066,19563,18503
Balneário Camboriú,420200,SC,Sul,FIOCRUZ/ASTRAZENECA,23852,22649,1203
Balneário Camboriú,420200,SC,Sul,PFIZER/BIONTECH,8201,8199,2
Balneário Gaivota,420207,SC,Sul,FIOCRUZ/ASTRAZENECA,3109,2989,120
Balneário Gaivota,420207,SC,Sul,BUTANTAN/SINOVAC,2649,1399,1250
Balneário Gaivota,420207,SC,Sul,PFIZER/BIONTECH,92,92,0
Balneário Piçarras,421280,SC,Sul,BUTANTAN/SINOVAC,5684,2966,2718
Balneário Piçarras,421280,SC,Sul,FIOCRUZ/ASTRAZENECA,5460,5328,132
Balneário Piçarras,421280,SC,Sul,PFIZER/BIONTECH,580,580,0
Balneário Pinhal,430163,RS,Sul,BUTANTAN/SINOVAC,4985,2695,2290
Balneário Pinhal,430163,RS,Sul,FIOCRUZ/ASTRAZENECA,3843,3531,312
Balneário Pinhal,430163,RS,Sul,PFIZER/BIONTECH,310,310,0
Balneário Rincão,422000,SC,Sul,FIOCRUZ/ASTRAZENECA,3821,3720,101
Balneário Rincão,422000,SC,Sul,BUTANTAN/SINOVAC,2755,1408,1347
Balneário Rincão,422000,SC,Sul,PFIZER/BIONTECH,149,149,0
Balsa Nova,410230,PR,Sul,FIOCRUZ/ASTRAZENECA,2560,2471,89
Balsa Nova,410230,PR,Sul,BUTANTAN/SINOVAC,2236,1171,1065
Bálsamo,350480,SP,Sudeste,BUTANTAN/SINOVAC,2541,1360,1181
Bálsamo,350480,SP,Sudeste,FIOCRUZ/ASTRAZENECA,2185,1901,284
Bálsamo,350480,SP,Sudeste,PFIZER/BIONTECH,180,180,0
Balsas,210140,MA,Nordeste,PFIZER/BIONTECH,13573,13570,3
Balsas,210140,MA,Nordeste,FIOCRUZ/ASTRAZENECA,11230,10077,1153
Balsas,210140,MA,Nordeste,BUTANTAN/SINOVAC,10620,5453,5167
Bambuí,310510,MG,Sudeste,BUTANTAN/SINOVAC,5474,2886,2588
Bambuí,310510,MG,Sudeste,FIOCRUZ/ASTRAZENECA,2999,2961,38
Banabuiú,230185,CE,Nordeste,BUTANTAN/SINOVAC,3127,1590,1537
Banabuiú,230185,CE,Nordeste,FIOCRUZ/ASTRAZENECA,1262,991,271
Bananal,350490,SP,Sudeste,BUTANTAN/SINOVAC,3056,1674,1382
Bananal,350490,SP,Sudeste,FIOCRUZ/ASTRAZENECA,2156,1856,300
Bananal,350490,SP,Sudeste,PFIZER/BIONTECH,194,194,0
Bananeiras,250150,PB,Nordeste,BUTANTAN/SINOVAC,4874,2573,2301
Bananeiras,250150,PB,Nordeste,FIOCRUZ/ASTRAZENECA,3339,3073,266
Bananeiras,250150,PB,Nordeste,PFIZER/BIONTECH,464,464,0
Bandeira,310520,MG,Sudeste,BUTANTAN/SINOVAC,1277,652,625
Bandeira,310520,MG,Sudeste,FIOCRUZ/ASTRAZENECA,884,800,84
Bandeira,310520,MG,Sudeste,PFIZER/BIONTECH,27,27,0
Bandeira Do Sul,310530,MG,Sudeste,FIOCRUZ/ASTRAZENECA,1310,1220,90
Bandeira Do Sul,310530,MG,Sudeste,BUTANTAN/SINOVAC,1104,555,549
Bandeira Do Sul,310530,MG,Sudeste,PFIZER/BIONTECH,112,112,0
Bandeirante,420208,SC,Sul,BUTANTAN/SINOVAC,863,452,411
Bandeirante,420208,SC,Sul,FIOCRUZ/ASTRAZENECA,793,709,84
Bandeirante,420208,SC,Sul,PFIZER/BIONTECH,68,68,0
Bandeirantes,410240,PR,Sul,BUTANTAN/SINOVAC,7191,3840,3351
Bandeirantes,410240,PR,Sul,FIOCRUZ/ASTRAZENECA,6811,6292,519
Bandeirantes,410240,PR,Sul,PFIZER/BIONTECH,1771,1771,0
Bandeirantes,500150,MS,Centro-Oeste,FIOCRUZ/ASTRAZENECA,1797,1550,247
Bandeirantes,500150,MS,Centro-Oeste,BUTANTAN/SINOVAC,1641,844,797
Bandeirantes,500150,MS,Centro-Oeste,PFIZER/BIONTECH,238,238,0
Bandeirantes Do Tocantins,170305,TO,Norte,BUTANTAN/SINOVAC,567,287,280
Bandeirantes Do Tocantins,170305,TO,Norte,FIOCRUZ/ASTRAZENECA,394,374,20
Bannach,150125,PA,Norte,FIOCRUZ/ASTRAZENECA,611,450,161
Bannach,150125,PA,Norte,BUTANTAN/SINOVAC,545,308,237
Banzaê,290265,BA,Nordeste,BUTANTAN/SINOVAC,5390,2744,2646
Banzaê,290265,BA,Nordeste,FIOCRUZ/ASTRAZENECA,3218,2872,346
Banzaê,290265,BA,Nordeste,PFIZER/BIONTECH,168,168,0
Barão,430165,RS,Sul,BUTANTAN/SINOVAC,1656,859,797
Barão,430165,RS,Sul,FIOCRUZ/ASTRAZENECA,1207,1097,110
Barão,430165,RS,Sul,PFIZER/BIONTECH,162,162,0
Barão De Antonina,350500,SP,Sudeste,BUTANTAN/SINOVAC,986,540,446
Barão De Antonina,350500,SP,Sudeste,FIOCRUZ/ASTRAZENECA,949,881,68
Barão De Antonina,350500,SP,Sudeste,PFIZER/BIONTECH,116,116,0
Barão De Cocais,310540,MG,Sudeste,BUTANTAN/SINOVAC,5053,2586,2467
Barão De Cocais,310540,MG,Sudeste,FIOCRUZ/ASTRAZENECA,4613,4220,393
Barão De Cocais,310540,MG,Sudeste,PFIZER/BIONTECH,496,480,16
Barão De Cotegipe,430170,RS,Sul,BUTANTAN/SINOVAC,2257,1131,1126
Barão De Cotegipe,430170,RS,Sul,FIOCRUZ/ASTRAZENECA,1632,1401,231
Barão De Cotegipe,430170,RS,Sul,PFIZER/BIONTECH,240,240,0
Barão De Grajaú,210150,MA,Nordeste,FIOCRUZ/ASTRAZENECA,3316,3140,176
Barão De Grajaú,210150,MA,Nordeste,BUTANTAN/SINOVAC,2823,1634,1189
Barão De Melgaço,510160,MT,Centro-Oeste,BUTANTAN/SINOVAC,1907,1013,894
Barão De Melgaço,510160,MT,Centro-Oeste,FIOCRUZ/ASTRAZENECA,1258,1201,57
Barão De Melgaço,510160,MT,Centro-Oeste,PFIZER/BIONTECH,6,6,0
Barão De Monte Alto,310550,MG,Sudeste,BUTANTAN/SINOVAC,1782,919,863
Barão De Monte Alto,310550,MG,Sudeste,FIOCRUZ/ASTRAZENECA,1389,1237,152
Barão De Monte Alto,310550,MG,Sudeste,PFIZER/BIONTECH,39,39,0
Barão Do Triunfo,430175,RS,Sul,FIOCRUZ/ASTRAZENECA,1493,1412,81
Barão Do Triunfo,430175,RS,Sul,BUTANTAN/SINOVAC,1431,743,688
Barão Do Triunfo,430175,RS,Sul,PFIZER/BIONTECH,165,165,0
Baraúna,240145,RN,Nordeste,FIOCRUZ/ASTRAZENECA,3898,3640,258
Baraúna,240145,RN,Nordeste,BUTANTAN/SINOVAC,3836,1937,1899
Baraúna,240145,RN,Nordeste,PFIZER/BIONTECH,256,256,0
Baraúna,250153,PB,Nordeste,BUTANTAN/SINOVAC,1169,605,564
Baraúna,250153,PB,Nordeste,FIOCRUZ/ASTRAZENECA,740,653,87
Baraúna,250153,PB,Nordeste,PFIZER/BIONTECH,18,18,0
Barbacena,310560,MG,Sudeste,BUTANTAN/SINOVAC,33665,17268,16397
Barbacena,310560,MG,Sudeste,FIOCRUZ/ASTRAZENECA,22906,18873,4033
Barbacena,310560,MG,Sudeste,PFIZER/BIONTECH,2813,2809,4
Barbalha,230190,CE,Nordeste,BUTANTAN/SINOVAC,11611,6323,5288
Barbalha,230190,CE,Nordeste,FIOCRUZ/ASTRAZENECA,2795,2449,346
Barbosa,350510,SP,Sudeste,FIOCRUZ/ASTRAZENECA,1452,1335,117
Barbosa,350510,SP,Sudeste,BUTANTAN/SINOVAC,1407,801,606
Barbosa,350510,SP,Sudeste,PFIZER/BIONTECH,177,177,0
Barbosa Ferraz,410250,PR,Sul,FIOCRUZ/ASTRAZENECA,3342,3136,206
Barbosa Ferraz,410250,PR,Sul,BUTANTAN/SINOVAC,3071,1583,1488
Barbosa Ferraz,410250,PR,Sul,PFIZER/BIONTECH,8,8,0
Barcarena,150130,PA,Norte,FIOCRUZ/ASTRAZENECA,18805,16650,2155
Barcarena,150130,PA,Norte,BUTANTAN/SINOVAC,11963,6216,5747
Barcelona,240150,RN,Nordeste,BUTANTAN/SINOVAC,974,491,483
Barcelona,240150,RN,Nordeste,FIOCRUZ/ASTRAZENECA,789,721,68
Barcelona,240150,RN,Nordeste,PFIZER/BIONTECH,97,97,0
Barcelos,130040,AM,Norte,BUTANTAN/SINOVAC,7322,4445,2877
Barcelos,130040,AM,Norte,FIOCRUZ/ASTRAZENECA,1765,1440,325
Bariri,350520,SP,Sudeste,BUTANTAN/SINOVAC,9446,4624,4822
Bariri,350520,SP,Sudeste,FIOCRUZ/ASTRAZENECA,9419,8433,986
Bariri,350520,SP,Sudeste,PFIZER/BIONTECH,665,665,0
Barra,290270,BA,Nordeste,FIOCRUZ/ASTRAZENECA,9215,8230,985
Barra,290270,BA,Nordeste,BUTANTAN/SINOVAC,6860,3709,3151
Barra,290270,BA,Nordeste,PFIZER/BIONTECH,343,343,0
Barra Bonita,350530,SP,Sudeste,FIOCRUZ/ASTRAZENECA,10136,9390,746
Barra Bonita,350530,SP,Sudeste,BUTANTAN/SINOVAC,9236,4695,4541
Barra Bonita,350530,SP,Sudeste,PFIZER/BIONTECH,975,975,0
Barra Bonita,420209,SC,Sul,FIOCRUZ/ASTRAZENECA,616,557,59
Barra Bonita,420209,SC,Sul,BUTANTAN/SINOVAC,560,291,269
Barra D'Alcântara,220117,PI,Nordeste,FIOCRUZ/ASTRAZENECA,819,761,58
Barra D'Alcântara,220117,PI,Nordeste,BUTANTAN/SINOVAC,800,412,388
Barra D'Alcântara,220117,PI,Nordeste,PFIZER/BIONTECH,96,96,0
Barra Da Estiva,290280,BA,Nordeste,FIOCRUZ/ASTRAZENECA,3732,3501,231
Barra Da Estiva,290280,BA,Nordeste,BUTANTAN/SINOVAC,3277,1743,1534
Barra Da Estiva,290280,BA,Nordeste,PFIZER/BIONTECH,337,337,0
Barra De Guabiraba,260130,PE,Nordeste,BUTANTAN/SINOVAC,1792,955,837
Barra De Guabiraba,260130,PE,Nordeste,FIOCRUZ/ASTRAZENECA,1717,1639,78
Barra De Guabiraba,260130,PE,Nordeste,PFIZER/BIONTECH,240,240,0
Barra De Santa Rosa,250160,PB,Nordeste,BUTANTAN/SINOVAC,3416,1877,1539
Barra De Santa Rosa,250160,PB,Nordeste,FIOCRUZ/ASTRAZENECA,2441,2193,248
Barra De Santa Rosa,250160,PB,Nordeste,PFIZER/BIONTECH,70,70,0
Barra De Santana,250157,PB,Nordeste,BUTANTAN/SINOVAC,2315,1171,1144
Barra De Santana,250157,PB,Nordeste,FIOCRUZ/ASTRAZENECA,1650,1494,156
Barra De Santana,250157,PB,Nordeste,PFIZER/BIONTECH,70,70,0
Barra De Santo Antônio,270050,AL,Nordeste,FIOCRUZ/ASTRAZENECA,2139,1939,200
Barra De Santo Antônio,270050,AL,Nordeste,BUTANTAN/SINOVAC,1985,1035,950
Barra De São Francisco,320090,ES,Sudeste,FIOCRUZ/ASTRAZENECA,12542,12136,406
Barra De São Francisco,320090,ES,Sudeste,BUTANTAN/SINOVAC,10609,5870,4739
Barra De São Francisco,320090,ES,Sudeste,PFIZER/BIONTECH,971,971,0
Barra De São Miguel,250170,PB,Nordeste,BUTANTAN/SINOVAC,1497,777,720
Barra De São Miguel,250170,PB,Nordeste,FIOCRUZ/ASTRAZENECA,1022,954,68
Barra De São Miguel,250170,PB,Nordeste,PFIZER/BIONTECH,82,82,0
Barra De São Miguel,270060,AL,Nordeste,FIOCRUZ/ASTRAZENECA,1011,940,71
Barra De São Miguel,270060,AL,Nordeste,BUTANTAN/SINOVAC,944,549,395
Barra Do Bugres,510170,MT,Centro-Oeste,FIOCRUZ/ASTRAZENECA,4039,3783,256
Barra Do Bugres,510170,MT,Centro-Oeste,BUTANTAN/SINOVAC,3296,1730,1566
Barra Do Bugres,510170,MT,Centro-Oeste,PFIZER/BIONTECH,291,291,0
Barra Do Chapéu,350535,SP,Sudeste,FIOCRUZ/ASTRAZENECA,1143,1063,80
Barra Do Chapéu,350535,SP,Sudeste,BUTANTAN/SINOVAC,952,521,431
Barra Do Chapéu,350535,SP,Sudeste,PFIZER/BIONTECH,166,166,0
Barra Do Choça,290290,BA,Nordeste,BUTANTAN/SINOVAC,802,489,313
Barra Do Choça,290290,BA,Nordeste,FIOCRUZ/ASTRAZENECA,549,537,12
Barra Do Choça,290290,BA,Nordeste,PFIZER/BIONTECH,12,12,0
Barra Do Corda,210160,MA,Nordeste,BUTANTAN/SINOVAC,22045,12031,10014
Barra Do Corda,210160,MA,Nordeste,FIOCRUZ/ASTRAZENECA,12635,11947,688
Barra Do Corda,210160,MA,Nordeste,PFIZER/BIONTECH,365,365,0
Barra Do Garças,510180,MT,Centro-Oeste,BUTANTAN/SINOVAC,14687,7666,7021
Barra Do Garças,510180,MT,Centro-Oeste,FIOCRUZ/ASTRAZENECA,11779,11108,671
Barra Do Garças,510180,MT,Centro-Oeste,PFIZER/BIONTECH,403,402,1
Barra Do Guarita,430185,RS,Sul,BUTANTAN/SINOVAC,806,406,400
Barra Do Guarita,430185,RS,Sul,FIOCRUZ/ASTRAZENECA,679,616,63
Barra Do Guarita,430185,RS,Sul,PFIZER/BIONTECH,103,103,0
Barra Do Jacaré,410270,PR,Sul,FIOCRUZ/ASTRAZENECA,902,871,31
Barra Do Jacaré,410270,PR,Sul,BUTANTAN/SINOVAC,885,493,392
Barra Do Mendes,290300,BA,Nordeste,FIOCRUZ/ASTRAZENECA,4283,3593,690
Barra Do Mendes,290300,BA,Nordeste,BUTANTAN/SINOVAC,3341,1722,1619
Barra Do Mendes,290300,BA,Nordeste,PFIZER/BIONTECH,169,160,9
Barra Do Ouro,170307,TO,Norte,BUTANTAN/SINOVAC,709,368,341
Barra Do Ouro,170307,TO,Norte,FIOCRUZ/ASTRAZENECA,434,405,29
Barra Do Piraí,330030,RJ,Sudeste,BUTANTAN/SINOVAC,16923,9910,7013
Barra Do Piraí,330030,RJ,Sudeste,FIOCRUZ/ASTRAZENECA,10618,10077,541
Barra Do Piraí,330030,RJ,Sudeste,PFIZER/BIONTECH,71,71,0
Barra Do Quaraí,430187,RS,Sul,FIOCRUZ/ASTRAZENECA,866,825,41
Barra Do Quaraí,430187,RS,Sul,BUTANTAN/SINOVAC,855,444,411
Barra Do Quaraí,430187,RS,Sul,PFIZER/BIONTECH,115,115,0
Barra Do Ribeiro,430190,RS,Sul,BUTANTAN/SINOVAC,8593,4501,4092
Barra Do Ribeiro,430190,RS,Sul,FIOCRUZ/ASTRAZENECA,3516,3185,331
Barra Do Ribeiro,430190,RS,Sul,PFIZER/BIONTECH,303,303,0
Barra Do Rio Azul,430192,RS,Sul,BUTANTAN/SINOVAC,1231,657,574
Barra Do Rio Azul,430192,RS,Sul,FIOCRUZ/ASTRAZENECA,826,706,120
Barra Do Rio Azul,430192,RS,Sul,PFIZER/BIONTECH,83,83,0
Barra Do Rocha,290310,BA,Nordeste,FIOCRUZ/ASTRAZENECA,939,892,47
Barra Do Rocha,290310,BA,Nordeste,BUTANTAN/SINOVAC,887,481,406
Barra Do Rocha,290310,BA,Nordeste,PFIZER/BIONTECH,22,22,0
Barra Do Turvo,350540,SP,Sudeste,BUTANTAN/SINOVAC,2736,1442,1294
Barra Do Turvo,350540,SP,Sudeste,FIOCRUZ/ASTRAZENECA,1013,914,99
Barra Do Turvo,350540,SP,Sudeste,PFIZER/BIONTECH,35,35,0
Barra Dos Coqueiros,280060,SE,Nordeste,FIOCRUZ/ASTRAZENECA,6285,5882,403
Barra Dos Coqueiros,280060,SE,Nordeste,BUTANTAN/SINOVAC,5121,2703,2418
Barra Dos Coqueiros,280060,SE,Nordeste,PFIZER/BIONTECH,681,681,0
Barra Funda,430195,RS,Sul,BUTANTAN/SINOVAC,786,395,391
Barra Funda,430195,RS,Sul,FIOCRUZ/ASTRAZENECA,680,611,69
Barra Funda,430195,RS,Sul,PFIZER/BIONTECH,102,102,0
Barra Longa,310570,MG,Sudeste,BUTANTAN/SINOVAC,1689,863,826
Barra Longa,310570,MG,Sudeste,FIOCRUZ/ASTRAZENECA,1553,1411,142
Barra Longa,310570,MG,Sudeste,PFIZER/BIONTECH,57,57,0
Barra Mansa,330040,RJ,Sudeste,BUTANTAN/SINOVAC,43191,22563,20628
Barra Mansa,330040,RJ,Sudeste,FIOCRUZ/ASTRAZENECA,26015,24662,1353
Barra Mansa,330040,RJ,Sudeste,PFIZER/BIONTECH,1529,1527,2
Barra Velha,420210,SC,Sul,FIOCRUZ/ASTRAZENECA,7834,7088,746
Barra Velha,420210,SC,Sul,BUTANTAN/SINOVAC,4701,2477,2224
Barra Velha,420210,SC,Sul,PFIZER/BIONTECH,492,492,0
Barracão,410260,PR,Sul,FIOCRUZ/ASTRAZENECA,2901,2785,116
Barracão,410260,PR,Sul,BUTANTAN/SINOVAC,2123,1092,1031
Barracão,410260,PR,Sul,PFIZER/BIONTECH,302,302,0
Barracão,430180,RS,Sul,FIOCRUZ/ASTRAZENECA,1523,1326,197
Barracão,430180,RS,Sul,BUTANTAN/SINOVAC,1348,691,657
Barracão,430180,RS,Sul,PFIZER/BIONTECH,210,210,0
Barras,220120,PI,Nordeste,FIOCRUZ/ASTRAZENECA,6622,5991,631
Barras,220120,PI,Nordeste,BUTANTAN/SINOVAC,6613,3761,2852
Barras,220120,PI,Nordeste,PFIZER/BIONTECH,304,304,0
Barreira,230195,CE,Nordeste,BUTANTAN/SINOVAC,3532,1816,1716
Barreira,230195,CE,Nordeste,FIOCRUZ/ASTRAZENECA,1349,1119,230
Barreiras,290320,BA,Nordeste,BUTANTAN/SINOVAC,17225,9432,7793
Barreiras,290320,BA,Nordeste,FIOCRUZ/ASTRAZENECA,14646,13020,1626
Barreiras,290320,BA,Nordeste,PFIZER/BIONTECH,90,90,0
Barreiras Do Piauí,220130,PI,Nordeste,BUTANTAN/SINOVAC,510,264,246
Barreiras Do Piauí,220130,PI,Nordeste,FIOCRUZ/ASTRAZENECA,453,434,19
Barreirinha,130050,AM,Norte,FIOCRUZ/ASTRAZENECA,8582,8360,222
Barreirinha,130050,AM,Norte,BUTANTAN/SINOVAC,6092,3482,2610
Barreirinhas,210170,MA,Nordeste,FIOCRUZ/ASTRAZENECA,14143,13613,530
Barreirinhas,210170,MA,Nordeste,BUTANTAN/SINOVAC,5018,2774,2244
Barreiros,260140,PE,Nordeste,BUTANTAN/SINOVAC,4766,2490,2276
Barreiros,260140,PE,Nordeste,FIOCRUZ/ASTRAZENECA,4654,4320,334
Barreiros,260140,PE,Nordeste,PFIZER/BIONTECH,211,211,0
Barretos,350550,SP,Sudeste,FIOCRUZ/ASTRAZENECA,33131,30256,2875
Barretos,350550,SP,Sudeste,BUTANTAN/SINOVAC,32678,17224,15454
Barretos,350550,SP,Sudeste,PFIZER/BIONTECH,1108,1108,0
Barrinha,350560,SP,Sudeste,FIOCRUZ/ASTRAZENECA,5533,5218,315
Barrinha,350560,SP,Sudeste,BUTANTAN/SINOVAC,3760,2012,1748
Barrinha,350560,SP,Sudeste,PFIZER/BIONTECH,616,616,0
Barro,230200,CE,Nordeste,BUTANTAN/SINOVAC,4419,2379,2040
Barro,230200,CE,Nordeste,FIOCRUZ/ASTRAZENECA,3463,3009,454
Barro Alto,290323,BA,Nordeste,FIOCRUZ/ASTRAZENECA,4974,4546,428
Barro Alto,290323,BA,Nordeste,BUTANTAN/SINOVAC,2774,1443,1331
Barro Alto,290323,BA,Nordeste,PFIZER/BIONTECH,107,107,0
Barro Alto,520320,GO,Centro-Oeste,FIOCRUZ/ASTRAZENECA,1999,1884,115
Barro Alto,520320,GO,Centro-Oeste,BUTANTAN/SINOVAC,1084,561,523
Barro Duro,220140,PI,Nordeste,BUTANTAN/SINOVAC,1341,758,583
Barro Duro,220140,PI,Nordeste,FIOCRUZ/ASTRAZENECA,1237,1155,82
Barro Preto,290330,BA,Nordeste,BUTANTAN/SINOVAC,2085,1199,886
Barro Preto,290330,BA,Nordeste,FIOCRUZ/ASTRAZENECA,1628,1567,61
Barro Preto,290330,BA,Nordeste,PFIZER/BIONTECH,48,48,0
Barrocas,290327,BA,Nordeste,BUTANTAN/SINOVAC,2868,1671,1197
Barrocas,290327,BA,Nordeste,FIOCRUZ/ASTRAZENECA,2614,2252,362
Barrocas,290327,BA,Nordeste,PFIZER/BIONTECH,373,372,1
Barrolândia,170310,TO,Norte,BUTANTAN/SINOVAC,1067,538,529
Barrolândia,170310,TO,Norte,FIOCRUZ/ASTRAZENECA,928,892,36
Barroquinha,230205,CE,Nordeste,BUTANTAN/SINOVAC,1763,1077,686
Barroquinha,230205,CE,Nordeste,FIOCRUZ/ASTRAZENECA,687,578,109
Barros Cassal,430200,RS,Sul,FIOCRUZ/ASTRAZENECA,2975,2837,138
Barros Cassal,430200,RS,Sul,BUTANTAN/SINOVAC,2341,1193,1148
Barros Cassal,430200,RS,Sul,PFIZER/BIONTECH,129,129,0
Barroso,310590,MG,Sudeste,BUTANTAN/SINOVAC,4414,2318,2096
Barroso,310590,MG,Sudeste,FIOCRUZ/ASTRAZENECA,4170,3840,330
Barueri,350570,SP,Sudeste,FIOCRUZ/ASTRAZENECA,60302,56204,4098
Barueri,350570,SP,Sudeste,BUTANTAN/SINOVAC,50357,28533,21824
Barueri,350570,SP,Sudeste,PFIZER/BIONTECH,640,640,0
Bastos,350580,SP,Sudeste,FIOCRUZ/ASTRAZENECA,6293,5752,541
Bastos,350580,SP,Sudeste,BUTANTAN/SINOVAC,5571,3089,2482
Bastos,350580,SP,Sudeste,PFIZER/BIONTECH,592,591,1
Bataguassu,500190,MS,Centro-Oeste,FIOCRUZ/ASTRAZENECA,4401,3830,571
Bataguassu,500190,MS,Centro-Oeste,BUTANTAN/SINOVAC,3668,1968,1700
Bataguassu,500190,MS,Centro-Oeste,PFIZER/BIONTECH,614,614,0
Batalha,220150,PI,Nordeste,BUTANTAN/SINOVAC,3143,1733,1410
Batalha,220150,PI,Nordeste,FIOCRUZ/ASTRAZENECA,2447,2273,174
Batalha,270070,AL,Nordeste,FIOCRUZ/ASTRAZENECA,4053,3788,265
Batalha,270070,AL,Nordeste,BUTANTAN/SINOVAC,2840,1540,1300
Batatais,350590,SP,Sudeste,FIOCRUZ/ASTRAZENECA,17398,16096,1302
Batatais,350590,SP,Sudeste,BUTANTAN/SINOVAC,15103,7928,7175
Batatais,350590,SP,Sudeste,PFIZER/BIONTECH,597,597,0
Batayporã,500200,MS,Centro-Oeste,FIOCRUZ/ASTRAZENECA,3056,2768,288
Batayporã,500200,MS,Centro-Oeste,BUTANTAN/SINOVAC,2612,1361,1251
Batayporã,500200,MS,Centro-Oeste,PFIZER/BIONTECH,399,399,0
Baturité,230210,CE,Nordeste,BUTANTAN/SINOVAC,5088,2796,2292
Baturité,230210,CE,Nordeste,FIOCRUZ/ASTRAZENECA,3129,2747,382
Baturité,230210,CE,Nordeste,PFIZER/BIONTECH,45,45,0
Bauru,350600,SP,Sudeste,FIOCRUZ/ASTRAZENECA,96225,85721,10504
Bauru,350600,SP,Sudeste,BUTANTAN/SINOVAC,91721,48459,43262
Bauru,350600,SP,Sudeste,PFIZER/BIONTECH,7471,7463,8
Bayeux,250180,PB,Nordeste,BUTANTAN/SINOVAC,18104,9362,8742
Bayeux,250180,PB,Nordeste,FIOCRUZ/ASTRAZENECA,13207,12189,1018
Bayeux,250180,PB,Nordeste,PFIZER/BIONTECH,1669,1665,4
Bebedouro,350610,SP,Sudeste,BUTANTAN/SINOVAC,19603,10716,8887
Bebedouro,350610,SP,Sudeste,FIOCRUZ/ASTRAZENECA,18301,16320,1981
Bebedouro,350610,SP,Sudeste,PFIZER/BIONTECH,883,881,2
Beberibe,230220,CE,Nordeste,BUTANTAN/SINOVAC,8897,4509,4388
Beberibe,230220,CE,Nordeste,FIOCRUZ/ASTRAZENECA,4931,4204,727
Bela Cruz,230230,CE,Nordeste,BUTANTAN/SINOVAC,5514,2839,2675
Bela Cruz,230230,CE,Nordeste,FIOCRUZ/ASTRAZENECA,4012,3498,514
Bela Vista,500210,MS,Centro-Oeste,BUTANTAN/SINOVAC,6051,3171,2880
Bela Vista,500210,MS,Centro-Oeste,FIOCRUZ/ASTRAZENECA,5367,4946,421
Bela Vista,500210,MS,Centro-Oeste,PFIZER/BIONTECH,255,255,0
Bela Vista Da Caroba,410275,PR,Sul,FIOCRUZ/ASTRAZENECA,1431,1388,43
Bela Vista Da Caroba,410275,PR,Sul,BUTANTAN/SINOVAC,964,502,462
Bela Vista De Goiás,520330,GO,Centro-Oeste,FIOCRUZ/ASTRAZENECA,6254,5892,362
Bela Vista De Goiás,520330,GO,Centro-Oeste,BUTANTAN/SINOVAC,4876,2584,2292
Bela Vista De Minas,310600,MG,Sudeste,BUTANTAN/SINOVAC,1411,817,594
Bela Vista De Minas,310600,MG,Sudeste,FIOCRUZ/ASTRAZENECA,1234,1215,19
Bela Vista De Minas,310600,MG,Sudeste,PFIZER/BIONTECH,59,59,0
Bela Vista Do Maranhão,210177,MA,Nordeste,FIOCRUZ/ASTRAZENECA,2053,1944,109
Bela Vista Do Maranhão,210177,MA,Nordeste,BUTANTAN/SINOVAC,1984,1158,826
Bela Vista Do Paraíso,410280,PR,Sul,FIOCRUZ/ASTRAZENECA,4690,4423,267
Bela Vista Do Paraíso,410280,PR,Sul,BUTANTAN/SINOVAC,3032,1575,1457
Bela Vista Do Paraíso,410280,PR,Sul,PFIZER/BIONTECH,39,39,0
Bela Vista Do Piauí,220155,PI,Nordeste,FIOCRUZ/ASTRAZENECA,817,768,49
Bela Vista Do Piauí,220155,PI,Nordeste,BUTANTAN/SINOVAC,559,291,268
Bela Vista Do Piauí,220155,PI,Nordeste,PFIZER/BIONTECH,30,30,0
Bela Vista Do Toldo,420213,SC,Sul,FIOCRUZ/ASTRAZENECA,1142,1111,31
Bela Vista Do Toldo,420213,SC,Sul,BUTANTAN/SINOVAC,967,517,450
Bela Vista Do Toldo,420213,SC,Sul,PFIZER/BIONTECH,88,88,0
Belágua,210173,MA,Nordeste,FIOCRUZ/ASTRAZENECA,1821,1687,134
Belágua,210173,MA,Nordeste,BUTANTAN/SINOVAC,960,485,475
Belém,150140,PA,Norte,BUTANTAN/SINOVAC,404152,212511,191641
Belém,150140,PA,Norte,FIOCRUZ/ASTRAZENECA,200038,156621,43417
Belém,150140,PA,Norte,PFIZER/BIONTECH,126130,125860,270
Belém,250190,PB,Nordeste,BUTANTAN/SINOVAC,5038,2722,2316
Belém,250190,PB,Nordeste,FIOCRUZ/ASTRAZENECA,2264,1963,301
Belém,250190,PB,Nordeste,PFIZER/BIONTECH,32,32,0
Belém,270080,AL,Nordeste,FIOCRUZ/ASTRAZENECA,1148,1003,145
Belém,270080,AL,Nordeste,BUTANTAN/SINOVAC,995,556,439
Belém De Maria,260150,PE,Nordeste,FIOCRUZ/ASTRAZENECA,1803,1666,137
Belém De Maria,260150,PE,Nordeste,BUTANTAN/SINOVAC,1644,934,710
Belém De Maria,260150,PE,Nordeste,PFIZER/BIONTECH,102,102,0
Belém Do Brejo Do Cruz,250200,PB,Nordeste,FIOCRUZ/ASTRAZENECA,2025,1892,133
Belém Do Brejo Do Cruz,250200,PB,Nordeste,BUTANTAN/SINOVAC,1590,822,768
Belém Do Brejo Do Cruz,250200,PB,Nordeste,PFIZER/BIONTECH,101,101,0
Belém Do Piauí,220157,PI,Nordeste,BUTANTAN/SINOVAC,730,417,313
Belém Do Piauí,220157,PI,Nordeste,FIOCRUZ/ASTRAZENECA,637,578,59
Belém Do São Francisco,260160,PE,Nordeste,FIOCRUZ/ASTRAZENECA,4830,4511,319
Belém Do São Francisco,260160,PE,Nordeste,BUTANTAN/SINOVAC,4470,2416,2054
Belém Do São Francisco,260160,PE,Nordeste,PFIZER/BIONTECH,433,433,0
Belford Roxo,330045,RJ,Sudeste,BUTANTAN/SINOVAC,56583,30289,26294
Belford Roxo,330045,RJ,Sudeste,FIOCRUZ/ASTRAZENECA,47740,43791,3949
Belford Roxo,330045,RJ,Sudeste,PFIZER/BIONTECH,1991,1990,1
Belmiro Braga,310610,MG,Sudeste,BUTANTAN/SINOVAC,508,373,135
Belmiro Braga,310610,MG,Sudeste,FIOCRUZ/ASTRAZENECA,366,354,12
Belmiro Braga,310610,MG,Sudeste,PFIZER/BIONTECH,11,11,0
Belmonte,290340,BA,Nordeste,BUTANTAN/SINOVAC,2449,1710,739
Belmonte,290340,BA,Nordeste,FIOCRUZ/ASTRAZENECA,896,821,75
Belmonte,420215,SC,Sul,BUTANTAN/SINOVAC,1418,874,544
Belmonte,420215,SC,Sul,FIOCRUZ/ASTRAZENECA,784,709,75
Belo Campo,290350,BA,Nordeste,BUTANTAN/SINOVAC,3632,1929,1703
Belo Campo,290350,BA,Nordeste,FIOCRUZ/ASTRAZENECA,3199,2691,508
Belo Campo,290350,BA,Nordeste,PFIZER/BIONTECH,11,11,0
Belo Horizonte,310620,MG,Sudeste,BUTANTAN/SINOVAC,716003,372958,343045
Belo Horizonte,310620,MG,Sudeste,FIOCRUZ/ASTRAZENECA,532391,470949,61442
Belo Horizonte,310620,MG,Sudeste,PFIZER/BIONTECH,140843,140591,252
Belo Jardim,260170,PE,Nordeste,BUTANTAN/SINOVAC,9281,5073,4208
Belo Jardim,260170,PE,Nordeste,FIOCRUZ/ASTRAZENECA,9085,8475,610
Belo Jardim,260170,PE,Nordeste,PFIZER/BIONTECH,1988,1984,4
Belo Monte,270090,AL,Nordeste,FIOCRUZ/ASTRAZENECA,1178,1046,132
Belo Monte,270090,AL,Nordeste,BUTANTAN/SINOVAC,1149,659,490
Belo Oriente,310630,MG,Sudeste,FIOCRUZ/ASTRAZENECA,4084,3811,273
Belo Oriente,310630,MG,Sudeste,BUTANTAN/SINOVAC,3819,1947,1872
Belo Oriente,310630,MG,Sudeste,PFIZER/BIONTECH,281,281,0
Belo Vale,310640,MG,Sudeste,FIOCRUZ/ASTRAZENECA,2502,2291,211
Belo Vale,310640,MG,Sudeste,BUTANTAN/SINOVAC,1993,1002,991
Belo Vale,310640,MG,Sudeste,PFIZER/BIONTECH,63,63,0
Belterra,150145,PA,Norte,FIOCRUZ/ASTRAZENECA,4986,3622,1364
Belterra,150145,PA,Norte,BUTANTAN/SINOVAC,1388,707,681
Beneditinos,220160,PI,Nordeste,BUTANTAN/SINOVAC,1920,1010,910
Beneditinos,220160,PI,Nordeste,FIOCRUZ/ASTRAZENECA,665,624,41
Benedito Leite,210180,MA,Nordeste,FIOCRUZ/ASTRAZENECA,1147,1018,129
Benedito Leite,210180,MA,Nordeste,BUTANTAN/SINOVAC,1013,518,495
Benedito Novo,420220,SC,Sul,BUTANTAN/SINOVAC,1776,824,952
Benedito Novo,420220,SC,Sul,FIOCRUZ/ASTRAZENECA,1411,1365,46
Benevides,150150,PA,Norte,BUTANTAN/SINOVAC,10375,5808,4567
Benevides,150150,PA,Norte,FIOCRUZ/ASTRAZENECA,7999,7958,41
Benevides,150150,PA,Norte,PFIZER/BIONTECH,1093,1093,0
Benjamin Constant,130060,AM,Norte,BUTANTAN/SINOVAC,12245,7198,5047
Benjamin Constant,130060,AM,Norte,FIOCRUZ/ASTRAZENECA,1742,1724,18
Benjamin Constant,130060,AM,Norte,PFIZER/BIONTECH,2,2,0
Benjamin Constant Do Sul,430205,RS,Sul,BUTANTAN/SINOVAC,1705,889,816
Benjamin Constant Do Sul,430205,RS,Sul,FIOCRUZ/ASTRAZENECA,359,328,31
Benjamin Constant Do Sul,430205,RS,Sul,PFIZER/BIONTECH,47,47,0
Bento De Abreu,350620,SP,Sudeste,FIOCRUZ/ASTRAZENECA,962,851,111
Bento De Abreu,350620,SP,Sudeste,BUTANTAN/SINOVAC,914,384,530
Bento De Abreu,350620,SP,Sudeste,PFIZER/BIONTECH,71,71,0
Bento Fernandes,240160,RN,Nordeste,BUTANTAN/SINOVAC,892,541,351
Bento Fernandes,240160,RN,Nordeste,FIOCRUZ/ASTRAZENECA,628,568,60
Bento Fernandes,240160,RN,Nordeste,PFIZER/BIONTECH,65,65,0
Bento Gonçalves,430210,RS,Sul,BUTANTAN/SINOVAC,29264,15130,14134
Bento Gonçalves,430210,RS,Sul,FIOCRUZ/ASTRAZENECA,22409,20863,1546
Bento Gonçalves,430210,RS,Sul,PFIZER/BIONTECH,1206,1206,0
Bequimão,210190,MA,Nordeste,FIOCRUZ/ASTRAZENECA,4447,4260,187
Bequimão,210190,MA,Nordeste,BUTANTAN/SINOVAC,3608,1872,1736
Berilo,310650,MG,Sudeste,FIOCRUZ/ASTRAZENECA,4446,4266,180
Berilo,310650,MG,Sudeste,BUTANTAN/SINOVAC,2061,1048,1013
Berilo,310650,MG,Sudeste,PFIZER/BIONTECH,113,113,0
Berizal,310665,MG,Sudeste,FIOCRUZ/ASTRAZENECA,1597,1506,91
Berizal,310665,MG,Sudeste,BUTANTAN/SINOVAC,935,479,456
Berizal,310665,MG,Sudeste,PFIZER/BIONTECH,53,53,0
Bernardino Batista,250205,PB,Nordeste,BUTANTAN/SINOVAC,889,455,434
Bernardino Batista,250205,PB,Nordeste,FIOCRUZ/ASTRAZENECA,734,669,65
Bernardino Batista,250205,PB,Nordeste,PFIZER/BIONTECH,72,72,0
Bernardino De Campos,350630,SP,Sudeste,BUTANTAN/SINOVAC,5459,2956,2503
Bernardino De Campos,350630,SP,Sudeste,FIOCRUZ/ASTRAZENECA,4025,3572,453
Bernardino De Campos,350630,SP,Sudeste,PFIZER/BIONTECH,291,291,0
Bernardo Do Mearim,210193,MA,Nordeste,FIOCRUZ/ASTRAZENECA,1579,1506,73
Bernardo Do Mearim,210193,MA,Nordeste,BUTANTAN/SINOVAC,1179,651,528
Bernardo Sayão,170320,TO,Norte,FIOCRUZ/ASTRAZENECA,890,859,31
Bernardo Sayão,170320,TO,Norte,BUTANTAN/SINOVAC,784,405,379
Bertioga,350635,SP,Sudeste,FIOCRUZ/ASTRAZENECA,12953,12206,747
Bertioga,350635,SP,Sudeste,BUTANTAN/SINOVAC,9848,5601,4247
Bertioga,350635,SP,Sudeste,PFIZER/BIONTECH,759,759,0
Bertolínia,220170,PI,Nordeste,FIOCRUZ/ASTRAZENECA,1247,1086,161
Bertolínia,220170,PI,Nordeste,BUTANTAN/SINOVAC,902,476,426
Bertolínia,220170,PI,Nordeste,PFIZER/BIONTECH,131,131,0
Bertópolis,310660,MG,Sudeste,BUTANTAN/SINOVAC,1761,936,825
Bertópolis,310660,MG,Sudeste,FIOCRUZ/ASTRAZENECA,1261,1120,141
Bertópolis,310660,MG,Sudeste,PFIZER/BIONTECH,28,28,0
Beruri,130063,AM,Norte,BUTANTAN/SINOVAC,1874,1097,777
Beruri,130063,AM,Norte,FIOCRUZ/ASTRAZENECA,486,367,119
Betânia,260180,PE,Nordeste,FIOCRUZ/ASTRAZENECA,4701,4501,200
Betânia,260180,PE,Nordeste,BUTANTAN/SINOVAC,2264,1172,1092
Betânia,260180,PE,Nordeste,PFIZER/BIONTECH,94,94,0
Betânia Do Piauí,220173,PI,Nordeste,FIOCRUZ/ASTRAZENECA,1410,1302,108
Betânia Do Piauí,220173,PI,Nordeste,BUTANTAN/SINOVAC,899,461,438
Betim,310670,MG,Sudeste,BUTANTAN/SINOVAC,63957,32766,31191
Betim,310670,MG,Sudeste,FIOCRUZ/ASTRAZENECA,45673,42769,2904
Betim,310670,MG,Sudeste,PFIZER/BIONTECH,2224,2224,0
Bezerros,260190,PE,Nordeste,BUTANTAN/SINOVAC,13114,6751,6363
Bezerros,260190,PE,Nordeste,FIOCRUZ/ASTRAZENECA,11246,10089,1157
Bezerros,260190,PE,Nordeste,PFIZER/BIONTECH,280,280,0
Bias Fortes,310680,MG,Sudeste,FIOCRUZ/ASTRAZENECA,1259,1188,71
Bias Fortes,310680,MG,Sudeste,BUTANTAN/SINOVAC,920,486,434
Bicas,310690,MG,Sudeste,BUTANTAN/SINOVAC,4143,2127,2016
Bicas,310690,MG,Sudeste,FIOCRUZ/ASTRAZENECA,3964,3650,314
Bicas,310690,MG,Sudeste,PFIZER/BIONTECH,159,159,0
Biguaçu,420230,SC,Sul,BUTANTAN/SINOVAC,13321,7313,6008
Biguaçu,420230,SC,Sul,FIOCRUZ/ASTRAZENECA,11796,10742,1054
Biguaçu,420230,SC,Sul,PFIZER/BIONTECH,4609,4609,0
Bilac,350640,SP,Sudeste,BUTANTAN/SINOVAC,2375,1253,1122
Bilac,350640,SP,Sudeste,FIOCRUZ/ASTRAZENECA,1818,1638,180
Bilac,350640,SP,Sudeste,PFIZER/BIONTECH,49,49,0
Biquinhas,310700,MG,Sudeste,BUTANTAN/SINOVAC,690,385,305
Biquinhas,310700,MG,Sudeste,FIOCRUZ/ASTRAZENECA,648,605,43
Biquinhas,310700,MG,Sudeste,PFIZER/BIONTECH,8,8,0
Birigui,350650,SP,Sudeste,FIOCRUZ/ASTRAZENECA,26276,24051,2225
Birigui,350650,SP,Sudeste,BUTANTAN/SINOVAC,24408,12770,11638
Birigui,350650,SP,Sudeste,PFIZER/BIONTECH,922,922,0
Biritiba-Mirim,350660,SP,Sudeste,FIOCRUZ/ASTRAZENECA,6006,5663,343
Biritiba-Mirim,350660,SP,Sudeste,BUTANTAN/SINOVAC,5641,2902,2739
Biritiba-Mirim,350660,SP,Sudeste,PFIZER/BIONTECH,765,765,0
Biritinga,290360,BA,Nordeste,FIOCRUZ/ASTRAZENECA,3677,3155,522
Biritinga,290360,BA,Nordeste,BUTANTAN/SINOVAC,2755,1499,1256
Biritinga,290360,BA,Nordeste,PFIZER/BIONTECH,408,406,2
Bituruna,410290,PR,Sul,FIOCRUZ/ASTRAZENECA,3232,3158,74
Bituruna,410290,PR,Sul,BUTANTAN/SINOVAC,2680,1366,1314
Bituruna,410290,PR,Sul,PFIZER/BIONTECH,90,90,0
Blumenau,420240,SC,Sul,BUTANTAN/SINOVAC,62883,32966,29917
Blumenau,420240,SC,Sul,FIOCRUZ/ASTRAZENECA,56022,53688,2334
Blumenau,420240,SC,Sul,PFIZER/BIONTECH,8940,8940,0
Boa Esperança,310710,MG,Sudeste,BUTANTAN/SINOVAC,6918,3515,3403
Boa Esperança,310710,MG,Sudeste,FIOCRUZ/ASTRAZENECA,4299,3974,325
Boa Esperança,310710,MG,Sudeste,PFIZER/BIONTECH,563,563,0
Boa Esperança,320100,ES,Sudeste,BUTANTAN/SINOVAC,3809,1987,1822
Boa Esperança,320100,ES,Sudeste,FIOCRUZ/ASTRAZENECA,3363,3224,139
Boa Esperança,320100,ES,Sudeste,PFIZER/BIONTECH,287,287,0
Boa Esperança,410300,PR,Sul,FIOCRUZ/ASTRAZENECA,1387,1321,66
Boa Esperança,410300,PR,Sul,BUTANTAN/SINOVAC,1015,551,464
Boa Esperança,410300,PR,Sul,PFIZER/BIONTECH,23,23,0
Boa Esperança Do Iguaçu,410302,PR,Sul,FIOCRUZ/ASTRAZENECA,730,691,39
Boa Esperança Do Iguaçu,410302,PR,Sul,BUTANTAN/SINOVAC,519,276,243
Boa Esperança Do Iguaçu,410302,PR,Sul,PFIZER/BIONTECH,17,17,0
Boa Esperança Do Sul,350670,SP,Sudeste,BUTANTAN/SINOVAC,3007,1541,1466
Boa Esperança Do Sul,350670,SP,Sudeste,FIOCRUZ/ASTRAZENECA,2955,2747,208
Boa Esperança Do Sul,350670,SP,Sudeste,PFIZER/BIONTECH,326,326,0
Boa Hora,220177,PI,Nordeste,FIOCRUZ/ASTRAZENECA,1295,1262,33
Boa Hora,220177,PI,Nordeste,BUTANTAN/SINOVAC,1089,564,525
Boa Nova,290370,BA,Nordeste,BUTANTAN/SINOVAC,2689,1511,1178
Boa Nova,290370,BA,Nordeste,FIOCRUZ/ASTRAZENECA,1866,1697,169
Boa Nova,290370,BA,Nordeste,PFIZER/BIONTECH,100,100,0
Boa Ventura,250210,PB,Nordeste,BUTANTAN/SINOVAC,1446,739,707
Boa Ventura,250210,PB,Nordeste,FIOCRUZ/ASTRAZENECA,1174,1077,97
Boa Ventura,250210,PB,Nordeste,PFIZER/BIONTECH,118,118,0
Boa Ventura De São Roque,410304,PR,Sul,FIOCRUZ/ASTRAZENECA,1692,1621,71
Boa Ventura De São Roque,410304,PR,Sul,BUTANTAN/SINOVAC,1188,665,523
Boa Ventura De São Roque,410304,PR,Sul,PFIZER/BIONTECH,17,17,0
Boa Viagem,230240,CE,Nordeste,BUTANTAN/SINOVAC,10407,5362,5045
Boa Viagem,230240,CE,Nordeste,FIOCRUZ/ASTRAZENECA,4953,4041,912
Boa Vista,140010,RR,Norte,BUTANTAN/SINOVAC,63479,32705,30774
Boa Vista,140010,RR,Norte,FIOCRUZ/ASTRAZENECA,37019,33859,3160
Boa Vista,140010,RR,Norte,PFIZER/BIONTECH,13278,13257,21
Boa Vista,250215,PB,Nordeste,BUTANTAN/SINOVAC,2279,1229,1050
Boa Vista,250215,PB,Nordeste,FIOCRUZ/ASTRAZENECA,1533,1428,105
Boa Vista,250215,PB,Nordeste,PFIZER/BIONTECH,107,107,0
Boa Vista Da Aparecida,410305,PR,Sul,FIOCRUZ/ASTRAZENECA,2024,1910,114
Boa Vista Da Aparecida,410305,PR,Sul,BUTANTAN/SINOVAC,1984,1035,949
Boa Vista Da Aparecida,410305,PR,Sul,PFIZER/BIONTECH,39,39,0
Boa Vista Das Missões,430215,RS,Sul,BUTANTAN/SINOVAC,549,283,266
Boa Vista Das Missões,430215,RS,Sul,FIOCRUZ/ASTRAZENECA,397,388,9
Boa Vista Das Missões,430215,RS,Sul,PFIZER/BIONTECH,30,30,0
Boa Vista Do Buricá,430220,RS,Sul,BUTANTAN/SINOVAC,2278,1155,1123
Boa Vista Do Buricá,430220,RS,Sul,FIOCRUZ/ASTRAZENECA,1628,1430,198
Boa Vista Do Buricá,430220,RS,Sul,PFIZER/BIONTECH,278,277,1
Boa Vista Do Cadeado,430222,RS,Sul,BUTANTAN/SINOVAC,774,394,380
Boa Vista Do Cadeado,430222,RS,Sul,FIOCRUZ/ASTRAZENECA,741,646,95
Boa Vista Do Cadeado,430222,RS,Sul,PFIZER/BIONTECH,98,98,0
Boa Vista Do Gurupi,210197,MA,Nordeste,FIOCRUZ/ASTRAZENECA,1095,1002,93
Boa Vista Do Gurupi,210197,MA,Nordeste,BUTANTAN/SINOVAC,1059,557,502
Boa Vista Do Incra,430223,RS,Sul,FIOCRUZ/ASTRAZENECA,927,820,107
Boa Vista Do Incra,430223,RS,Sul,BUTANTAN/SINOVAC,721,338,383
Boa Vista Do Incra,430223,RS,Sul,PFIZER/BIONTECH,111,111,0
Boa Vista Do Ramos,130068,AM,Norte,FIOCRUZ/ASTRAZENECA,7365,6600,765
Boa Vista Do Ramos,130068,AM,Norte,BUTANTAN/SINOVAC,1813,936,877
Boa Vista Do Sul,430225,RS,Sul,BUTANTAN/SINOVAC,1044,541,503
Boa Vista Do Sul,430225,RS,Sul,FIOCRUZ/ASTRAZENECA,856,721,135
Boa Vista Do Sul,430225,RS,Sul,PFIZER/BIONTECH,102,102,0
Boa Vista Do Tupim,290380,BA,Nordeste,FIOCRUZ/ASTRAZENECA,3306,3179,127
Boa Vista Do Tupim,290380,BA,Nordeste,BUTANTAN/SINOVAC,2997,1693,1304
Boa Vista Do Tupim,290380,BA,Nordeste,PFIZER/BIONTECH,6,6,0
Boca Da Mata,270100,AL,Nordeste,FIOCRUZ/ASTRAZENECA,5398,4860,538
Boca Da Mata,270100,AL,Nordeste,BUTANTAN/SINOVAC,4389,2355,2034
Boca Do Acre,130070,AM,Norte,BUTANTAN/SINOVAC,5535,3054,2481
Boca Do Acre,130070,AM,Norte,FIOCRUZ/ASTRAZENECA,4051,3045,1006
Bocaina,220180,PI,Nordeste,FIOCRUZ/ASTRAZENECA,1103,1017,86
Bocaina,220180,PI,Nordeste,BUTANTAN/SINOVAC,1081,546,535
Bocaina,350680,SP,Sudeste,FIOCRUZ/ASTRAZENECA,3167,2916,251
Bocaina,350680,SP,Sudeste,BUTANTAN/SINOVAC,2674,1303,1371
Bocaina,350680,SP,Sudeste,PFIZER/BIONTECH,293,293,0
Bocaina De Minas,310720,MG,Sudeste,BUTANTAN/SINOVAC,1127,564,563
Bocaina De Minas,310720,MG,Sudeste,FIOCRUZ/ASTRAZENECA,1095,991,104
Bocaina De Minas,310720,MG,Sudeste,PFIZER/BIONTECH,50,50,0
Bocaina Do Sul,420243,SC,Sul,FIOCRUZ/ASTRAZENECA,1046,1016,30
Bocaina Do Sul,420243,SC,Sul,BUTANTAN/SINOVAC,766,415,351
Bocaiúva,310730,MG,Sudeste,BUTANTAN/SINOVAC,806,418,388
Bocaiúva,310730,MG,Sudeste,PFIZER/BIONTECH,369,369,0
Bocaiúva,310730,MG,Sudeste,FIOCRUZ/ASTRAZENECA,6,0,6
Bocaiúva Do Sul,410310,PR,Sul,FIOCRUZ/ASTRAZENECA,2299,2198,101
Bocaiúva Do Sul,410310,PR,Sul,BUTANTAN/SINOVAC,2140,1118,1022
Bocaiúva Do Sul,410310,PR,Sul,PFIZER/BIONTECH,12,12,0
Bodó,240165,RN,Nordeste,FIOCRUZ/ASTRAZENECA,492,473,19
Bodó,240165,RN,Nordeste,BUTANTAN/SINOVAC,464,228,236
Bodó,240165,RN,Nordeste,PFIZER/BIONTECH,83,83,0
Bodocó,260200,PE,Nordeste,FIOCRUZ/ASTRAZENECA,6742,6245,497
Bodocó,260200,PE,Nordeste,BUTANTAN/SINOVAC,5554,2845,2709
Bodocó,260200,PE,Nordeste,PFIZER/BIONTECH,701,700,1
Bodoquena,500215,MS,Centro-Oeste,FIOCRUZ/ASTRAZENECA,2508,2208,300
Bodoquena,500215,MS,Centro-Oeste,BUTANTAN/SINOVAC,1770,922,848
Bodoquena,500215,MS,Centro-Oeste,PFIZER/BIONTECH,290,290,0
Bofete,350690,SP,Sudeste,BUTANTAN/SINOVAC,2289,1248,1041
Bofete,350690,SP,Sudeste,FIOCRUZ/ASTRAZENECA,1781,1634,147
Bofete,350690,SP,Sudeste,PFIZER/BIONTECH,56,56,0
Boituva,350700,SP,Sudeste,FIOCRUZ/ASTRAZENECA,11384,10596,788
Boituva,350700,SP,Sudeste,BUTANTAN/SINOVAC,9795,4914,4881
Boituva,350700,SP,Sudeste,PFIZER/BIONTECH,321,321,0
Bom Conselho,260210,PE,Nordeste,FIOCRUZ/ASTRAZENECA,14821,14122,699
Bom Conselho,260210,PE,Nordeste,BUTANTAN/SINOVAC,8448,4338,4110
Bom Conselho,260210,PE,Nordeste,PFIZER/BIONTECH,371,371,0
Bom Despacho,310740,MG,Sudeste,BUTANTAN/SINOVAC,11192,5765,5427
Bom Despacho,310740,MG,Sudeste,FIOCRUZ/ASTRAZENECA,9446,8467,979
Bom Despacho,310740,MG,Sudeste,PFIZER/BIONTECH,1085,1085,0
Bom Jardim,210200,MA,Nordeste,FIOCRUZ/ASTRAZENECA,5194,4964,230
Bom Jardim,210200,MA,Nordeste,BUTANTAN/SINOVAC,5114,2838,2276
Bom Jardim,260220,PE,Nordeste,FIOCRUZ/ASTRAZENECA,7210,6592,618
Bom Jardim,260220,PE,Nordeste,BUTANTAN/SINOVAC,6641,3417,3224
Bom Jardim,260220,PE,Nordeste,PFIZER/BIONTECH,350,350,0
Bom Jardim,330050,RJ,Sudeste,FIOCRUZ/ASTRAZENECA,5583,5317,266
Bom Jardim,330050,RJ,Sudeste,BUTANTAN/SINOVAC,5380,2738,2642
Bom Jardim,330050,RJ,Sudeste,PFIZER/BIONTECH,1402,1402,0
Bom Jardim Da Serra,420250,SC,Sul,FIOCRUZ/ASTRAZENECA,1020,943,77
Bom Jardim Da Serra,420250,SC,Sul,BUTANTAN/SINOVAC,992,551,441
Bom Jardim De Goiás,520340,GO,Centro-Oeste,FIOCRUZ/ASTRAZENECA,2469,2323,146
Bom Jardim De Goiás,520340,GO,Centro-Oeste,BUTANTAN/SINOVAC,1927,980,947
Bom Jardim De Minas,310750,MG,Sudeste,BUTANTAN/SINOVAC,1673,848,825
Bom Jardim De Minas,310750,MG,Sudeste,FIOCRUZ/ASTRAZENECA,1625,1495,130
Bom Jardim De Minas,310750,MG,Sudeste,PFIZER/BIONTECH,59,56,3
Bom Jesus,220190,PI,Nordeste,FIOCRUZ/ASTRAZENECA,4764,4351,413
Bom Jesus,220190,PI,Nordeste,BUTANTAN/SINOVAC,2949,1465,1484
Bom Jesus,220190,PI,Nordeste,PFIZER/BIONTECH,449,448,1
Bom Jesus,240170,RN,Nordeste,FIOCRUZ/ASTRAZENECA,2235,2044,191
Bom Jesus,240170,RN,Nordeste,BUTANTAN/SINOVAC,1932,980,952
Bom Jesus,240170,RN,Nordeste,PFIZER/BIONTECH,112,112,0
Bom Jesus,250220,PB,Nordeste,BUTANTAN/SINOVAC,1009,535,474
Bom Jesus,250220,PB,Nordeste,FIOCRUZ/ASTRAZENECA,468,425,43
Bom Jesus,250220,PB,Nordeste,PFIZER/BIONTECH,47,47,0
Bom Jesus,420253,SC,Sul,BUTANTAN/SINOVAC,666,377,289
Bom Jesus,420253,SC,Sul,FIOCRUZ/ASTRAZENECA,316,275,41
Bom Jesus,430230,RS,Sul,BUTANTAN/SINOVAC,3169,1641,1528
Bom Jesus,430230,RS,Sul,FIOCRUZ/ASTRAZENECA,2478,2210,268
Bom Jesus,430230,RS,Sul,PFIZER/BIONTECH,400,400,0
Bom Jesus Da Lapa,290390,BA,Nordeste,FIOCRUZ/ASTRAZENECA,14755,13862,893
Bom Jesus Da Lapa,290390,BA,Nordeste,BUTANTAN/SINOVAC,10138,5201,4937
Bom Jesus Da Penha,310760,MG,Sudeste,BUTANTAN/SINOVAC,1129,576,553
Bom Jesus Da Penha,310760,MG,Sudeste,FIOCRUZ/ASTRAZENECA,858,763,95
Bom Jesus Da Serra,290395,BA,Nordeste,BUTANTAN/SINOVAC,2319,1150,1169
Bom Jesus Da Serra,290395,BA,Nordeste,FIOCRUZ/ASTRAZENECA,1715,1518,197
Bom Jesus Da Serra,290395,BA,Nordeste,PFIZER/BIONTECH,52,52,0
Bom Jesus Das Selvas,210203,MA,Nordeste,BUTANTAN/SINOVAC,2675,1418,1257
Bom Jesus Das Selvas,210203,MA,Nordeste,FIOCRUZ/ASTRAZENECA,1970,1885,85
Bom Jesus De Goiás,520350,GO,Centro-Oeste,FIOCRUZ/ASTRAZENECA,5986,5687,299
Bom Jesus De Goiás,520350,GO,Centro-Oeste,BUTANTAN/SINOVAC,3469,1836,1633
Bom Jesus De Goiás,520350,GO,Centro-Oeste,PFIZER/BIONTECH,77,77,0
Bom Jesus Do Amparo,310770,MG,Sudeste,BUTANTAN/SINOVAC,1266,726,540
Bom Jesus Do Amparo,310770,MG,Sudeste,FIOCRUZ/ASTRAZENECA,1115,1089,26
Bom Jesus Do Amparo,310770,MG,Sudeste,PFIZER/BIONTECH,2,2,0
Bom Jesus Do Araguaia,510185,MT,Centro-Oeste,FIOCRUZ/ASTRAZENECA,816,753,63
Bom Jesus Do Araguaia,510185,MT,Centro-Oeste,BUTANTAN/SINOVAC,782,396,386
Bom Jesus Do Araguaia,510185,MT,Centro-Oeste,PFIZER/BIONTECH,102,102,0
Bom Jesus Do Galho,310780,MG,Sudeste,BUTANTAN/SINOVAC,3506,2126,1380
Bom Jesus Do Galho,310780,MG,Sudeste,FIOCRUZ/ASTRAZENECA,1576,1476,100
Bom Jesus Do Galho,310780,MG,Sudeste,PFIZER/BIONTECH,23,23,0
Bom Jesus Do Itabapoana,330060,RJ,Sudeste,BUTANTAN/SINOVAC,11347,5986,5361
Bom Jesus Do Itabapoana,330060,RJ,Sudeste,FIOCRUZ/ASTRAZENECA,9832,9173,659
Bom Jesus Do Itabapoana,330060,RJ,Sudeste,PFIZER/BIONTECH,1369,1368,1
Bom Jesus Do Norte,320110,ES,Sudeste,BUTANTAN/SINOVAC,3505,1807,1698
Bom Jesus Do Norte,320110,ES,Sudeste,FIOCRUZ/ASTRAZENECA,2376,2254,122
Bom Jesus Do Norte,320110,ES,Sudeste,PFIZER/BIONTECH,474,474,0
Bom Jesus Do Oeste,420257,SC,Sul,BUTANTAN/SINOVAC,815,428,387
Bom Jesus Do Oeste,420257,SC,Sul,FIOCRUZ/ASTRAZENECA,392,330,62
Bom Jesus Do Sul,410315,PR,Sul,FIOCRUZ/ASTRAZENECA,1161,1067,94
Bom Jesus Do Sul,410315,PR,Sul,BUTANTAN/SINOVAC,1059,554,505
Bom Jesus Do Tocantins,150157,PA,Norte,FIOCRUZ/ASTRAZENECA,2285,2085,200
Bom Jesus Do Tocantins,150157,PA,Norte,BUTANTAN/SINOVAC,878,515,363
Bom Jesus Do Tocantins,170330,TO,Norte,FIOCRUZ/ASTRAZENECA,567,549,18
Bom Jesus Do Tocantins,170330,TO,Norte,BUTANTAN/SINOVAC,526,277,249
Bom Jesus Dos Perdões,350710,SP,Sudeste,FIOCRUZ/ASTRAZENECA,4984,4718,266
Bom Jesus Dos Perdões,350710,SP,Sudeste,BUTANTAN/SINOVAC,4127,2164,1963
Bom Jesus Dos Perdões,350710,SP,Sudeste,PFIZER/BIONTECH,323,323,0
Bom Lugar,210207,MA,Nordeste,BUTANTAN/SINOVAC,1925,1009,916
Bom Lugar,210207,MA,Nordeste,FIOCRUZ/ASTRAZENECA,1658,1523,135
Bom Princípio,430235,RS,Sul,FIOCRUZ/ASTRAZENECA,2942,2730,212
Bom Princípio,430235,RS,Sul,BUTANTAN/SINOVAC,2428,1250,1178
Bom Princípio,430235,RS,Sul,PFIZER/BIONTECH,478,478,0
Bom Princípio Do Piauí,220191,PI,Nordeste,BUTANTAN/SINOVAC,1112,646,466
Bom Princípio Do Piauí,220191,PI,Nordeste,FIOCRUZ/ASTRAZENECA,724,684,40
Bom Progresso,430237,RS,Sul,BUTANTAN/SINOVAC,642,342,300
Bom Progresso,430237,RS,Sul,FIOCRUZ/ASTRAZENECA,606,566,40
Bom Progresso,430237,RS,Sul,PFIZER/BIONTECH,96,96,0
Bom Repouso,310790,MG,Sudeste,FIOCRUZ/ASTRAZENECA,2169,2066,103
Bom Repouso,310790,MG,Sudeste,BUTANTAN/SINOVAC,1815,984,831
Bom Repouso,310790,MG,Sudeste,PFIZER/BIONTECH,112,112,0
Bom Retiro,420260,SC,Sul,BUTANTAN/SINOVAC,1894,1024,870
Bom Retiro,420260,SC,Sul,FIOCRUZ/ASTRAZENECA,1800,1740,60
Bom Retiro Do Sul,430240,RS,Sul,FIOCRUZ/ASTRAZENECA,3025,2834,191
Bom Retiro Do Sul,430240,RS,Sul,BUTANTAN/SINOVAC,2943,1505,1438
Bom Retiro Do Sul,430240,RS,Sul,PFIZER/BIONTECH,437,437,0
Bom Sucesso,250230,PB,Nordeste,BUTANTAN/SINOVAC,1619,803,816
Bom Sucesso,250230,PB,Nordeste,FIOCRUZ/ASTRAZENECA,1033,902,131
Bom Sucesso,250230,PB,Nordeste,PFIZER/BIONTECH,112,112,0
Bom Sucesso,310800,MG,Sudeste,BUTANTAN/SINOVAC,4333,2172,2161
Bom Sucesso,310800,MG,Sudeste,FIOCRUZ/ASTRAZENECA,3355,3068,287
Bom Sucesso,310800,MG,Sudeste,PFIZER/BIONTECH,95,95,0
Bom Sucesso,410320,PR,Sul,FIOCRUZ/ASTRAZENECA,1936,1833,103
Bom Sucesso,410320,PR,Sul,BUTANTAN/SINOVAC,1493,783,710
Bom Sucesso,410320,PR,Sul,PFIZER/BIONTECH,29,29,0
Bom Sucesso De Itararé,350715,SP,Sudeste,FIOCRUZ/ASTRAZENECA,686,622,64
Bom Sucesso De Itararé,350715,SP,Sudeste,BUTANTAN/SINOVAC,640,353,287
Bom Sucesso De Itararé,350715,SP,Sudeste,PFIZER/BIONTECH,99,99,0
Bom Sucesso Do Sul,410322,PR,Sul,FIOCRUZ/ASTRAZENECA,932,870,62
Bom Sucesso Do Sul,410322,PR,Sul,BUTANTAN/SINOVAC,845,439,406
Bom Sucesso Do Sul,410322,PR,Sul,PFIZER/BIONTECH,4,4,0
Bombinhas,420245,SC,Sul,FIOCRUZ/ASTRAZENECA,4390,4170,220
Bombinhas,420245,SC,Sul,BUTANTAN/SINOVAC,3294,1717,1577
Bombinhas,420245,SC,Sul,PFIZER/BIONTECH,303,303,0
Bonfim,140015,RR,Norte,BUTANTAN/SINOVAC,4646,2850,1796
Bonfim,140015,RR,Norte,FIOCRUZ/ASTRAZENECA,1599,1588,11
Bonfim,310810,MG,Sudeste,FIOCRUZ/ASTRAZENECA,2481,2325,156
Bonfim,310810,MG,Sudeste,BUTANTAN/SINOVAC,2232,1199,1033
Bonfim,310810,MG,Sudeste,PFIZER/BIONTECH,47,47,0
Bonfim Do Piauí,220192,PI,Nordeste,BUTANTAN/SINOVAC,1000,507,493
Bonfim Do Piauí,220192,PI,Nordeste,FIOCRUZ/ASTRAZENECA,955,873,82
Bonfinópolis,520355,GO,Centro-Oeste,FIOCRUZ/ASTRAZENECA,2556,2382,174
Bonfinópolis,520355,GO,Centro-Oeste,BUTANTAN/SINOVAC,1875,1048,827
Bonfinópolis De Minas,310820,MG,Sudeste,BUTANTAN/SINOVAC,1665,847,818
Bonfinópolis De Minas,310820,MG,Sudeste,FIOCRUZ/ASTRAZENECA,1384,1224,160
Bonfinópolis De Minas,310820,MG,Sudeste,PFIZER/BIONTECH,70,70,0
Boninal,290400,BA,Nordeste,BUTANTAN/SINOVAC,2587,1404,1183
Boninal,290400,BA,Nordeste,FIOCRUZ/ASTRAZENECA,2296,2185,111
Bonito,150160,PA,Norte,FIOCRUZ/ASTRAZENECA,1650,1236,414
Bonito,150160,PA,Norte,BUTANTAN/SINOVAC,1324,821,503
Bonito,260230,PE,Nordeste,BUTANTAN/SINOVAC,6758,3755,3003
Bonito,260230,PE,Nordeste,FIOCRUZ/ASTRAZENECA,5629,5094,535
Bonito,260230,PE,Nordeste,PFIZER/BIONTECH,280,279,1
Bonito,290405,BA,Nordeste,FIOCRUZ/ASTRAZENECA,7499,7285,214
Bonito,290405,BA,Nordeste,BUTANTAN/SINOVAC,1991,1026,965
Bonito,290405,BA,Nordeste,PFIZER/BIONTECH,83,83,0
Bonito,500220,MS,Centro-Oeste,FIOCRUZ/ASTRAZENECA,5672,4845,827
Bonito,500220,MS,Centro-Oeste,BUTANTAN/SINOVAC,4706,2547,2159
Bonito,500220,MS,Centro-Oeste,PFIZER/BIONTECH,790,789,1
Bonito De Minas,310825,MG,Sudeste,FIOCRUZ/ASTRAZENECA,2207,2060,147
Bonito De Minas,310825,MG,Sudeste,BUTANTAN/SINOVAC,1934,996,938
Bonito De Minas,310825,MG,Sudeste,PFIZER/BIONTECH,120,120,0
Bonito De Santa Fé,250240,PB,Nordeste,BUTANTAN/SINOVAC,2455,1296,1159
Bonito De Santa Fé,250240,PB,Nordeste,FIOCRUZ/ASTRAZENECA,1385,1223,162
Bonópolis,520357,GO,Centro-Oeste,FIOCRUZ/ASTRAZENECA,1030,987,43
Bonópolis,520357,GO,Centro-Oeste,BUTANTAN/SINOVAC,542,291,251
Boqueirão,250250,PB,Nordeste,BUTANTAN/SINOVAC,3528,1911,1617
Boqueirão,250250,PB,Nordeste,FIOCRUZ/ASTRAZENECA,2690,2557,133
Boqueirão,250250,PB,Nordeste,PFIZER/BIONTECH,174,174,0
Boqueirão Do Leão,430245,RS,Sul,FIOCRUZ/ASTRAZENECA,1655,1511,144
Boqueirão Do Leão,430245,RS,Sul,BUTANTAN/SINOVAC,1584,838,746
Boqueirão Do Leão,430245,RS,Sul,PFIZER/BIONTECH,124,124,0
Boqueirão Do Piauí,220194,PI,Nordeste,BUTANTAN/SINOVAC,1307,716,591
Boqueirão Do Piauí,220194,PI,Nordeste,FIOCRUZ/ASTRAZENECA,800,798,2
Boqueirão Do Piauí,220194,PI,Nordeste,PFIZER/BIONTECH,55,55,0
Boquim,280067,SE,Nordeste,BUTANTAN/SINOVAC,4123,2297,1826
Boquim,280067,SE,Nordeste,FIOCRUZ/ASTRAZENECA,3376,3223,153
Boquim,280067,SE,Nordeste,PFIZER/BIONTECH,517,517,0
Boquira,290410,BA,Nordeste,BUTANTAN/SINOVAC,4681,2379,2302
Boquira,290410,BA,Nordeste,FIOCRUZ/ASTRAZENECA,3243,2988,255
Boquira,290410,BA,Nordeste,PFIZER/BIONTECH,51,51,0
Borá,350720,SP,Sudeste,BUTANTAN/SINOVAC,271,141,130
Borá,350720,SP,Sudeste,FIOCRUZ/ASTRAZENECA,194,171,23
Borá,350720,SP,Sudeste,PFIZER/BIONTECH,99,99,0
Boracéia,350730,SP,Sudeste,FIOCRUZ/ASTRAZENECA,1201,1107,94
Boracéia,350730,SP,Sudeste,BUTANTAN/SINOVAC,1201,603,598
Boracéia,350730,SP,Sudeste,PFIZER/BIONTECH,104,103,1
Borba,130080,AM,Norte,BUTANTAN/SINOVAC,5145,2658,2487
Borba,130080,AM,Norte,FIOCRUZ/ASTRAZENECA,4235,3301,934
Borborema,250270,PB,Nordeste,BUTANTAN/SINOVAC,912,483,429
Borborema,250270,PB,Nordeste,FIOCRUZ/ASTRAZENECA,841,770,71
Borborema,250270,PB,Nordeste,PFIZER/BIONTECH,99,99,0
Borborema,350740,SP,Sudeste,BUTANTAN/SINOVAC,6429,3554,2875
Borborema,350740,SP,Sudeste,FIOCRUZ/ASTRAZENECA,6201,5624,577
Borborema,350740,SP,Sudeste,PFIZER/BIONTECH,425,425,0
Borda Da Mata,310830,MG,Sudeste,FIOCRUZ/ASTRAZENECA,5167,4810,357
Borda Da Mata,310830,MG,Sudeste,BUTANTAN/SINOVAC,4743,2441,2302
Borda Da Mata,310830,MG,Sudeste,PFIZER/BIONTECH,264,264,0
Borebi,350745,SP,Sudeste,FIOCRUZ/ASTRAZENECA,727,661,66
Borebi,350745,SP,Sudeste,BUTANTAN/SINOVAC,509,235,274
Borebi,350745,SP,Sudeste,PFIZER/BIONTECH,68,68,0
Borrazópolis,410330,PR,Sul,FIOCRUZ/ASTRAZENECA,2216,2100,116
Borrazópolis,410330,PR,Sul,BUTANTAN/SINOVAC,1994,1092,902
Bossoroca,430250,RS,Sul,BUTANTAN/SINOVAC,1943,1007,936
Bossoroca,430250,RS,Sul,FIOCRUZ/ASTRAZENECA,1797,1569,228
Bossoroca,430250,RS,Sul,PFIZER/BIONTECH,237,237,0
Botelhos,310840,MG,Sudeste,FIOCRUZ/ASTRAZENECA,3175,2853,322
Botelhos,310840,MG,Sudeste,BUTANTAN/SINOVAC,3162,1585,1577
Botelhos,310840,MG,Sudeste,PFIZER/BIONTECH,105,105,0
Botucatu,350750,SP,Sudeste,BUTANTAN/SINOVAC,37398,19052,18346
Botucatu,350750,SP,Sudeste,FIOCRUZ/ASTRAZENECA,20747,15943,4804
Botucatu,350750,SP,Sudeste,PFIZER/BIONTECH,78,78,0
Botumirim,310850,MG,Sudeste,FIOCRUZ/ASTRAZENECA,1332,1240,92
Botumirim,310850,MG,Sudeste,BUTANTAN/SINOVAC,1165,597,568
Botumirim,310850,MG,Sudeste,PFIZER/BIONTECH,81,81,0
Botuporã,290420,BA,Nordeste,BUTANTAN/SINOVAC,2287,1182,1105
Botuporã,290420,BA,Nordeste,FIOCRUZ/ASTRAZENECA,1472,1410,62
Botuporã,290420,BA,Nordeste,PFIZER/BIONTECH,18,18,0
Botuverá,420270,SC,Sul,BUTANTAN/SINOVAC,1654,865,789
Botuverá,420270,SC,Sul,FIOCRUZ/ASTRAZENECA,1187,1160,27
Bozano,430258,RS,Sul,BUTANTAN/SINOVAC,875,442,433
Bozano,430258,RS,Sul,FIOCRUZ/ASTRAZENECA,653,539,114
Bozano,430258,RS,Sul,PFIZER/BIONTECH,84,84,0
Braço Do Norte,420280,SC,Sul,FIOCRUZ/ASTRAZENECA,8017,7459,558
Braço Do Norte,420280,SC,Sul,BUTANTAN/SINOVAC,5908,3270,2638
Braço Do Norte,420280,SC,Sul,PFIZER/BIONTECH,838,837,1
Braço Do Trombudo,420285,SC,Sul,BUTANTAN/SINOVAC,944,495,449
Braço Do Trombudo,420285,SC,Sul,FIOCRUZ/ASTRAZENECA,695,617,78
Braço Do Trombudo,420285,SC,Sul,PFIZER/BIONTECH,42,42,0
Braga,430260,RS,Sul,BUTANTAN/SINOVAC,993,499,494
Braga,430260,RS,Sul,FIOCRUZ/ASTRAZENECA,746,706,40
Braga,430260,RS,Sul,PFIZER/BIONTECH,29,29,0
Bragança,150170,PA,Norte,FIOCRUZ/ASTRAZENECA,34787,29888,4899
Bragança,150170,PA,Norte,BUTANTAN/SINOVAC,13812,7534,6278
Bragança Paulista,350760,SP,Sudeste,FIOCRUZ/ASTRAZENECA,43689,39663,4026
Bragança Paulista,350760,SP,Sudeste,BUTANTAN/SINOVAC,38061,20287,17774
Bragança Paulista,350760,SP,Sudeste,PFIZER/BIONTECH,2096,2094,2
Braganey,410335,PR,Sul,FIOCRUZ/ASTRAZENECA,1634,1528,106
Braganey,410335,PR,Sul,BUTANTAN/SINOVAC,1101,567,534
Braganey,410335,PR,Sul,PFIZER/BIONTECH,19,19,0
Branquinha,270110,AL,Nordeste,BUTANTAN/SINOVAC,1629,838,791
Branquinha,270110,AL,Nordeste,FIOCRUZ/ASTRAZENECA,1571,1454,117
Brás Pires,310870,MG,Sudeste,BUTANTAN/SINOVAC,1261,635,626
Brás Pires,310870,MG,Sudeste,FIOCRUZ/ASTRAZENECA,1217,1110,107
Brás Pires,310870,MG,Sudeste,PFIZER/BIONTECH,37,37,0
Brasil Novo,150172,PA,Norte,FIOCRUZ/ASTRAZENECA,3115,2267,848
Brasil Novo,150172,PA,Norte,BUTANTAN/SINOVAC,2057,1071,986
Brasilândia,500230,MS,Centro-Oeste,FIOCRUZ/ASTRAZENECA,2623,2297,326
Brasilândia,500230,MS,Centro-Oeste,BUTANTAN/SINOVAC,2383,1231,1152
Brasilândia,500230,MS,Centro-Oeste,PFIZER/BIONTECH,307,307,0
Brasilândia De Minas,310855,MG,Sudeste,FIOCRUZ/ASTRAZENECA,2806,2624,182
Brasilândia De Minas,310855,MG,Sudeste,BUTANTAN/SINOVAC,2056,1041,1015
Brasilândia De Minas,310855,MG,Sudeste,PFIZER/BIONTECH,59,59,0
Brasilândia Do Sul,410337,PR,Sul,FIOCRUZ/ASTRAZENECA,1018,954,64
Brasilândia Do Sul,410337,PR,Sul,BUTANTAN/SINOVAC,721,386,335
Brasilândia Do Sul,410337,PR,Sul,PFIZER/BIONTECH,12,12,0
Brasilândia Do Tocantins,170360,TO,Norte,BUTANTAN/SINOVAC,431,228,203
Brasilândia Do Tocantins,170360,TO,Norte,FIOCRUZ/ASTRAZENECA,356,325,31
Brasiléia,120010,AC,Norte,FIOCRUZ/ASTRAZENECA,4296,3867,429
Brasiléia,120010,AC,Norte,BUTANTAN/SINOVAC,3938,2026,1912
Brasileira,220196,PI,Nordeste,FIOCRUZ/ASTRAZENECA,1407,1313,94
Brasileira,220196,PI,Nordeste,BUTANTAN/SINOVAC,1357,703,654
Brasileira,220196,PI,Nordeste,PFIZER/BIONTECH,88,88,0
Brasília,530010,DF,Centro-Oeste,FIOCRUZ/ASTRAZENECA,538234,476632,61602
Brasília,530010,DF,Centro-Oeste,BUTANTAN/SINOVAC,534897,280046,254851
Brasília,530010,DF,Centro-Oeste,PFIZER/BIONTECH,73115,72941,174
Brasília De Minas,310860,MG,Sudeste,BUTANTAN/SINOVAC,7074,3910,3164
Brasília De Minas,310860,MG,Sudeste,FIOCRUZ/ASTRAZENECA,4053,3612,441
Brasília De Minas,310860,MG,Sudeste,PFIZER/BIONTECH,916,914,2
Brasnorte,510190,MT,Centro-Oeste,FIOCRUZ/ASTRAZENECA,2188,2053,135
Brasnorte,510190,MT,Centro-Oeste,BUTANTAN/SINOVAC,1768,889,879
Brasnorte,510190,MT,Centro-Oeste,PFIZER/BIONTECH,139,139,0
Braúna,350770,SP,Sudeste,BUTANTAN/SINOVAC,1675,942,733
Braúna,350770,SP,Sudeste,FIOCRUZ/ASTRAZENECA,1230,1118,112
Braúna,350770,SP,Sudeste,PFIZER/BIONTECH,99,99,0
Braúnas,310880,MG,Sudeste,FIOCRUZ/ASTRAZENECA,1237,1049,188
Braúnas,310880,MG,Sudeste,BUTANTAN/SINOVAC,1229,641,588
Braúnas,310880,MG,Sudeste,PFIZER/BIONTECH,25,25,0
Brazabrantes,520360,GO,Centro-Oeste,BUTANTAN/SINOVAC,835,425,410
Brazabrantes,520360,GO,Centro-Oeste,FIOCRUZ/ASTRAZENECA,610,539,71
Brazópolis,310890,MG,Sudeste,BUTANTAN/SINOVAC,3945,2050,1895
Brazópolis,310890,MG,Sudeste,FIOCRUZ/ASTRAZENECA,2996,2680,316
Brazópolis,310890,MG,Sudeste,PFIZER/BIONTECH,198,198,0
Brejão,260240,PE,Nordeste,FIOCRUZ/ASTRAZENECA,2939,2756,183
Brejão,260240,PE,Nordeste,BUTANTAN/SINOVAC,1855,943,912
Brejão,260240,PE,Nordeste,PFIZER/BIONTECH,234,234,0
Brejetuba,320115,ES,Sudeste,FIOCRUZ/ASTRAZENECA,2257,2203,54
Brejetuba,320115,ES,Sudeste,BUTANTAN/SINOVAC,2164,1205,959
Brejetuba,320115,ES,Sudeste,PFIZER/BIONTECH,146,145,1
Brejinho,240180,RN,Nordeste,BUTANTAN/SINOVAC,1893,957,936
Brejinho,240180,RN,Nordeste,FIOCRUZ/ASTRAZENECA,1877,1775,102
Brejinho,240180,RN,Nordeste,PFIZER/BIONTECH,365,364,1
Brejinho,260250,PE,Nordeste,FIOCRUZ/ASTRAZENECA,1601,1433,168
Brejinho,260250,PE,Nordeste,BUTANTAN/SINOVAC,1479,744,735
Brejinho,260250,PE,Nordeste,PFIZER/BIONTECH,142,142,0
Brejinho De Nazaré,170370,TO,Norte,BUTANTAN/SINOVAC,998,529,469
Brejinho De Nazaré,170370,TO,Norte,FIOCRUZ/ASTRAZENECA,990,947,43
Brejo,210210,MA,Nordeste,FIOCRUZ/ASTRAZENECA,12327,9927,2400
Brejo,210210,MA,Nordeste,BUTANTAN/SINOVAC,4838,2598,2240
Brejo Alegre,350775,SP,Sudeste,BUTANTAN/SINOVAC,837,449,388
Brejo Alegre,350775,SP,Sudeste,FIOCRUZ/ASTRAZENECA,673,583,90
Brejo Alegre,350775,SP,Sudeste,PFIZER/BIONTECH,42,42,0
Brejo Da Madre De Deus,260260,PE,Nordeste,BUTANTAN/SINOVAC,6901,3701,3200
Brejo Da Madre De Deus,260260,PE,Nordeste,FIOCRUZ/ASTRAZENECA,6740,6162,578
Brejo Da Madre De Deus,260260,PE,Nordeste,PFIZER/BIONTECH,703,703,0
Brejo De Areia,210215,MA,Nordeste,FIOCRUZ/ASTRAZENECA,1321,1252,69
Brejo De Areia,210215,MA,Nordeste,BUTANTAN/SINOVAC,743,409,334
Brejo Do Cruz,250280,PB,Nordeste,BUTANTAN/SINOVAC,3143,1584,1559
Brejo Do Cruz,250280,PB,Nordeste,FIOCRUZ/ASTRAZENECA,2937,2709,228
Brejo Do Cruz,250280,PB,Nordeste,PFIZER/BIONTECH,256,255,1
Brejo Do Piauí,220198,PI,Nordeste,BUTANTAN/SINOVAC,741,402,339
Brejo Do Piauí,220198,PI,Nordeste,FIOCRUZ/ASTRAZENECA,383,339,44
Brejo Do Piauí,220198,PI,Nordeste,PFIZER/BIONTECH,14,14,0
Brejo Dos Santos,250290,PB,Nordeste,BUTANTAN/SINOVAC,1725,891,834
Brejo Dos Santos,250290,PB,Nordeste,FIOCRUZ/ASTRAZENECA,1337,1195,142
Brejo Dos Santos,250290,PB,Nordeste,PFIZER/BIONTECH,102,102,0
Brejo Grande,280070,SE,Nordeste,BUTANTAN/SINOVAC,371,239,132
Brejo Grande,280070,SE,Nordeste,FIOCRUZ/ASTRAZENECA,186,186,0
Brejo Grande Do Araguaia,150175,PA,Norte,FIOCRUZ/ASTRAZENECA,1177,1066,111
Brejo Grande Do Araguaia,150175,PA,Norte,BUTANTAN/SINOVAC,446,240,206
Brejo Santo,230250,CE,Nordeste,BUTANTAN/SINOVAC,7465,4043,3422
Brejo Santo,230250,CE,Nordeste,FIOCRUZ/ASTRAZENECA,3663,3160,503
Brejões,290430,BA,Nordeste,BUTANTAN/SINOVAC,1432,1174,258
Brejões,290430,BA,Nordeste,FIOCRUZ/ASTRAZENECA,837,790,47
Brejolândia,290440,BA,Nordeste,BUTANTAN/SINOVAC,1621,873,748
Brejolândia,290440,BA,Nordeste,FIOCRUZ/ASTRAZENECA,896,807,89
Brejolândia,290440,BA,Nordeste,PFIZER/BIONTECH,17,17,0
Breu Branco,150178,PA,Norte,FIOCRUZ/ASTRAZENECA,5050,4653,397
Breu Branco,150178,PA,Norte,BUTANTAN/SINOVAC,3177,1790,1387
Breves,150180,PA,Norte,FIOCRUZ/ASTRAZENECA,25170,20969,4201
Breves,150180,PA,Norte,BUTANTAN/SINOVAC,4563,2489,2074
Britânia,520380,GO,Centro-Oeste,FIOCRUZ/ASTRAZENECA,1304,1196,108
Britânia,520380,GO,Centro-Oeste,BUTANTAN/SINOVAC,1299,661,638
Brochier,430265,RS,Sul,BUTANTAN/SINOVAC,2079,992,1087
Brochier,430265,RS,Sul,FIOCRUZ/ASTRAZENECA,1513,1320,193
Brochier,430265,RS,Sul,PFIZER/BIONTECH,22,22,0
Brodowski,350780,SP,Sudeste,BUTANTAN/SINOVAC,5136,2627,2509
Brodowski,350780,SP,Sudeste,FIOCRUZ/ASTRAZENECA,4085,3779,306
Brodowski,350780,SP,Sudeste,PFIZER/BIONTECH,349,349,0
Brotas,350790,SP,Sudeste,FIOCRUZ/ASTRAZENECA,5312,4855,457
Brotas,350790,SP,Sudeste,BUTANTAN/SINOVAC,4924,2699,2225
Brotas,350790,SP,Sudeste,PFIZER/BIONTECH,592,592,0
Brotas De Macaúbas,290450,BA,Nordeste,FIOCRUZ/ASTRAZENECA,2514,2376,138
Brotas De Macaúbas,290450,BA,Nordeste,BUTANTAN/SINOVAC,2511,1304,1207
Brotas De Macaúbas,290450,BA,Nordeste,PFIZER/BIONTECH,93,93,0
Brumadinho,310900,MG,Sudeste,BUTANTAN/SINOVAC,8590,4470,4120
Brumadinho,310900,MG,Sudeste,FIOCRUZ/ASTRAZENECA,8017,7119,898
Brumadinho,310900,MG,Sudeste,PFIZER/BIONTECH,554,551,3
Brumado,290460,BA,Nordeste,BUTANTAN/SINOVAC,12803,6713,6090
Brumado,290460,BA,Nordeste,FIOCRUZ/ASTRAZENECA,11949,10899,1050
Brumado,290460,BA,Nordeste,PFIZER/BIONTECH,271,271,0
Brunópolis,420287,SC,Sul,BUTANTAN/SINOVAC,755,389,366
Brunópolis,420287,SC,Sul,FIOCRUZ/ASTRAZENECA,596,547,49
Brunópolis,420287,SC,Sul,PFIZER/BIONTECH,54,54,0
Brusque,420290,SC,Sul,BUTANTAN/SINOVAC,26338,13577,12761
Brusque,420290,SC,Sul,FIOCRUZ/ASTRAZENECA,19704,18785,919
Brusque,420290,SC,Sul,PFIZER/BIONTECH,6863,6863,0
Bueno Brandão,310910,MG,Sudeste,BUTANTAN/SINOVAC,2810,1414,1396
Bueno Brandão,310910,MG,Sudeste,FIOCRUZ/ASTRAZENECA,2404,2178,226
Bueno Brandão,310910,MG,Sudeste,PFIZER/BIONTECH,108,108,0
Buenópolis,310920,MG,Sudeste,FIOCRUZ/ASTRAZENECA,2440,2260,180
Buenópolis,310920,MG,Sudeste,BUTANTAN/SINOVAC,2180,1142,1038
Buenópolis,310920,MG,Sudeste,PFIZER/BIONTECH,132,132,0
Buenos Aires,260270,PE,Nordeste,FIOCRUZ/ASTRAZENECA,2774,2581,193
Buenos Aires,260270,PE,Nordeste,BUTANTAN/SINOVAC,2222,1188,1034
Buenos Aires,260270,PE,Nordeste,PFIZER/BIONTECH,202,202,0
Buerarema,290470,BA,Nordeste,BUTANTAN/SINOVAC,4867,2547,2320
Buerarema,290470,BA,Nordeste,FIOCRUZ/ASTRAZENECA,4526,3973,553
Buerarema,290470,BA,Nordeste,PFIZER/BIONTECH,207,206,1
Bugre,310925,MG,Sudeste,FIOCRUZ/ASTRAZENECA,1174,1068,106
Bugre,310925,MG,Sudeste,BUTANTAN/SINOVAC,940,507,433
Bugre,310925,MG,Sudeste,PFIZER/BIONTECH,17,17,0
Buíque,260280,PE,Nordeste,BUTANTAN/SINOVAC,11508,5979,5529
Buíque,260280,PE,Nordeste,FIOCRUZ/ASTRAZENECA,11304,10485,819
Buíque,260280,PE,Nordeste,PFIZER/BIONTECH,631,631,0
Bujari,120013,AC,Norte,FIOCRUZ/ASTRAZENECA,2774,2473,301
Bujari,120013,AC,Norte,BUTANTAN/SINOVAC,881,466,415
Bujari,120013,AC,Norte,PFIZER/BIONTECH,128,128,0
Bujaru,150190,PA,Norte,FIOCRUZ/ASTRAZENECA,4144,3504,640
Bujaru,150190,PA,Norte,BUTANTAN/SINOVAC,1845,1012,833
Buri,350800,SP,Sudeste,FIOCRUZ/ASTRAZENECA,3963,3620,343
Buri,350800,SP,Sudeste,BUTANTAN/SINOVAC,3705,1819,1886
Buri,350800,SP,Sudeste,PFIZER/BIONTECH,284,284,0
Buritama,350810,SP,Sudeste,FIOCRUZ/ASTRAZENECA,4652,4367,285
Buritama,350810,SP,Sudeste,BUTANTAN/SINOVAC,3950,1981,1969
Buritama,350810,SP,Sudeste,PFIZER/BIONTECH,477,476,1
Buriti,210220,MA,Nordeste,FIOCRUZ/ASTRAZENECA,4272,4004,268
Buriti,210220,MA,Nordeste,BUTANTAN/SINOVAC,4073,2194,1879
Buriti Alegre,520390,GO,Centro-Oeste,FIOCRUZ/ASTRAZENECA,2661,2514,147
Buriti Alegre,520390,GO,Centro-Oeste,BUTANTAN/SINOVAC,2034,1024,1010
Buriti Alegre,520390,GO,Centro-Oeste,PFIZER/BIONTECH,134,134,0
Buriti Bravo,210230,MA,Nordeste,FIOCRUZ/ASTRAZENECA,4532,4281,251
Buriti Bravo,210230,MA,Nordeste,BUTANTAN/SINOVAC,3773,2173,1600
Buriti De Goiás,520393,GO,Centro-Oeste,FIOCRUZ/ASTRAZENECA,757,713,44
Buriti De Goiás,520393,GO,Centro-Oeste,BUTANTAN/SINOVAC,573,290,283
Buriti De Goiás,520393,GO,Centro-Oeste,PFIZER/BIONTECH,30,30,0
Buriti Do Tocantins,170380,TO,Norte,BUTANTAN/SINOVAC,1545,786,759
Buriti Do Tocantins,170380,TO,Norte,FIOCRUZ/ASTRAZENECA,941,868,73
Buriti Dos Lopes,220200,PI,Nordeste,BUTANTAN/SINOVAC,3562,2253,1309
Buriti Dos Lopes,220200,PI,Nordeste,FIOCRUZ/ASTRAZENECA,2544,2354,190
Buriti Dos Montes,220202,PI,Nordeste,BUTANTAN/SINOVAC,1263,730,533
Buriti Dos Montes,220202,PI,Nordeste,FIOCRUZ/ASTRAZENECA,166,166,0
Buriticupu,210232,MA,Nordeste,FIOCRUZ/ASTRAZENECA,7499,7046,453
Buriticupu,210232,MA,Nordeste,BUTANTAN/SINOVAC,6598,3543,3055
Buritinópolis,520396,GO,Centro-Oeste,FIOCRUZ/ASTRAZENECA,744,673,71
Buritinópolis,520396,GO,Centro-Oeste,BUTANTAN/SINOVAC,436,212,224
Buritirama,290475,BA,Nordeste,FIOCRUZ/ASTRAZENECA,3919,3786,133
Buritirama,290475,BA,Nordeste,BUTANTAN/SINOVAC,3063,1571,1492
Buritirama,290475,BA,Nordeste,PFIZER/BIONTECH,39,39,0
Buritirana,210235,MA,Nordeste,BUTANTAN/SINOVAC,2199,1139,1060
Buritirana,210235,MA,Nordeste,FIOCRUZ/ASTRAZENECA,2067,1877,190
Buritis,110045,RO,Norte,BUTANTAN/SINOVAC,6114,3164,2950
Buritis,110045,RO,Norte,FIOCRUZ/ASTRAZENECA,2902,2706,196
Buritis,110045,RO,Norte,PFIZER/BIONTECH,185,185,0
Buritis,310930,MG,Sudeste,BUTANTAN/SINOVAC,4619,2604,2015
Buritis,310930,MG,Sudeste,FIOCRUZ/ASTRAZENECA,2103,1796,307
Buritis,310930,MG,Sudeste,PFIZER/BIONTECH,20,20,0
Buritizal,350820,SP,Sudeste,BUTANTAN/SINOVAC,1133,569,564
Buritizal,350820,SP,Sudeste,FIOCRUZ/ASTRAZENECA,1117,1001,116
Buritizal,350820,SP,Sudeste,PFIZER/BIONTECH,51,51,0
Buritizeiro,310940,MG,Sudeste,BUTANTAN/SINOVAC,3701,1914,1787
Buritizeiro,310940,MG,Sudeste,FIOCRUZ/ASTRAZENECA,3538,3358,180
Buritizeiro,310940,MG,Sudeste,PFIZER/BIONTECH,267,267,0
Butiá,430270,RS,Sul,FIOCRUZ/ASTRAZENECA,5627,5272,355
Butiá,430270,RS,Sul,BUTANTAN/SINOVAC,4578,2363,2215
Butiá,430270,RS,Sul,PFIZER/BIONTECH,580,580,0
Caapiranga,130083,AM,Norte,FIOCRUZ/ASTRAZENECA,3546,3107,439
Caapiranga,130083,AM,Norte,BUTANTAN/SINOVAC,1151,666,485
Caaporã,250300,PB,Nordeste,FIOCRUZ/ASTRAZENECA,2679,2548,131
Caaporã,250300,PB,Nordeste,BUTANTAN/SINOVAC,2499,1304,1195
Caaporã,250300,PB,Nordeste,PFIZER/BIONTECH,125,125,0
Caarapó,500240,MS,Centro-Oeste,BUTANTAN/SINOVAC,11626,5968,5658
Caarapó,500240,MS,Centro-Oeste,FIOCRUZ/ASTRAZENECA,5420,5071,349
Caarapó,500240,MS,Centro-Oeste,PFIZER/BIONTECH,724,724,0
Caatiba,290480,BA,Nordeste,FIOCRUZ/ASTRAZENECA,1588,1508,80
Caatiba,290480,BA,Nordeste,BUTANTAN/SINOVAC,1518,796,722
Caatiba,290480,BA,Nordeste,PFIZER/BIONTECH,69,69,0
Cabaceiras,250310,PB,Nordeste,BUTANTAN/SINOVAC,1421,741,680
Cabaceiras,250310,PB,Nordeste,FIOCRUZ/ASTRAZENECA,1052,936,116
Cabaceiras,250310,PB,Nordeste,PFIZER/BIONTECH,118,118,0
Cabaceiras Do Paraguaçu,290485,BA,Nordeste,FIOCRUZ/ASTRAZENECA,2998,2827,171
Cabaceiras Do Paraguaçu,290485,BA,Nordeste,BUTANTAN/SINOVAC,2724,1392,1332
Cabaceiras Do Paraguaçu,290485,BA,Nordeste,PFIZER/BIONTECH,343,343,0
Cabeceira Grande,310945,MG,Sudeste,BUTANTAN/SINOVAC,1301,658,643
Cabeceira Grande,310945,MG,Sudeste,FIOCRUZ/ASTRAZENECA,999,928,71
Cabeceira Grande,310945,MG,Sudeste,PFIZER/BIONTECH,21,21,0
Cabeceiras,520400,GO,Centro-Oeste,FIOCRUZ/ASTRAZENECA,2043,1875,168
Cabeceiras,520400,GO,Centro-Oeste,BUTANTAN/SINOVAC,780,407,373
Cabeceiras,520400,GO,Centro-Oeste,PFIZER/BIONTECH,103,103,0
Cabeceiras Do Piauí,220205,PI,Nordeste,FIOCRUZ/ASTRAZENECA,1616,1485,131
Cabeceiras Do Piauí,220205,PI,Nordeste,BUTANTAN/SINOVAC,1540,795,745
Cabedelo,250320,PB,Nordeste,BUTANTAN/SINOVAC,12442,6490,5952
Cabedelo,250320,PB,Nordeste,FIOCRUZ/ASTRAZENECA,11574,10562,1012
Cabedelo,250320,PB,Nordeste,PFIZER/BIONTECH,3555,3554,1
Cabixi,110003,RO,Norte,BUTANTAN/SINOVAC,1544,863,681
Cabixi,110003,RO,Norte,FIOCRUZ/ASTRAZENECA,1105,1056,49
Cabixi,110003,RO,Norte,PFIZER/BIONTECH,55,55,0
Cabo De Santo Agostinho,260290,PE,Nordeste,FIOCRUZ/ASTRAZENECA,52177,49385,2792
Cabo De Santo Agostinho,260290,PE,Nordeste,BUTANTAN/SINOVAC,29989,15676,14313
Cabo De Santo Agostinho,260290,PE,Nordeste,PFIZER/BIONTECH,3494,3484,10
Cabo Frio,330070,RJ,Sudeste,BUTANTAN/SINOVAC,42144,21770,20374
Cabo Frio,330070,RJ,Sudeste,FIOCRUZ/ASTRAZENECA,38253,34974,3279
Cabo Frio,330070,RJ,Sudeste,PFIZER/BIONTECH,5293,5286,7
Cabo Verde,310950,MG,Sudeste,FIOCRUZ/ASTRAZENECA,3344,3131,213
Cabo Verde,310950,MG,Sudeste,BUTANTAN/SINOVAC,2454,1271,1183
Cabo Verde,310950,MG,Sudeste,PFIZER/BIONTECH,149,149,0
Cabrália Paulista,350830,SP,Sudeste,BUTANTAN/SINOVAC,914,461,453
Cabrália Paulista,350830,SP,Sudeste,FIOCRUZ/ASTRAZENECA,896,830,66
Cabrália Paulista,350830,SP,Sudeste,PFIZER/BIONTECH,98,98,0
Cabreúva,350840,SP,Sudeste,BUTANTAN/SINOVAC,7009,3922,3087
Cabreúva,350840,SP,Sudeste,FIOCRUZ/ASTRAZENECA,6546,6197,349
Cabreúva,350840,SP,Sudeste,PFIZER/BIONTECH,732,726,6
Cabrobó,260300,PE,Nordeste,BUTANTAN/SINOVAC,10190,5352,4838
Cabrobó,260300,PE,Nordeste,FIOCRUZ/ASTRAZENECA,8847,8334,513
Cabrobó,260300,PE,Nordeste,PFIZER/BIONTECH,292,292,0
Caçador,420300,SC,Sul,FIOCRUZ/ASTRAZENECA,13391,12641,750
Caçador,420300,SC,Sul,BUTANTAN/SINOVAC,11766,6664,5102
Caçador,420300,SC,Sul,PFIZER/BIONTECH,1559,1557,2
Caçapava,350850,SP,Sudeste,BUTANTAN/SINOVAC,20766,10971,9795
Caçapava,350850,SP,Sudeste,FIOCRUZ/ASTRAZENECA,16437,14441,1996
Caçapava,350850,SP,Sudeste,PFIZER/BIONTECH,409,404,5
Caçapava Do Sul,430280,RS,Sul,BUTANTAN/SINOVAC,9502,4893,4609
Caçapava Do Sul,430280,RS,Sul,FIOCRUZ/ASTRAZENECA,9322,8377,945
Caçapava Do Sul,430280,RS,Sul,PFIZER/BIONTECH,1007,1007,0
Cacaulândia,110060,RO,Norte,BUTANTAN/SINOVAC,1167,623,544
Cacaulândia,110060,RO,Norte,FIOCRUZ/ASTRAZENECA,799,761,38
Cacequi,430290,RS,Sul,FIOCRUZ/ASTRAZENECA,3562,3410,152
Cacequi,430290,RS,Sul,BUTANTAN/SINOVAC,2713,1353,1360
Cacequi,430290,RS,Sul,PFIZER/BIONTECH,327,326,1
Cáceres,510250,MT,Centro-Oeste,FIOCRUZ/ASTRAZENECA,17123,16766,357
Cáceres,510250,MT,Centro-Oeste,BUTANTAN/SINOVAC,14972,8218,6754
Cáceres,510250,MT,Centro-Oeste,PFIZER/BIONTECH,146,146,0
Cachoeira,290490,BA,Nordeste,FIOCRUZ/ASTRAZENECA,8898,7429,1469
Cachoeira,290490,BA,Nordeste,BUTANTAN/SINOVAC,5097,2717,2380
Cachoeira,290490,BA,Nordeste,PFIZER/BIONTECH,558,557,1
Cachoeira Alta,520410,GO,Centro-Oeste,FIOCRUZ/ASTRAZENECA,3050,2862,188
Cachoeira Alta,520410,GO,Centro-Oeste,BUTANTAN/SINOVAC,1983,1026,957
Cachoeira Da Prata,310960,MG,Sudeste,BUTANTAN/SINOVAC,1009,505,504
Cachoeira Da Prata,310960,MG,Sudeste,FIOCRUZ/ASTRAZENECA,843,763,80
Cachoeira Da Prata,310960,MG,Sudeste,PFIZER/BIONTECH,47,47,0
Cachoeira De Goiás,520420,GO,Centro-Oeste,FIOCRUZ/ASTRAZENECA,609,566,43
Cachoeira De Goiás,520420,GO,Centro-Oeste,BUTANTAN/SINOVAC,315,174,141
Cachoeira De Minas,310970,MG,Sudeste,BUTANTAN/SINOVAC,2732,1375,1357
Cachoeira De Minas,310970,MG,Sudeste,FIOCRUZ/ASTRAZENECA,2506,2253,253
Cachoeira De Minas,310970,MG,Sudeste,PFIZER/BIONTECH,45,45,0
Cachoeira De Pajeú,310270,MG,Sudeste,BUTANTAN/SINOVAC,1918,1011,907
Cachoeira De Pajeú,310270,MG,Sudeste,FIOCRUZ/ASTRAZENECA,1527,1379,148
Cachoeira De Pajeú,310270,MG,Sudeste,PFIZER/BIONTECH,137,137,0
Cachoeira Do Arari,150200,PA,Norte,FIOCRUZ/ASTRAZENECA,3390,3307,83
Cachoeira Do Arari,150200,PA,Norte,BUTANTAN/SINOVAC,1106,585,521
Cachoeira Do Piriá,150195,PA,Norte,FIOCRUZ/ASTRAZENECA,2751,2509,242
Cachoeira Do Piriá,150195,PA,Norte,BUTANTAN/SINOVAC,2713,1774,939
Cachoeira Do Sul,430300,RS,Sul,BUTANTAN/SINOVAC,25553,13273,12280
Cachoeira Do Sul,430300,RS,Sul,FIOCRUZ/ASTRAZENECA,21726,18699,3027
Cachoeira Do Sul,430300,RS,Sul,PFIZER/BIONTECH,3249,3239,10
Cachoeira Dos Índios,250330,PB,Nordeste,BUTANTAN/SINOVAC,2438,1230,1208
Cachoeira Dos Índios,250330,PB,Nordeste,FIOCRUZ/ASTRAZENECA,1786,1612,174
Cachoeira Dos Índios,250330,PB,Nordeste,PFIZER/BIONTECH,119,118,1
Cachoeira Dourada,310980,MG,Sudeste,BUTANTAN/SINOVAC,679,332,347
Cachoeira Dourada,310980,MG,Sudeste,FIOCRUZ/ASTRAZENECA,441,376,65
Cachoeira Dourada,520425,GO,Centro-Oeste,FIOCRUZ/ASTRAZENECA,2261,2109,152
Cachoeira Dourada,520425,GO,Centro-Oeste,BUTANTAN/SINOVAC,1910,988,922
Cachoeira Grande,210237,MA,Nordeste,FIOCRUZ/ASTRAZENECA,2491,2400,91
Cachoeira Grande,210237,MA,Nordeste,BUTANTAN/SINOVAC,1053,578,475
Cachoeira Paulista,350860,SP,Sudeste,BUTANTAN/SINOVAC,7676,3959,3717
Cachoeira Paulista,350860,SP,Sudeste,FIOCRUZ/ASTRAZENECA,6149,5439,710
Cachoeira Paulista,350860,SP,Sudeste,PFIZER/BIONTECH,549,548,1
Cachoeiras De Macacu,330080,RJ,Sudeste,BUTANTAN/SINOVAC,12511,6567,5944
Cachoeiras De Macacu,330080,RJ,Sudeste,FIOCRUZ/ASTRAZENECA,9224,8348,876
Cachoeiras De Macacu,330080,RJ,Sudeste,PFIZER/BIONTECH,28,28,0
Cachoeirinha,170382,TO,Norte,BUTANTAN/SINOVAC,404,207,197
Cachoeirinha,170382,TO,Norte,FIOCRUZ/ASTRAZENECA,273,262,11
Cachoeirinha,260310,PE,Nordeste,FIOCRUZ/ASTRAZENECA,3618,3266,352
Cachoeirinha,260310,PE,Nordeste,BUTANTAN/SINOVAC,3587,1939,1648
Cachoeirinha,260310,PE,Nordeste,PFIZER/BIONTECH,185,184,1
Cachoeirinha,430310,RS,Sul,BUTANTAN/SINOVAC,33301,17411,15890
Cachoeirinha,430310,RS,Sul,FIOCRUZ/ASTRAZENECA,28372,26566,1806
Cachoeirinha,430310,RS,Sul,PFIZER/BIONTECH,2023,1889,134
Cachoeiro De Itapemirim,320120,ES,Sudeste,FIOCRUZ/ASTRAZENECA,47534,43356,4178
Cachoeiro De Itapemirim,320120,ES,Sudeste,BUTANTAN/SINOVAC,46568,24164,22404
Cachoeiro De Itapemirim,320120,ES,Sudeste,PFIZER/BIONTECH,3416,3409,7
Cacimba De Areia,250340,PB,Nordeste,BUTANTAN/SINOVAC,858,439,419
Cacimba De Areia,250340,PB,Nordeste,FIOCRUZ/ASTRAZENECA,502,462,40
Cacimba De Dentro,250350,PB,Nordeste,BUTANTAN/SINOVAC,4224,2150,2074
Cacimba De Dentro,250350,PB,Nordeste,FIOCRUZ/ASTRAZENECA,3039,2722,317
Cacimba De Dentro,250350,PB,Nordeste,PFIZER/BIONTECH,278,278,0
Cacimbas,250355,PB,Nordeste,FIOCRUZ/ASTRAZENECA,1593,1499,94
Cacimbas,250355,PB,Nordeste,BUTANTAN/SINOVAC,1156,599,557
Cacimbas,250355,PB,Nordeste,PFIZER/BIONTECH,74,74,0
Cacimbinhas,270120,AL,Nordeste,FIOCRUZ/ASTRAZENECA,2609,2270,339
Cacimbinhas,270120,AL,Nordeste,BUTANTAN/SINOVAC,1851,988,863
Cacique Doble,430320,RS,Sul,BUTANTAN/SINOVAC,2983,1380,1603
Cacique Doble,430320,RS,Sul,FIOCRUZ/ASTRAZENECA,2020,1739,281
Cacique Doble,430320,RS,Sul,PFIZER/BIONTECH,205,205,0
Cacoal,110004,RO,Norte,BUTANTAN/SINOVAC,21414,12655,8759
Cacoal,110004,RO,Norte,FIOCRUZ/ASTRAZENECA,20302,19110,1192
Cacoal,110004,RO,Norte,PFIZER/BIONTECH,2290,2289,1
Caconde,350870,SP,Sudeste,BUTANTAN/SINOVAC,4144,2216,1928
Caconde,350870,SP,Sudeste,FIOCRUZ/ASTRAZENECA,4026,3572,454
Caconde,350870,SP,Sudeste,PFIZER/BIONTECH,111,111,0
Caçu,520430,GO,Centro-Oeste,FIOCRUZ/ASTRAZENECA,3302,3003,299
Caçu,520430,GO,Centro-Oeste,BUTANTAN/SINOVAC,3129,1574,1555
Caçu,520430,GO,Centro-Oeste,PFIZER/BIONTECH,44,44,0
Caculé,290500,BA,Nordeste,FIOCRUZ/ASTRAZENECA,6440,5856,584
Caculé,290500,BA,Nordeste,BUTANTAN/SINOVAC,5996,3261,2735
Caculé,290500,BA,Nordeste,PFIZER/BIONTECH,318,318,0
Caém,290510,BA,Nordeste,FIOCRUZ/ASTRAZENECA,1841,1657,184
Caém,290510,BA,Nordeste,BUTANTAN/SINOVAC,1406,750,656
Caém,290510,BA,Nordeste,PFIZER/BIONTECH,11,11,0
Caetanópolis,310990,MG,Sudeste,BUTANTAN/SINOVAC,2357,1205,1152
Caetanópolis,310990,MG,Sudeste,FIOCRUZ/ASTRAZENECA,2010,1792,218
Caetanópolis,310990,MG,Sudeste,PFIZER/BIONTECH,147,146,1
Caetanos,290515,BA,Nordeste,BUTANTAN/SINOVAC,2751,1545,1206
Caetanos,290515,BA,Nordeste,FIOCRUZ/ASTRAZENECA,2166,1934,232
Caetanos,290515,BA,Nordeste,PFIZER/BIONTECH,18,18,0
Caeté,311000,MG,Sudeste,BUTANTAN/SINOVAC,8489,4474,4015
Caeté,311000,MG,Sudeste,FIOCRUZ/ASTRAZENECA,7011,6412,599
Caeté,311000,MG,Sudeste,PFIZER/BIONTECH,290,290,0
Caetés,260320,PE,Nordeste,FIOCRUZ/ASTRAZENECA,5311,4923,388
Caetés,260320,PE,Nordeste,BUTANTAN/SINOVAC,4793,2598,2195
Caetés,260320,PE,Nordeste,PFIZER/BIONTECH,217,217,0
Caetité,290520,BA,Nordeste,BUTANTAN/SINOVAC,8046,4599,3447
Caetité,290520,BA,Nordeste,FIOCRUZ/ASTRAZENECA,5351,4721,630
Caetité,290520,BA,Nordeste,PFIZER/BIONTECH,57,57,0
Cafarnaum,290530,BA,Nordeste,FIOCRUZ/ASTRAZENECA,4129,3624,505
Cafarnaum,290530,BA,Nordeste,BUTANTAN/SINOVAC,2896,1494,1402
Cafarnaum,290530,BA,Nordeste,PFIZER/BIONTECH,396,396,0
Cafeara,410340,PR,Sul,FIOCRUZ/ASTRAZENECA,820,760,60
Cafeara,410340,PR,Sul,BUTANTAN/SINOVAC,664,346,318
Cafelândia,350880,SP,Sudeste,BUTANTAN/SINOVAC,4477,2346,2131
Cafelândia,350880,SP,Sudeste,FIOCRUZ/ASTRAZENECA,4176,3702,474
Cafelândia,350880,SP,Sudeste,PFIZER/BIONTECH,110,110,0
Cafelândia,410345,PR,Sul,FIOCRUZ/ASTRAZENECA,3812,3643,169
Cafelândia,410345,PR,Sul,BUTANTAN/SINOVAC,2628,1413,1215
Cafelândia,410345,PR,Sul,PFIZER/BIONTECH,396,396,0
Cafezal Do Sul,410347,PR,Sul,FIOCRUZ/ASTRAZENECA,1149,1049,100
Cafezal Do Sul,410347,PR,Sul,BUTANTAN/SINOVAC,1067,568,499
Cafezal Do Sul,410347,PR,Sul,PFIZER/BIONTECH,16,16,0
Caiabu,350890,SP,Sudeste,FIOCRUZ/ASTRAZENECA,1449,1317,132
Caiabu,350890,SP,Sudeste,BUTANTAN/SINOVAC,1345,731,614
Caiabu,350890,SP,Sudeste,PFIZER/BIONTECH,122,122,0
Caiana,311010,MG,Sudeste,FIOCRUZ/ASTRAZENECA,1061,1001,60
Caiana,311010,MG,Sudeste,BUTANTAN/SINOVAC,943,493,450
Caiana,311010,MG,Sudeste,PFIZER/BIONTECH,47,47,0
Caiapônia,520440,GO,Centro-Oeste,FIOCRUZ/ASTRAZENECA,4384,4152,232
Caiapônia,520440,GO,Centro-Oeste,BUTANTAN/SINOVAC,3615,1875,1740
Caiapônia,520440,GO,Centro-Oeste,PFIZER/BIONTECH,299,299,0
Caibaté,430330,RS,Sul,BUTANTAN/SINOVAC,1772,897,875
Caibaté,430330,RS,Sul,FIOCRUZ/ASTRAZENECA,1614,1413,201
Caibaté,430330,RS,Sul,PFIZER/BIONTECH,195,195,0
Caibi,420310,SC,Sul,BUTANTAN/SINOVAC,1806,951,855
Caibi,420310,SC,Sul,FIOCRUZ/ASTRAZENECA,1517,1404,113
Caibi,420310,SC,Sul,PFIZER/BIONTECH,90,90,0
Caiçara,250360,PB,Nordeste,BUTANTAN/SINOVAC,1509,791,718
Caiçara,250360,PB,Nordeste,FIOCRUZ/ASTRAZENECA,1112,1024,88
Caiçara,250360,PB,Nordeste,PFIZER/BIONTECH,153,153,0
Caiçara,430340,RS,Sul,BUTANTAN/SINOVAC,1684,849,835
Caiçara,430340,RS,Sul,FIOCRUZ/ASTRAZENECA,1481,1350,131
Caiçara,430340,RS,Sul,PFIZER/BIONTECH,60,60,0
Caiçara Do Norte,240185,RN,Nordeste,BUTANTAN/SINOVAC,952,479,473
Caiçara Do Norte,240185,RN,Nordeste,FIOCRUZ/ASTRAZENECA,931,884,47
Caiçara Do Norte,240185,RN,Nordeste,PFIZER/BIONTECH,54,54,0
Caiçara Do Rio Do Vento,240190,RN,Nordeste,BUTANTAN/SINOVAC,798,404,394
Caiçara Do Rio Do Vento,240190,RN,Nordeste,FIOCRUZ/ASTRAZENECA,618,586,32
Caiçara Do Rio Do Vento,240190,RN,Nordeste,PFIZER/BIONTECH,90,90,0
Caicó,240200,RN,Nordeste,FIOCRUZ/ASTRAZENECA,15631,14203,1428
Caicó,240200,RN,Nordeste,BUTANTAN/SINOVAC,14644,7616,7028
Caicó,240200,RN,Nordeste,PFIZER/BIONTECH,2199,2196,3
Caieiras,350900,SP,Sudeste,FIOCRUZ/ASTRAZENECA,18340,17273,1067
Caieiras,350900,SP,Sudeste,BUTANTAN/SINOVAC,16357,8753,7604
Caieiras,350900,SP,Sudeste,PFIZER/BIONTECH,1303,1303,0
Cairu,290540,BA,Nordeste,FIOCRUZ/ASTRAZENECA,5925,5405,520
Cairu,290540,BA,Nordeste,BUTANTAN/SINOVAC,1830,974,856
Cairu,290540,BA,Nordeste,PFIZER/BIONTECH,76,76,0
Caiuá,350910,SP,Sudeste,BUTANTAN/SINOVAC,2424,1144,1280
Caiuá,350910,SP,Sudeste,FIOCRUZ/ASTRAZENECA,1467,1357,110
Caiuá,350910,SP,Sudeste,PFIZER/BIONTECH,22,22,0
Cajamar,350920,SP,Sudeste,FIOCRUZ/ASTRAZENECA,16906,15926,980
Cajamar,350920,SP,Sudeste,BUTANTAN/SINOVAC,12384,6729,5655
Cajamar,350920,SP,Sudeste,PFIZER/BIONTECH,1196,1195,1
Cajapió,210240,MA,Nordeste,FIOCRUZ/ASTRAZENECA,2318,2188,130
Cajapió,210240,MA,Nordeste,BUTANTAN/SINOVAC,1618,856,762
Cajari,210250,MA,Nordeste,FIOCRUZ/ASTRAZENECA,6653,6367,286
Cajari,210250,MA,Nordeste,BUTANTAN/SINOVAC,2016,1103,913
Cajati,350925,SP,Sudeste,BUTANTAN/SINOVAC,7404,3803,3601
Cajati,350925,SP,Sudeste,FIOCRUZ/ASTRAZENECA,6950,6508,442
Cajati,350925,SP,Sudeste,PFIZER/BIONTECH,293,292,1
Cajazeiras,250370,PB,Nordeste,BUTANTAN/SINOVAC,15568,8127,7441
Cajazeiras,250370,PB,Nordeste,FIOCRUZ/ASTRAZENECA,10880,9776,1104
Cajazeiras,250370,PB,Nordeste,PFIZER/BIONTECH,1590,1587,3
Cajazeiras Do Piauí,220207,PI,Nordeste,BUTANTAN/SINOVAC,733,380,353
Cajazeiras Do Piauí,220207,PI,Nordeste,FIOCRUZ/ASTRAZENECA,641,593,48
Cajazeirinhas,250375,PB,Nordeste,BUTANTAN/SINOVAC,857,446,411
Cajazeirinhas,250375,PB,Nordeste,FIOCRUZ/ASTRAZENECA,792,746,46
Cajazeirinhas,250375,PB,Nordeste,PFIZER/BIONTECH,32,32,0
Cajobi,350930,SP,Sudeste,BUTANTAN/SINOVAC,2983,1572,1411
Cajobi,350930,SP,Sudeste,FIOCRUZ/ASTRAZENECA,2616,2469,147
Cajobi,350930,SP,Sudeste,PFIZER/BIONTECH,76,76,0
Cajueiro,270130,AL,Nordeste,FIOCRUZ/ASTRAZENECA,3185,2922,263
Cajueiro,270130,AL,Nordeste,BUTANTAN/SINOVAC,2369,1278,1091
Cajueiro Da Praia,220208,PI,Nordeste,BUTANTAN/SINOVAC,902,505,397
Cajueiro Da Praia,220208,PI,Nordeste,FIOCRUZ/ASTRAZENECA,620,603,17
Cajuri,311020,MG,Sudeste,BUTANTAN/SINOVAC,1428,794,634
Cajuri,311020,MG,Sudeste,FIOCRUZ/ASTRAZENECA,879,787,92
Cajuru,350940,SP,Sudeste,FIOCRUZ/ASTRAZENECA,6103,5550,553
Cajuru,350940,SP,Sudeste,BUTANTAN/SINOVAC,5751,3068,2683
Cajuru,350940,SP,Sudeste,PFIZER/BIONTECH,251,251,0
Calçado,260330,PE,Nordeste,FIOCRUZ/ASTRAZENECA,2217,1996,221
Calçado,260330,PE,Nordeste,BUTANTAN/SINOVAC,1789,946,843
Calçado,260330,PE,Nordeste,PFIZER/BIONTECH,257,257,0
Calçoene,160020,AP,Norte,BUTANTAN/SINOVAC,1177,591,586
Calçoene,160020,AP,Norte,FIOCRUZ/ASTRAZENECA,1024,983,41
Calçoene,160020,AP,Norte,PFIZER/BIONTECH,72,72,0
Caldas,311030,MG,Sudeste,BUTANTAN/SINOVAC,3906,1976,1930
Caldas,311030,MG,Sudeste,FIOCRUZ/ASTRAZENECA,2925,2704,221
Caldas,311030,MG,Sudeste,PFIZER/BIONTECH,6,6,0
Caldas Brandão,250380,PB,Nordeste,BUTANTAN/SINOVAC,1321,668,653
Caldas Brandão,250380,PB,Nordeste,FIOCRUZ/ASTRAZENECA,1202,1102,100
Caldas Brandão,250380,PB,Nordeste,PFIZER/BIONTECH,120,120,0
Caldas Novas,520450,GO,Centro-Oeste,FIOCRUZ/ASTRAZENECA,24909,23393,1516
Caldas Novas,520450,GO,Centro-Oeste,BUTANTAN/SINOVAC,12133,6292,5841
Caldas Novas,520450,GO,Centro-Oeste,PFIZER/BIONTECH,260,259,1
Caldazinha,520455,GO,Centro-Oeste,FIOCRUZ/ASTRAZENECA,1116,1053,63
Caldazinha,520455,GO,Centro-Oeste,BUTANTAN/SINOVAC,853,472,381
Caldeirão Grande,290550,BA,Nordeste,FIOCRUZ/ASTRAZENECA,3228,2786,442
Caldeirão Grande,290550,BA,Nordeste,BUTANTAN/SINOVAC,2628,1411,1217
Caldeirão Grande,290550,BA,Nordeste,PFIZER/BIONTECH,327,327,0
Caldeirão Grande Do Piauí,220209,PI,Nordeste,BUTANTAN/SINOVAC,919,470,449
Caldeirão Grande Do Piauí,220209,PI,Nordeste,FIOCRUZ/ASTRAZENECA,869,809,60
Caldeirão Grande Do Piauí,220209,PI,Nordeste,PFIZER/BIONTECH,72,72,0
Califórnia,410350,PR,Sul,FIOCRUZ/ASTRAZENECA,2957,2813,144
Califórnia,410350,PR,Sul,BUTANTAN/SINOVAC,2205,1127,1078
Calmon,420315,SC,Sul,BUTANTAN/SINOVAC,449,225,224
Calmon,420315,SC,Sul,FIOCRUZ/ASTRAZENECA,430,392,38
Calumbi,260340,PE,Nordeste,FIOCRUZ/ASTRAZENECA,1412,1302,110
Calumbi,260340,PE,Nordeste,BUTANTAN/SINOVAC,1247,636,611
Calumbi,260340,PE,Nordeste,PFIZER/BIONTECH,220,220,0
Camacan,290560,BA,Nordeste,FIOCRUZ/ASTRAZENECA,4329,4021,308
Camacan,290560,BA,Nordeste,BUTANTAN/SINOVAC,3176,2288,888
Camacan,290560,BA,Nordeste,PFIZER/BIONTECH,397,397,0
Camaçari,290570,BA,Nordeste,FIOCRUZ/ASTRAZENECA,32766,28526,4240
Camaçari,290570,BA,Nordeste,BUTANTAN/SINOVAC,29332,15587,13745
Camaçari,290570,BA,Nordeste,PFIZER/BIONTECH,9369,9355,14
Camacho,311040,MG,Sudeste,BUTANTAN/SINOVAC,762,384,378
Camacho,311040,MG,Sudeste,FIOCRUZ/ASTRAZENECA,675,597,78
Camacho,311040,MG,Sudeste,PFIZER/BIONTECH,58,58,0
Camalaú,250390,PB,Nordeste,BUTANTAN/SINOVAC,1366,696,670
Camalaú,250390,PB,Nordeste,FIOCRUZ/ASTRAZENECA,1171,1041,130
Camalaú,250390,PB,Nordeste,PFIZER/BIONTECH,65,65,0
Camamu,290580,BA,Nordeste,FIOCRUZ/ASTRAZENECA,5643,5456,187
Camamu,290580,BA,Nordeste,BUTANTAN/SINOVAC,4519,2786,1733
Camamu,290580,BA,Nordeste,PFIZER/BIONTECH,65,65,0
Camanducaia,311050,MG,Sudeste,BUTANTAN/SINOVAC,4311,2214,2097
Camanducaia,311050,MG,Sudeste,FIOCRUZ/ASTRAZENECA,2484,2372,112
Camapuã,500260,MS,Centro-Oeste,BUTANTAN/SINOVAC,3352,1739,1613
Camapuã,500260,MS,Centro-Oeste,FIOCRUZ/ASTRAZENECA,2624,2408,216
Camapuã,500260,MS,Centro-Oeste,PFIZER/BIONTECH,299,299,0
Camaquã,430350,RS,Sul,BUTANTAN/SINOVAC,17749,9014,8735
Camaquã,430350,RS,Sul,FIOCRUZ/ASTRAZENECA,14420,13174,1246
Camaquã,430350,RS,Sul,PFIZER/BIONTECH,983,983,0
Camaragibe,260345,PE,Nordeste,FIOCRUZ/ASTRAZENECA,24408,23055,1353
Camaragibe,260345,PE,Nordeste,BUTANTAN/SINOVAC,24100,12757,11343
Camaragibe,260345,PE,Nordeste,PFIZER/BIONTECH,601,599,2
Camargo,430355,RS,Sul,BUTANTAN/SINOVAC,894,478,416
Camargo,430355,RS,Sul,FIOCRUZ/ASTRAZENECA,726,602,124
Camargo,430355,RS,Sul,PFIZER/BIONTECH,41,41,0
Cambará,410360,PR,Sul,FIOCRUZ/ASTRAZENECA,5892,5558,334
Cambará,410360,PR,Sul,BUTANTAN/SINOVAC,5614,2961,2653
Cambará Do Sul,430360,RS,Sul,BUTANTAN/SINOVAC,2001,930,1071
Cambará Do Sul,430360,RS,Sul,FIOCRUZ/ASTRAZENECA,1437,1343,94
Cambará Do Sul,430360,RS,Sul,PFIZER/BIONTECH,40,40,0
Cambé,410370,PR,Sul,FIOCRUZ/ASTRAZENECA,21080,19459,1621
Cambé,410370,PR,Sul,BUTANTAN/SINOVAC,19580,10301,9279
Cambé,410370,PR,Sul,PFIZER/BIONTECH,74,74,0
Cambira,410380,PR,Sul,FIOCRUZ/ASTRAZENECA,1990,1938,52
Cambira,410380,PR,Sul,BUTANTAN/SINOVAC,1709,893,816
Cambira,410380,PR,Sul,PFIZER/BIONTECH,77,77,0
Camboriú,420320,SC,Sul,BUTANTAN/SINOVAC,12106,6502,5604
Camboriú,420320,SC,Sul,FIOCRUZ/ASTRAZENECA,9649,9225,424
Camboriú,420320,SC,Sul,PFIZER/BIONTECH,1129,1129,0
Cambuci,330090,RJ,Sudeste,BUTANTAN/SINOVAC,3801,1989,1812
Cambuci,330090,RJ,Sudeste,FIOCRUZ/ASTRAZENECA,2878,2660,218
Cambuí,311060,MG,Sudeste,BUTANTAN/SINOVAC,6535,3396,3139
Cambuí,311060,MG,Sudeste,FIOCRUZ/ASTRAZENECA,5767,5393,374
Cambuí,311060,MG,Sudeste,PFIZER/BIONTECH,182,182,0
Cambuquira,311070,MG,Sudeste,FIOCRUZ/ASTRAZENECA,3335,2962,373
Cambuquira,311070,MG,Sudeste,BUTANTAN/SINOVAC,3206,1611,1595
Cambuquira,311070,MG,Sudeste,PFIZER/BIONTECH,146,145,1
Cametá,150210,PA,Norte,FIOCRUZ/ASTRAZENECA,29761,25831,3930
Cametá,150210,PA,Norte,BUTANTAN/SINOVAC,12599,7090,5509
Camocim,230260,CE,Nordeste,BUTANTAN/SINOVAC,2835,2238,597
Camocim,230260,CE,Nordeste,FIOCRUZ/ASTRAZENECA,1528,1515,13
Camocim De São Félix,260350,PE,Nordeste,FIOCRUZ/ASTRAZENECA,2927,2629,298
Camocim De São Félix,260350,PE,Nordeste,BUTANTAN/SINOVAC,2604,1342,1262
Camocim De São Félix,260350,PE,Nordeste,PFIZER/BIONTECH,373,373,0
Campanário,311080,MG,Sudeste,BUTANTAN/SINOVAC,1046,537,509
Campanário,311080,MG,Sudeste,FIOCRUZ/ASTRAZENECA,459,410,49
Campanário,311080,MG,Sudeste,PFIZER/BIONTECH,48,48,0
Campanha,311090,MG,Sudeste,FIOCRUZ/ASTRAZENECA,4419,4105,314
Campanha,311090,MG,Sudeste,BUTANTAN/SINOVAC,3803,1974,1829
Campanha,311090,MG,Sudeste,PFIZER/BIONTECH,234,233,1
Campestre,270135,AL,Nordeste,FIOCRUZ/ASTRAZENECA,1004,904,100
Campestre,270135,AL,Nordeste,BUTANTAN/SINOVAC,972,514,458
Campestre,311100,MG,Sudeste,BUTANTAN/SINOVAC,4590,2325,2265
Campestre,311100,MG,Sudeste,FIOCRUZ/ASTRAZENECA,3474,3208,266
Campestre,311100,MG,Sudeste,PFIZER/BIONTECH,164,164,0
Campestre Da Serra,430367,RS,Sul,FIOCRUZ/ASTRAZENECA,982,901,81
Campestre Da Serra,430367,RS,Sul,BUTANTAN/SINOVAC,947,505,442
Campestre Da Serra,430367,RS,Sul,PFIZER/BIONTECH,66,66,0
Campestre De Goiás,520460,GO,Centro-Oeste,BUTANTAN/SINOVAC,938,522,416
Campestre De Goiás,520460,GO,Centro-Oeste,FIOCRUZ/ASTRAZENECA,791,745,46
Campestre De Goiás,520460,GO,Centro-Oeste,PFIZER/BIONTECH,60,60,0
Campestre Do Maranhão,210255,MA,Nordeste,FIOCRUZ/ASTRAZENECA,2138,2012,126
Campestre Do Maranhão,210255,MA,Nordeste,BUTANTAN/SINOVAC,1837,1031,806
Campina Da Lagoa,410390,PR,Sul,FIOCRUZ/ASTRAZENECA,4810,4599,211
Campina Da Lagoa,410390,PR,Sul,BUTANTAN/SINOVAC,3131,1633,1498
Campina Da Lagoa,410390,PR,Sul,PFIZER/BIONTECH,186,186,0
Campina Das Missões,430370,RS,Sul,BUTANTAN/SINOVAC,2159,1100,1059
Campina Das Missões,430370,RS,Sul,FIOCRUZ/ASTRAZENECA,1732,1506,226
Campina Das Missões,430370,RS,Sul,PFIZER/BIONTECH,224,224,0
Campina Do Monte Alegre,350945,SP,Sudeste,BUTANTAN/SINOVAC,2330,1273,1057
Campina Do Monte Alegre,350945,SP,Sudeste,FIOCRUZ/ASTRAZENECA,2254,2066,188
Campina Do Monte Alegre,350945,SP,Sudeste,PFIZER/BIONTECH,146,146,0
Campina Do Simão,410395,PR,Sul,FIOCRUZ/ASTRAZENECA,1113,998,115
Campina Do Simão,410395,PR,Sul,BUTANTAN/SINOVAC,648,374,274
Campina Grande,250400,PB,Nordeste,BUTANTAN/SINOVAC,81927,45898,36029
Campina Grande,250400,PB,Nordeste,FIOCRUZ/ASTRAZENECA,59886,55326,4560
Campina Grande,250400,PB,Nordeste,PFIZER/BIONTECH,17335,17329,6
Campina Grande Do Sul,410400,PR,Sul,BUTANTAN/SINOVAC,10311,5334,4977
Campina Grande Do Sul,410400,PR,Sul,FIOCRUZ/ASTRAZENECA,8736,8568,168
Campina Grande Do Sul,410400,PR,Sul,PFIZER/BIONTECH,750,750,0
Campina Verde,311110,MG,Sudeste,BUTANTAN/SINOVAC,3397,2101,1296
Campina Verde,311110,MG,Sudeste,FIOCRUZ/ASTRAZENECA,1180,1046,134
Campinaçu,520465,GO,Centro-Oeste,FIOCRUZ/ASTRAZENECA,939,856,83
Campinaçu,520465,GO,Centro-Oeste,BUTANTAN/SINOVAC,559,314,245
Campinápolis,510260,MT,Centro-Oeste,BUTANTAN/SINOVAC,7888,4138,3750
Campinápolis,510260,MT,Centro-Oeste,FIOCRUZ/ASTRAZENECA,1009,860,149
Campinápolis,510260,MT,Centro-Oeste,PFIZER/BIONTECH,217,217,0
Campinas,350950,SP,Sudeste,FIOCRUZ/ASTRAZENECA,351667,320764,30903
Campinas,350950,SP,Sudeste,BUTANTAN/SINOVAC,285713,141731,143982
Campinas,350950,SP,Sudeste,PFIZER/BIONTECH,16037,16011,26
Campinas Do Piauí,220210,PI,Nordeste,FIOCRUZ/ASTRAZENECA,1875,1819,56
Campinas Do Piauí,220210,PI,Nordeste,BUTANTAN/SINOVAC,874,466,408
Campinas Do Sul,430380,RS,Sul,BUTANTAN/SINOVAC,1929,980,949
Campinas Do Sul,430380,RS,Sul,FIOCRUZ/ASTRAZENECA,1543,1328,215
Campinas Do Sul,430380,RS,Sul,PFIZER/BIONTECH,192,192,0
Campinorte,520470,GO,Centro-Oeste,FIOCRUZ/ASTRAZENECA,3348,3174,174
Campinorte,520470,GO,Centro-Oeste,BUTANTAN/SINOVAC,1773,904,869
Campo Alegre,270140,AL,Nordeste,FIOCRUZ/ASTRAZENECA,7163,6740,423
Campo Alegre,270140,AL,Nordeste,BUTANTAN/SINOVAC,5784,3487,2297
Campo Alegre,420330,SC,Sul,FIOCRUZ/ASTRAZENECA,2625,2401,224
Campo Alegre,420330,SC,Sul,BUTANTAN/SINOVAC,2172,1166,1006
Campo Alegre,420330,SC,Sul,PFIZER/BIONTECH,99,99,0
Campo Alegre De Goiás,520480,GO,Centro-Oeste,FIOCRUZ/ASTRAZENECA,1833,1696,137
Campo Alegre De Goiás,520480,GO,Centro-Oeste,BUTANTAN/SINOVAC,839,419,420
Campo Alegre De Goiás,520480,GO,Centro-Oeste,PFIZER/BIONTECH,77,77,0
Campo Alegre De Lourdes,290590,BA,Nordeste,BUTANTAN/SINOVAC,4790,2497,2293
Campo Alegre De Lourdes,290590,BA,Nordeste,FIOCRUZ/ASTRAZENECA,4649,4177,472
Campo Alegre Do Fidalgo,220211,PI,Nordeste,FIOCRUZ/ASTRAZENECA,1296,1158,138
Campo Alegre Do Fidalgo,220211,PI,Nordeste,BUTANTAN/SINOVAC,761,424,337
Campo Alegre Do Fidalgo,220211,PI,Nordeste,PFIZER/BIONTECH,118,118,0
Campo Azul,311115,MG,Sudeste,BUTANTAN/SINOVAC,1013,496,517
Campo Azul,311115,MG,Sudeste,FIOCRUZ/ASTRAZENECA,916,815,101
Campo Azul,311115,MG,Sudeste,PFIZER/BIONTECH,49,49,0
Campo Belo,311120,MG,Sudeste,BUTANTAN/SINOVAC,12347,6329,6018
Campo Belo,311120,MG,Sudeste,FIOCRUZ/ASTRAZENECA,9832,9346,486
Campo Belo,311120,MG,Sudeste,PFIZER/BIONTECH,43,43,0
Campo Belo Do Sul,420340,SC,Sul,FIOCRUZ/ASTRAZENECA,2144,1979,165
Campo Belo Do Sul,420340,SC,Sul,BUTANTAN/SINOVAC,1472,778,694
Campo Bom,430390,RS,Sul,FIOCRUZ/ASTRAZENECA,16957,15570,1387
Campo Bom,430390,RS,Sul,BUTANTAN/SINOVAC,13517,6890,6627
Campo Bom,430390,RS,Sul,PFIZER/BIONTECH,2253,2248,5
Campo Bonito,410405,PR,Sul,FIOCRUZ/ASTRAZENECA,889,833,56
Campo Bonito,410405,PR,Sul,BUTANTAN/SINOVAC,778,392,386
Campo Do Brito,280100,SE,Nordeste,BUTANTAN/SINOVAC,4035,2070,1965
Campo Do Brito,280100,SE,Nordeste,FIOCRUZ/ASTRAZENECA,2840,2834,6
Campo Do Brito,280100,SE,Nordeste,PFIZER/BIONTECH,59,59,0
Campo Do Meio,311130,MG,Sudeste,FIOCRUZ/ASTRAZENECA,3691,3609,82
Campo Do Meio,311130,MG,Sudeste,BUTANTAN/SINOVAC,2450,1283,1167
Campo Do Meio,311130,MG,Sudeste,PFIZER/BIONTECH,183,183,0
Campo Do Tenente,410410,PR,Sul,FIOCRUZ/ASTRAZENECA,1333,1328,5
Campo Do Tenente,410410,PR,Sul,BUTANTAN/SINOVAC,909,478,431
Campo Erê,420350,SC,Sul,FIOCRUZ/ASTRAZENECA,2495,2283,212
Campo Erê,420350,SC,Sul,BUTANTAN/SINOVAC,1932,1008,924
Campo Florido,311140,MG,Sudeste,FIOCRUZ/ASTRAZENECA,1405,1303,102
Campo Florido,311140,MG,Sudeste,BUTANTAN/SINOVAC,1272,638,634
Campo Florido,311140,MG,Sudeste,PFIZER/BIONTECH,255,255,0
Campo Formoso,290600,BA,Nordeste,FIOCRUZ/ASTRAZENECA,16305,15996,309
Campo Formoso,290600,BA,Nordeste,BUTANTAN/SINOVAC,11184,5955,5229
Campo Grande,270150,AL,Nordeste,BUTANTAN/SINOVAC,1348,758,590
Campo Grande,270150,AL,Nordeste,FIOCRUZ/ASTRAZENECA,1193,1106,87
Campo Grande,500270,MS,Centro-Oeste,BUTANTAN/SINOVAC,238567,123278,115289
Campo Grande,500270,MS,Centro-Oeste,FIOCRUZ/ASTRAZENECA,230840,195622,35218
Campo Grande,500270,MS,Centro-Oeste,PFIZER/BIONTECH,31748,31748,0
Campo Grande Do Piauí,220213,PI,Nordeste,BUTANTAN/SINOVAC,938,480,458
Campo Grande Do Piauí,220213,PI,Nordeste,FIOCRUZ/ASTRAZENECA,855,833,22
Campo Largo,410420,PR,Sul,BUTANTAN/SINOVAC,22615,11786,10829
Campo Largo,410420,PR,Sul,FIOCRUZ/ASTRAZENECA,22498,21144,1354
Campo Largo,410420,PR,Sul,PFIZER/BIONTECH,4046,4042,4
Campo Largo Do Piauí,220217,PI,Nordeste,FIOCRUZ/ASTRAZENECA,1718,1566,152
Campo Largo Do Piauí,220217,PI,Nordeste,BUTANTAN/SINOVAC,1102,592,510
Campo Limpo De Goiás,520485,GO,Centro-Oeste,FIOCRUZ/ASTRAZENECA,1159,1088,71
Campo Limpo De Goiás,520485,GO,Centro-Oeste,BUTANTAN/SINOVAC,1082,544,538
Campo Limpo Paulista,350960,SP,Sudeste,FIOCRUZ/ASTRAZENECA,14282,13459,823
Campo Limpo Paulista,350960,SP,Sudeste,BUTANTAN/SINOVAC,13341,7085,6256
Campo Limpo Paulista,350960,SP,Sudeste,PFIZER/BIONTECH,1575,1571,4
Campo Magro,410425,PR,Sul,FIOCRUZ/ASTRAZENECA,5087,4827,260
Campo Magro,410425,PR,Sul,BUTANTAN/SINOVAC,3808,1995,1813
Campo Magro,410425,PR,Sul,PFIZER/BIONTECH,690,690,0
Campo Maior,220220,PI,Nordeste,FIOCRUZ/ASTRAZENECA,9930,8917,1013
Campo Maior,220220,PI,Nordeste,BUTANTAN/SINOVAC,9191,4737,4454
Campo Maior,220220,PI,Nordeste,PFIZER/BIONTECH,1482,1482,0
Campo Mourão,410430,PR,Sul,FIOCRUZ/ASTRAZENECA,22652,21108,1544
Campo Mourão,410430,PR,Sul,BUTANTAN/SINOVAC,18884,9883,9001
Campo Mourão,410430,PR,Sul,PFIZER/BIONTECH,5104,5101,3
Campo Novo,430400,RS,Sul,BUTANTAN/SINOVAC,1386,705,681
Campo Novo,430400,RS,Sul,FIOCRUZ/ASTRAZENECA,919,835,84
Campo Novo,430400,RS,Sul,PFIZER/BIONTECH,82,82,0
Campo Novo De Rondônia,110070,RO,Norte,FIOCRUZ/ASTRAZENECA,1725,1671,54
Campo Novo De Rondônia,110070,RO,Norte,BUTANTAN/SINOVAC,1643,834,809
Campo Novo Do Parecis,510263,MT,Centro-Oeste,FIOCRUZ/ASTRAZENECA,3654,3266,388
Campo Novo Do Parecis,510263,MT,Centro-Oeste,BUTANTAN/SINOVAC,3067,1580,1487
Campo Novo Do Parecis,510263,MT,Centro-Oeste,PFIZER/BIONTECH,181,181,0
Campo Redondo,240210,RN,Nordeste,BUTANTAN/SINOVAC,971,497,474
Campo Redondo,240210,RN,Nordeste,FIOCRUZ/ASTRAZENECA,314,269,45
Campo Redondo,240210,RN,Nordeste,PFIZER/BIONTECH,23,23,0
Campo Verde,510267,MT,Centro-Oeste,FIOCRUZ/ASTRAZENECA,6811,6412,399
Campo Verde,510267,MT,Centro-Oeste,BUTANTAN/SINOVAC,5897,3139,2758
Campo Verde,510267,MT,Centro-Oeste,PFIZER/BIONTECH,423,421,2
Campos Altos,311150,MG,Sudeste,BUTANTAN/SINOVAC,2295,1163,1132
Campos Altos,311150,MG,Sudeste,FIOCRUZ/ASTRAZENECA,1726,1531,195
Campos Belos,520490,GO,Centro-Oeste,FIOCRUZ/ASTRAZENECA,5655,4649,1006
Campos Belos,520490,GO,Centro-Oeste,BUTANTAN/SINOVAC,1325,702,623
Campos Belos,520490,GO,Centro-Oeste,PFIZER/BIONTECH,1245,1242,3
Campos Borges,430410,RS,Sul,BUTANTAN/SINOVAC,1014,540,474
Campos Borges,430410,RS,Sul,FIOCRUZ/ASTRAZENECA,904,753,151
Campos Borges,430410,RS,Sul,PFIZER/BIONTECH,54,54,0
Campos De Júlio,510268,MT,Centro-Oeste,FIOCRUZ/ASTRAZENECA,1052,981,71
Campos De Júlio,510268,MT,Centro-Oeste,BUTANTAN/SINOVAC,672,335,337
Campos De Júlio,510268,MT,Centro-Oeste,PFIZER/BIONTECH,40,40,0
Campos Do Jordão,350970,SP,Sudeste,FIOCRUZ/ASTRAZENECA,10479,9430,1049
Campos Do Jordão,350970,SP,Sudeste,BUTANTAN/SINOVAC,9820,4914,4906
Campos Do Jordão,350970,SP,Sudeste,PFIZER/BIONTECH,1079,1079,0
Campos Dos Goytacazes,330100,RJ,Sudeste,BUTANTAN/SINOVAC,90018,55171,34847
Campos Dos Goytacazes,330100,RJ,Sudeste,FIOCRUZ/ASTRAZENECA,66612,59210,7402
Campos Dos Goytacazes,330100,RJ,Sudeste,PFIZER/BIONTECH,7081,7063,18
Campos Gerais,311160,MG,Sudeste,FIOCRUZ/ASTRAZENECA,6280,5865,415
Campos Gerais,311160,MG,Sudeste,BUTANTAN/SINOVAC,5902,3020,2882
Campos Gerais,311160,MG,Sudeste,PFIZER/BIONTECH,187,187,0
Campos Lindos,170384,TO,Norte,BUTANTAN/SINOVAC,999,601,398
Campos Lindos,170384,TO,Norte,FIOCRUZ/ASTRAZENECA,781,747,34
Campos Novos,420360,SC,Sul,FIOCRUZ/ASTRAZENECA,7357,6692,665
Campos Novos,420360,SC,Sul,BUTANTAN/SINOVAC,6969,3757,3212
Campos Novos Paulista,350980,SP,Sudeste,BUTANTAN/SINOVAC,1835,1056,779
Campos Novos Paulista,350980,SP,Sudeste,FIOCRUZ/ASTRAZENECA,1402,1274,128
Campos Novos Paulista,350980,SP,Sudeste,PFIZER/BIONTECH,134,134,0
Campos Sales,230270,CE,Nordeste,BUTANTAN/SINOVAC,4967,2707,2260
Campos Sales,230270,CE,Nordeste,FIOCRUZ/ASTRAZENECA,3759,3427,332
Campos Verdes,520495,GO,Centro-Oeste,FIOCRUZ/ASTRAZENECA,1105,1084,21
Campos Verdes,520495,GO,Centro-Oeste,BUTANTAN/SINOVAC,574,289,285
Camutanga,260360,PE,Nordeste,FIOCRUZ/ASTRAZENECA,1966,1823,143
Camutanga,260360,PE,Nordeste,BUTANTAN/SINOVAC,1398,732,666
Camutanga,260360,PE,Nordeste,PFIZER/BIONTECH,157,157,0
Cana Verde,311190,MG,Sudeste,BUTANTAN/SINOVAC,1700,881,819
Cana Verde,311190,MG,Sudeste,FIOCRUZ/ASTRAZENECA,1204,1083,121
Cana Verde,311190,MG,Sudeste,PFIZER/BIONTECH,115,115,0
Canaã,311170,MG,Sudeste,BUTANTAN/SINOVAC,1950,947,1003
Canaã,311170,MG,Sudeste,FIOCRUZ/ASTRAZENECA,1028,905,123
Canaã,311170,MG,Sudeste,PFIZER/BIONTECH,29,29,0
Canaã Dos Carajás,150215,PA,Norte,FIOCRUZ/ASTRAZENECA,6785,6110,675
Canaã Dos Carajás,150215,PA,Norte,BUTANTAN/SINOVAC,1680,936,744
Canabrava Do Norte,510269,MT,Centro-Oeste,BUTANTAN/SINOVAC,826,431,395
Canabrava Do Norte,510269,MT,Centro-Oeste,FIOCRUZ/ASTRAZENECA,283,267,16
Canabrava Do Norte,510269,MT,Centro-Oeste,PFIZER/BIONTECH,42,42,0
Cananéia,350990,SP,Sudeste,BUTANTAN/SINOVAC,3036,1702,1334
Cananéia,350990,SP,Sudeste,FIOCRUZ/ASTRAZENECA,2175,2008,167
Cananéia,350990,SP,Sudeste,PFIZER/BIONTECH,222,222,0
Canapi,270160,AL,Nordeste,FIOCRUZ/ASTRAZENECA,3344,3086,258
Canapi,270160,AL,Nordeste,BUTANTAN/SINOVAC,2889,1500,1389
Canápolis,290610,BA,Nordeste,BUTANTAN/SINOVAC,1915,1060,855
Canápolis,290610,BA,Nordeste,FIOCRUZ/ASTRAZENECA,1906,1743,163
Canápolis,290610,BA,Nordeste,PFIZER/BIONTECH,26,26,0
Canápolis,311180,MG,Sudeste,FIOCRUZ/ASTRAZENECA,2348,2189,159
Canápolis,311180,MG,Sudeste,BUTANTAN/SINOVAC,2290,1168,1122
Canápolis,311180,MG,Sudeste,PFIZER/BIONTECH,480,479,1
Canarana,290620,BA,Nordeste,FIOCRUZ/ASTRAZENECA,7306,6271,1035
Canarana,290620,BA,Nordeste,BUTANTAN/SINOVAC,4402,2262,2140
Canarana,290620,BA,Nordeste,PFIZER/BIONTECH,285,285,0
Canarana,510270,MT,Centro-Oeste,FIOCRUZ/ASTRAZENECA,3096,2866,230
Canarana,510270,MT,Centro-Oeste,BUTANTAN/SINOVAC,2778,1396,1382
Canarana,510270,MT,Centro-Oeste,PFIZER/BIONTECH,75,75,0
Canas,350995,SP,Sudeste,BUTANTAN/SINOVAC,903,531,372
Canas,350995,SP,Sudeste,FIOCRUZ/ASTRAZENECA,688,630,58
Canas,350995,SP,Sudeste,PFIZER/BIONTECH,96,96,0
Canavieira,220225,PI,Nordeste,BUTANTAN/SINOVAC,736,397,339
Canavieira,220225,PI,Nordeste,FIOCRUZ/ASTRAZENECA,635,568,67
Canavieira,220225,PI,Nordeste,PFIZER/BIONTECH,55,55,0
Canavieiras,290630,BA,Nordeste,BUTANTAN/SINOVAC,5637,3037,2600
Canavieiras,290630,BA,Nordeste,FIOCRUZ/ASTRAZENECA,4801,4425,376
Canavieiras,290630,BA,Nordeste,PFIZER/BIONTECH,78,78,0
Candeal,290640,BA,Nordeste,BUTANTAN/SINOVAC,2000,1012,988
Candeal,290640,BA,Nordeste,FIOCRUZ/ASTRAZENECA,1876,1742,134
Candeal,290640,BA,Nordeste,PFIZER/BIONTECH,136,136,0
Candeias,290650,BA,Nordeste,FIOCRUZ/ASTRAZENECA,15497,13962,1535
Candeias,290650,BA,Nordeste,BUTANTAN/SINOVAC,11973,6373,5600
Candeias,290650,BA,Nordeste,PFIZER/BIONTECH,3813,3799,14
Candeias,311200,MG,Sudeste,BUTANTAN/SINOVAC,3641,1840,1801
Candeias,311200,MG,Sudeste,FIOCRUZ/ASTRAZENECA,3522,3211,311
Candeias,311200,MG,Sudeste,PFIZER/BIONTECH,151,151,0
Candeias Do Jamari,110080,RO,Norte,FIOCRUZ/ASTRAZENECA,3831,3678,153
Candeias Do Jamari,110080,RO,Norte,BUTANTAN/SINOVAC,3614,1994,1620
Candeias Do Jamari,110080,RO,Norte,PFIZER/BIONTECH,117,117,0
Candelária,430420,RS,Sul,FIOCRUZ/ASTRAZENECA,7759,7234,525
Candelária,430420,RS,Sul,BUTANTAN/SINOVAC,7599,4117,3482
Candelária,430420,RS,Sul,PFIZER/BIONTECH,832,832,0
Candiba,290660,BA,Nordeste,FIOCRUZ/ASTRAZENECA,3659,3393,266
Candiba,290660,BA,Nordeste,BUTANTAN/SINOVAC,3219,1625,1594
Candiba,290660,BA,Nordeste,PFIZER/BIONTECH,220,220,0
Cândido De Abreu,410440,PR,Sul,FIOCRUZ/ASTRAZENECA,3359,3166,193
Cândido De Abreu,410440,PR,Sul,BUTANTAN/SINOVAC,3342,1790,1552
Cândido De Abreu,410440,PR,Sul,PFIZER/BIONTECH,382,381,1
Cândido Godói,430430,RS,Sul,BUTANTAN/SINOVAC,2099,1055,1044
Cândido Godói,430430,RS,Sul,FIOCRUZ/ASTRAZENECA,1808,1636,172
Cândido Godói,430430,RS,Sul,PFIZER/BIONTECH,208,208,0
Cândido Mendes,210260,MA,Nordeste,FIOCRUZ/ASTRAZENECA,5451,3797,1654
Cândido Mendes,210260,MA,Nordeste,BUTANTAN/SINOVAC,2151,1141,1010
Cândido Mota,351000,SP,Sudeste,FIOCRUZ/ASTRAZENECA,8116,7596,520
Cândido Mota,351000,SP,Sudeste,BUTANTAN/SINOVAC,7726,3926,3800
Cândido Mota,351000,SP,Sudeste,PFIZER/BIONTECH,736,736,0
Cândido Rodrigues,351010,SP,Sudeste,BUTANTAN/SINOVAC,1062,517,545
Cândido Rodrigues,351010,SP,Sudeste,FIOCRUZ/ASTRAZENECA,748,671,77
Cândido Rodrigues,351010,SP,Sudeste,PFIZER/BIONTECH,65,65,0
Cândido Sales,290670,BA,Nordeste,FIOCRUZ/ASTRAZENECA,4825,4495,330
Cândido Sales,290670,BA,Nordeste,BUTANTAN/SINOVAC,4755,2478,2277
Cândido Sales,290670,BA,Nordeste,PFIZER/BIONTECH,377,376,1
Candiota,430435,RS,Sul,FIOCRUZ/ASTRAZENECA,2305,2121,184
Candiota,430435,RS,Sul,BUTANTAN/SINOVAC,1728,926,802
Candiota,430435,RS,Sul,PFIZER/BIONTECH,376,375,1
Candói,410442,PR,Sul,FIOCRUZ/ASTRAZENECA,3842,3613,229
Candói,410442,PR,Sul,BUTANTAN/SINOVAC,2668,1446,1222
Candói,410442,PR,Sul,PFIZER/BIONTECH,204,204,0
Canela,430440,RS,Sul,FIOCRUZ/ASTRAZENECA,10205,9306,899
Canela,430440,RS,Sul,BUTANTAN/SINOVAC,7837,4035,3802
Canela,430440,RS,Sul,PFIZER/BIONTECH,840,839,1
Canelinha,420370,SC,Sul,FIOCRUZ/ASTRAZENECA,2425,2165,260
Canelinha,420370,SC,Sul,BUTANTAN/SINOVAC,1548,937,611
Canelinha,420370,SC,Sul,PFIZER/BIONTECH,179,179,0
Canguaretama,240220,RN,Nordeste,FIOCRUZ/ASTRAZENECA,5251,4850,401
Canguaretama,240220,RN,Nordeste,BUTANTAN/SINOVAC,4308,2293,2015
Canguaretama,240220,RN,Nordeste,PFIZER/BIONTECH,376,376,0
Canguçu,430450,RS,Sul,BUTANTAN/SINOVAC,15288,7908,7380
Canguçu,430450,RS,Sul,FIOCRUZ/ASTRAZENECA,15179,13775,1404
Canguçu,430450,RS,Sul,PFIZER/BIONTECH,1758,1756,2
Canhoba,280110,SE,Nordeste,BUTANTAN/SINOVAC,811,441,370
Canhoba,280110,SE,Nordeste,FIOCRUZ/ASTRAZENECA,633,584,49
Canhotinho,260370,PE,Nordeste,FIOCRUZ/ASTRAZENECA,4806,4463,343
Canhotinho,260370,PE,Nordeste,BUTANTAN/SINOVAC,3922,2080,1842
Canhotinho,260370,PE,Nordeste,PFIZER/BIONTECH,482,482,0
Canindé,230280,CE,Nordeste,BUTANTAN/SINOVAC,13420,6891,6529
Canindé,230280,CE,Nordeste,FIOCRUZ/ASTRAZENECA,5377,4779,598
Canindé De São Francisco,280120,SE,Nordeste,FIOCRUZ/ASTRAZENECA,3817,3817,0
Canindé De São Francisco,280120,SE,Nordeste,BUTANTAN/SINOVAC,3627,1932,1695
Canindé De São Francisco,280120,SE,Nordeste,PFIZER/BIONTECH,456,456,0
Canitar,351015,SP,Sudeste,FIOCRUZ/ASTRAZENECA,1306,1236,70
Canitar,351015,SP,Sudeste,BUTANTAN/SINOVAC,977,526,451
Canitar,351015,SP,Sudeste,PFIZER/BIONTECH,79,79,0
Canoas,430460,RS,Sul,BUTANTAN/SINOVAC,82521,42652,39869
Canoas,430460,RS,Sul,FIOCRUZ/ASTRAZENECA,77641,72308,5333
Canoas,430460,RS,Sul,PFIZER/BIONTECH,9101,9097,4
Canoinhas,420380,SC,Sul,FIOCRUZ/ASTRAZENECA,12148,11235,913
Canoinhas,420380,SC,Sul,BUTANTAN/SINOVAC,8360,4341,4019
Canoinhas,420380,SC,Sul,PFIZER/BIONTECH,54,52,2
Cansanção,290680,BA,Nordeste,FIOCRUZ/ASTRAZENECA,7412,6279,1133
Cansanção,290680,BA,Nordeste,BUTANTAN/SINOVAC,6545,3414,3131
Cansanção,290680,BA,Nordeste,PFIZER/BIONTECH,1066,1065,1
Cantá,140017,RR,Norte,BUTANTAN/SINOVAC,4831,2830,2001
Cantá,140017,RR,Norte,FIOCRUZ/ASTRAZENECA,2132,2097,35
Cantagalo,311205,MG,Sudeste,BUTANTAN/SINOVAC,977,502,475
Cantagalo,311205,MG,Sudeste,FIOCRUZ/ASTRAZENECA,901,808,93
Cantagalo,311205,MG,Sudeste,PFIZER/BIONTECH,20,20,0
Cantagalo,330110,RJ,Sudeste,FIOCRUZ/ASTRAZENECA,4976,4552,424
Cantagalo,330110,RJ,Sudeste,BUTANTAN/SINOVAC,4758,2503,2255
Cantagalo,330110,RJ,Sudeste,PFIZER/BIONTECH,1113,1111,2
Cantagalo,410445,PR,Sul,FIOCRUZ/ASTRAZENECA,3087,2955,132
Cantagalo,410445,PR,Sul,BUTANTAN/SINOVAC,2151,1101,1050
Cantagalo,410445,PR,Sul,PFIZER/BIONTECH,48,48,0
Cantanhede,210270,MA,Nordeste,FIOCRUZ/ASTRAZENECA,2982,2811,171
Cantanhede,210270,MA,Nordeste,BUTANTAN/SINOVAC,2446,1275,1171
Canto Do Buriti,220230,PI,Nordeste,BUTANTAN/SINOVAC,3273,1842,1431
Canto Do Buriti,220230,PI,Nordeste,FIOCRUZ/ASTRAZENECA,2544,2412,132
Canto Do Buriti,220230,PI,Nordeste,PFIZER/BIONTECH,3,3,0
Canudos,290682,BA,Nordeste,FIOCRUZ/ASTRAZENECA,2722,2466,256
Canudos,290682,BA,Nordeste,BUTANTAN/SINOVAC,2407,1247,1160
Canudos,290682,BA,Nordeste,PFIZER/BIONTECH,48,48,0
Canudos Do Vale,430461,RS,Sul,BUTANTAN/SINOVAC,590,314,276
Canudos Do Vale,430461,RS,Sul,FIOCRUZ/ASTRAZENECA,433,392,41
Canudos Do Vale,430461,RS,Sul,PFIZER/BIONTECH,58,58,0
Canutama,130090,AM,Norte,BUTANTAN/SINOVAC,2045,1199,846
Canutama,130090,AM,Norte,FIOCRUZ/ASTRAZENECA,1530,1328,202
Capanema,150220,PA,Norte,FIOCRUZ/ASTRAZENECA,10463,9288,1175
Capanema,150220,PA,Norte,BUTANTAN/SINOVAC,8403,4437,3966
Capanema,410450,PR,Sul,BUTANTAN/SINOVAC,5256,2537,2719
Capanema,410450,PR,Sul,FIOCRUZ/ASTRAZENECA,4714,4444,270
Capão Alto,420325,SC,Sul,BUTANTAN/SINOVAC,571,299,272
Capão Alto,420325,SC,Sul,FIOCRUZ/ASTRAZENECA,508,453,55
Capão Bonito,351020,SP,Sudeste,FIOCRUZ/ASTRAZENECA,9707,9086,621
Capão Bonito,351020,SP,Sudeste,BUTANTAN/SINOVAC,8644,4508,4136
Capão Bonito,351020,SP,Sudeste,PFIZER/BIONTECH,721,720,1
Capão Bonito Do Sul,430462,RS,Sul,BUTANTAN/SINOVAC,592,351,241
Capão Bonito Do Sul,430462,RS,Sul,FIOCRUZ/ASTRAZENECA,410,360,50
Capão Bonito Do Sul,430462,RS,Sul,PFIZER/BIONTECH,70,70,0
Capão Da Canoa,430463,RS,Sul,FIOCRUZ/ASTRAZENECA,13544,12791,753
Capão Da Canoa,430463,RS,Sul,BUTANTAN/SINOVAC,12565,6745,5820
Capão Da Canoa,430463,RS,Sul,PFIZER/BIONTECH,1466,1464,2
Capão Do Cipó,430465,RS,Sul,FIOCRUZ/ASTRAZENECA,911,813,98
Capão Do Cipó,430465,RS,Sul,BUTANTAN/SINOVAC,679,343,336
Capão Do Cipó,430465,RS,Sul,PFIZER/BIONTECH,151,151,0
Capão Do Leão,430466,RS,Sul,FIOCRUZ/ASTRAZENECA,5878,5594,284
Capão Do Leão,430466,RS,Sul,BUTANTAN/SINOVAC,5099,2597,2502
Capão Do Leão,430466,RS,Sul,PFIZER/BIONTECH,801,801,0
Caparaó,311210,MG,Sudeste,BUTANTAN/SINOVAC,1092,574,518
Caparaó,311210,MG,Sudeste,FIOCRUZ/ASTRAZENECA,844,778,66
Caparaó,311210,MG,Sudeste,PFIZER/BIONTECH,86,86,0
Capela,270170,AL,Nordeste,BUTANTAN/SINOVAC,2485,1320,1165
Capela,270170,AL,Nordeste,FIOCRUZ/ASTRAZENECA,2168,1989,179
Capela,270170,AL,Nordeste,PFIZER/BIONTECH,35,35,0
Capela,280130,SE,Nordeste,FIOCRUZ/ASTRAZENECA,4220,4153,67
Capela,280130,SE,Nordeste,BUTANTAN/SINOVAC,3135,1651,1484
Capela,280130,SE,Nordeste,PFIZER/BIONTECH,77,77,0
Capela De Santana,430468,RS,Sul,FIOCRUZ/ASTRAZENECA,2466,2333,133
Capela De Santana,430468,RS,Sul,BUTANTAN/SINOVAC,2185,1172,1013
Capela De Santana,430468,RS,Sul,PFIZER/BIONTECH,111,111,0
Capela Do Alto,351030,SP,Sudeste,FIOCRUZ/ASTRAZENECA,4234,4059,175
Capela Do Alto,351030,SP,Sudeste,BUTANTAN/SINOVAC,3787,2097,1690
Capela Do Alto,351030,SP,Sudeste,PFIZER/BIONTECH,321,321,0
Capela Do Alto Alegre,290685,BA,Nordeste,BUTANTAN/SINOVAC,3182,1660,1522
Capela Do Alto Alegre,290685,BA,Nordeste,FIOCRUZ/ASTRAZENECA,2829,2482,347
Capela Do Alto Alegre,290685,BA,Nordeste,PFIZER/BIONTECH,158,158,0
Capela Nova,311220,MG,Sudeste,BUTANTAN/SINOVAC,1150,586,564
Capela Nova,311220,MG,Sudeste,FIOCRUZ/ASTRAZENECA,1118,896,222
Capelinha,311230,MG,Sudeste,FIOCRUZ/ASTRAZENECA,6554,6013,541
Capelinha,311230,MG,Sudeste,BUTANTAN/SINOVAC,5732,2999,2733
Capelinha,311230,MG,Sudeste,PFIZER/BIONTECH,581,581,0
Capetinga,311240,MG,Sudeste,BUTANTAN/SINOVAC,1765,912,853
Capetinga,311240,MG,Sudeste,FIOCRUZ/ASTRAZENECA,1131,1123,8
Capetinga,311240,MG,Sudeste,PFIZER/BIONTECH,2,2,0
Capim,250403,PB,Nordeste,BUTANTAN/SINOVAC,1027,535,492
Capim,250403,PB,Nordeste,FIOCRUZ/ASTRAZENECA,809,738,71
Capim,250403,PB,Nordeste,PFIZER/BIONTECH,29,29,0
Capim Branco,311250,MG,Sudeste,FIOCRUZ/ASTRAZENECA,2170,2004,166
Capim Branco,311250,MG,Sudeste,BUTANTAN/SINOVAC,1847,934,913
Capim Branco,311250,MG,Sudeste,PFIZER/BIONTECH,113,113,0
Capim Grosso,290687,BA,Nordeste,FIOCRUZ/ASTRAZENECA,7415,6671,744
Capim Grosso,290687,BA,Nordeste,BUTANTAN/SINOVAC,6950,4048,2902
Capim Grosso,290687,BA,Nordeste,PFIZER/BIONTECH,651,640,11
Capinópolis,311260,MG,Sudeste,BUTANTAN/SINOVAC,3866,1985,1881
Capinópolis,311260,MG,Sudeste,FIOCRUZ/ASTRAZENECA,3194,2942,252
Capinópolis,311260,MG,Sudeste,PFIZER/BIONTECH,167,167,0
Capinzal,420390,SC,Sul,FIOCRUZ/ASTRAZENECA,4549,4222,327
Capinzal,420390,SC,Sul,BUTANTAN/SINOVAC,4094,2086,2008
Capinzal,420390,SC,Sul,PFIZER/BIONTECH,290,290,0
Capinzal Do Norte,210275,MA,Nordeste,FIOCRUZ/ASTRAZENECA,3277,3065,212
Capinzal Do Norte,210275,MA,Nordeste,BUTANTAN/SINOVAC,2017,1089,928
Capistrano,230290,CE,Nordeste,BUTANTAN/SINOVAC,2439,1382,1057
Capistrano,230290,CE,Nordeste,FIOCRUZ/ASTRAZENECA,860,766,94
Capitão,430469,RS,Sul,BUTANTAN/SINOVAC,791,395,396
Capitão,430469,RS,Sul,FIOCRUZ/ASTRAZENECA,717,639,78
Capitão,430469,RS,Sul,PFIZER/BIONTECH,168,168,0
Capitão Andrade,311265,MG,Sudeste,FIOCRUZ/ASTRAZENECA,1444,1345,99
Capitão Andrade,311265,MG,Sudeste,BUTANTAN/SINOVAC,1328,680,648
Capitão Andrade,311265,MG,Sudeste,PFIZER/BIONTECH,51,51,0
Capitão De Campos,220240,PI,Nordeste,FIOCRUZ/ASTRAZENECA,2058,1943,115
Capitão De Campos,220240,PI,Nordeste,BUTANTAN/SINOVAC,2018,1068,950
Capitão De Campos,220240,PI,Nordeste,PFIZER/BIONTECH,105,105,0
Capitão Enéas,311270,MG,Sudeste,BUTANTAN/SINOVAC,1947,1034,913
Capitão Enéas,311270,MG,Sudeste,FIOCRUZ/ASTRAZENECA,1033,976,57
Capitão Gervásio Oliveira,220245,PI,Nordeste,FIOCRUZ/ASTRAZENECA,727,671,56
Capitão Gervásio Oliveira,220245,PI,Nordeste,BUTANTAN/SINOVAC,690,358,332
Capitão Leônidas Marques,410460,PR,Sul,FIOCRUZ/ASTRAZENECA,3511,3305,206
Capitão Leônidas Marques,410460,PR,Sul,BUTANTAN/SINOVAC,3334,1733,1601
Capitão Leônidas Marques,410460,PR,Sul,PFIZER/BIONTECH,349,349,0
Capitão Poço,150230,PA,Norte,FIOCRUZ/ASTRAZENECA,11544,10022,1522
Capitão Poço,150230,PA,Norte,BUTANTAN/SINOVAC,7509,3839,3670
Capitólio,311280,MG,Sudeste,BUTANTAN/SINOVAC,2115,1080,1035
Capitólio,311280,MG,Sudeste,FIOCRUZ/ASTRAZENECA,1568,1394,174
Capitólio,311280,MG,Sudeste,PFIZER/BIONTECH,39,39,0
Capivari,351040,SP,Sudeste,FIOCRUZ/ASTRAZENECA,11466,10109,1357
Capivari,351040,SP,Sudeste,BUTANTAN/SINOVAC,9787,4954,4833
Capivari,351040,SP,Sudeste,PFIZER/BIONTECH,718,718,0
Capivari De Baixo,420395,SC,Sul,FIOCRUZ/ASTRAZENECA,5305,4817,488
Capivari De Baixo,420395,SC,Sul,BUTANTAN/SINOVAC,2994,1556,1438
Capivari De Baixo,420395,SC,Sul,PFIZER/BIONTECH,127,127,0
Capivari Do Sul,430467,RS,Sul,FIOCRUZ/ASTRAZENECA,1274,1184,90
Capivari Do Sul,430467,RS,Sul,BUTANTAN/SINOVAC,996,506,490
Capivari Do Sul,430467,RS,Sul,PFIZER/BIONTECH,169,169,0
Capixaba,120017,AC,Norte,BUTANTAN/SINOVAC,1676,878,798
Capixaba,120017,AC,Norte,FIOCRUZ/ASTRAZENECA,1453,1281,172
Capoeiras,260380,PE,Nordeste,FIOCRUZ/ASTRAZENECA,4901,4560,341
Capoeiras,260380,PE,Nordeste,BUTANTAN/SINOVAC,3794,1994,1800
Capoeiras,260380,PE,Nordeste,PFIZER/BIONTECH,199,198,1
Caputira,311290,MG,Sudeste,BUTANTAN/SINOVAC,2427,1250,1177
Caputira,311290,MG,Sudeste,FIOCRUZ/ASTRAZENECA,1385,1241,144
Caputira,311290,MG,Sudeste,PFIZER/BIONTECH,46,46,0
Caraá,430471,RS,Sul,BUTANTAN/SINOVAC,3037,1660,1377
Caraá,430471,RS,Sul,FIOCRUZ/ASTRAZENECA,2013,1866,147
Caraá,430471,RS,Sul,PFIZER/BIONTECH,316,316,0
Caracaraí,140020,RR,Norte,BUTANTAN/SINOVAC,3064,1605,1459
Caracaraí,140020,RR,Norte,FIOCRUZ/ASTRAZENECA,2908,2882,26
Caracol,220250,PI,Nordeste,FIOCRUZ/ASTRAZENECA,1808,1685,123
Caracol,220250,PI,Nordeste,BUTANTAN/SINOVAC,1356,735,621
Caracol,500280,MS,Centro-Oeste,FIOCRUZ/ASTRAZENECA,1320,1206,114
Caracol,500280,MS,Centro-Oeste,BUTANTAN/SINOVAC,1206,628,578
Caracol,500280,MS,Centro-Oeste,PFIZER/BIONTECH,196,196,0
Caraguatatuba,351050,SP,Sudeste,FIOCRUZ/ASTRAZENECA,31736,29815,1921
Caraguatatuba,351050,SP,Sudeste,BUTANTAN/SINOVAC,24923,13922,11001
Caraguatatuba,351050,SP,Sudeste,PFIZER/BIONTECH,2002,2001,1
Caraí,311300,MG,Sudeste,BUTANTAN/SINOVAC,5239,2795,2444
Caraí,311300,MG,Sudeste,FIOCRUZ/ASTRAZENECA,2450,2255,195
Caraí,311300,MG,Sudeste,PFIZER/BIONTECH,211,211,0
Caraíbas,290689,BA,Nordeste,BUTANTAN/SINOVAC,2483,1398,1085
Caraíbas,290689,BA,Nordeste,FIOCRUZ/ASTRAZENECA,1698,1508,190
Caraíbas,290689,BA,Nordeste,PFIZER/BIONTECH,134,134,0
Carambeí,410465,PR,Sul,FIOCRUZ/ASTRAZENECA,4526,4326,200
Carambeí,410465,PR,Sul,BUTANTAN/SINOVAC,2967,1584,1383
Carambeí,410465,PR,Sul,PFIZER/BIONTECH,257,257,0
Caranaíba,311310,MG,Sudeste,BUTANTAN/SINOVAC,794,402,392
Caranaíba,311310,MG,Sudeste,FIOCRUZ/ASTRAZENECA,637,539,98
Carandaí,311320,MG,Sudeste,FIOCRUZ/ASTRAZENECA,5243,4622,621
Carandaí,311320,MG,Sudeste,BUTANTAN/SINOVAC,4634,2392,2242
Carandaí,311320,MG,Sudeste,PFIZER/BIONTECH,470,470,0
Carangola,311330,MG,Sudeste,BUTANTAN/SINOVAC,9468,4903,4565
Carangola,311330,MG,Sudeste,FIOCRUZ/ASTRAZENECA,5948,5461,487
Carangola,311330,MG,Sudeste,PFIZER/BIONTECH,372,370,2
Carapebus,330093,RJ,Sudeste,BUTANTAN/SINOVAC,3042,1605,1437
Carapebus,330093,RJ,Sudeste,FIOCRUZ/ASTRAZENECA,1009,945,64
Carapicuíba,351060,SP,Sudeste,BUTANTAN/SINOVAC,24966,14075,10891
Carapicuíba,351060,SP,Sudeste,FIOCRUZ/ASTRAZENECA,23115,21722,1393
Carapicuíba,351060,SP,Sudeste,PFIZER/BIONTECH,1600,1598,2
Caratinga,311340,MG,Sudeste,BUTANTAN/SINOVAC,15286,8056,7230
Caratinga,311340,MG,Sudeste,FIOCRUZ/ASTRAZENECA,10685,9536,1149
Caratinga,311340,MG,Sudeste,PFIZER/BIONTECH,902,900,2
Carauari,130100,AM,Norte,FIOCRUZ/ASTRAZENECA,4656,3740,916
Carauari,130100,AM,Norte,BUTANTAN/SINOVAC,2432,1383,1049
Caraúbas,240230,RN,Nordeste,FIOCRUZ/ASTRAZENECA,4900,4502,398
Caraúbas,240230,RN,Nordeste,BUTANTAN/SINOVAC,4393,2229,2164
Caraúbas,240230,RN,Nordeste,PFIZER/BIONTECH,546,546,0
Caraúbas,250407,PB,Nordeste,BUTANTAN/SINOVAC,1144,591,553
Caraúbas,250407,PB,Nordeste,FIOCRUZ/ASTRAZENECA,734,653,81
Caraúbas,250407,PB,Nordeste,PFIZER/BIONTECH,59,59,0
Caraúbas Do Piauí,220253,PI,Nordeste,BUTANTAN/SINOVAC,799,457,342
Caraúbas Do Piauí,220253,PI,Nordeste,FIOCRUZ/ASTRAZENECA,636,577,59
Caravelas,290690,BA,Nordeste,FIOCRUZ/ASTRAZENECA,4402,4059,343
Caravelas,290690,BA,Nordeste,BUTANTAN/SINOVAC,4030,2148,1882
Caravelas,290690,BA,Nordeste,PFIZER/BIONTECH,157,157,0
Carazinho,430470,RS,Sul,FIOCRUZ/ASTRAZENECA,18652,16713,1939
Carazinho,430470,RS,Sul,BUTANTAN/SINOVAC,16062,8137,7925
Carazinho,430470,RS,Sul,PFIZER/BIONTECH,2021,2019,2
Carbonita,311350,MG,Sudeste,BUTANTAN/SINOVAC,1762,903,859
Carbonita,311350,MG,Sudeste,FIOCRUZ/ASTRAZENECA,1556,1439,117
Carbonita,311350,MG,Sudeste,PFIZER/BIONTECH,190,190,0
Cardeal Da Silva,290700,BA,Nordeste,FIOCRUZ/ASTRAZENECA,1731,1588,143
Cardeal Da Silva,290700,BA,Nordeste,BUTANTAN/SINOVAC,1547,810,737
Cardeal Da Silva,290700,BA,Nordeste,PFIZER/BIONTECH,95,94,1
Cardoso,351070,SP,Sudeste,BUTANTAN/SINOVAC,3478,1795,1683
Cardoso,351070,SP,Sudeste,FIOCRUZ/ASTRAZENECA,3186,2808,378
Cardoso,351070,SP,Sudeste,PFIZER/BIONTECH,108,108,0
Cardoso Moreira,330115,RJ,Sudeste,BUTANTAN/SINOVAC,2940,1746,1194
Cardoso Moreira,330115,RJ,Sudeste,FIOCRUZ/ASTRAZENECA,2100,1754,346
Careaçu,311360,MG,Sudeste,BUTANTAN/SINOVAC,1598,847,751
Careaçu,311360,MG,Sudeste,FIOCRUZ/ASTRAZENECA,1457,1327,130
Careaçu,311360,MG,Sudeste,PFIZER/BIONTECH,101,101,0
Careiro,130110,AM,Norte,FIOCRUZ/ASTRAZENECA,9327,7785,1542
Careiro,130110,AM,Norte,BUTANTAN/SINOVAC,4236,2342,1894
Careiro Da Várzea,130115,AM,Norte,FIOCRUZ/ASTRAZENECA,6981,5929,1052
Careiro Da Várzea,130115,AM,Norte,BUTANTAN/SINOVAC,1543,880,663
Cariacica,320130,ES,Sudeste,FIOCRUZ/ASTRAZENECA,90825,83312,7513
Cariacica,320130,ES,Sudeste,BUTANTAN/SINOVAC,61466,30565,30901
Cariacica,320130,ES,Sudeste,PFIZER/BIONTECH,4567,4565,2
Caridade,230300,CE,Nordeste,BUTANTAN/SINOVAC,2902,1527,1375
Caridade,230300,CE,Nordeste,FIOCRUZ/ASTRAZENECA,1235,961,274
Caridade Do Piauí,220255,PI,Nordeste,FIOCRUZ/ASTRAZENECA,718,534,184
Caridade Do Piauí,220255,PI,Nordeste,BUTANTAN/SINOVAC,630,318,312
Carinhanha,290710,BA,Nordeste,FIOCRUZ/ASTRAZENECA,6771,6235,536
Carinhanha,290710,BA,Nordeste,BUTANTAN/SINOVAC,3976,2115,1861
Carinhanha,290710,BA,Nordeste,PFIZER/BIONTECH,322,322,0
Carira,280140,SE,Nordeste,BUTANTAN/SINOVAC,5145,2693,2452
Carira,280140,SE,Nordeste,FIOCRUZ/ASTRAZENECA,3406,3402,4
Carira,280140,SE,Nordeste,PFIZER/BIONTECH,218,218,0
Cariré,230310,CE,Nordeste,BUTANTAN/SINOVAC,3359,2104,1255
Cariré,230310,CE,Nordeste,FIOCRUZ/ASTRAZENECA,980,894,86
Cariri Do Tocantins,170386,TO,Norte,FIOCRUZ/ASTRAZENECA,765,724,41
Cariri Do Tocantins,170386,TO,Norte,BUTANTAN/SINOVAC,754,379,375
Caririaçu,230320,CE,Nordeste,BUTANTAN/SINOVAC,5899,3149,2750
Caririaçu,230320,CE,Nordeste,FIOCRUZ/ASTRAZENECA,2273,1893,380
Cariús,230330,CE,Nordeste,BUTANTAN/SINOVAC,4002,2060,1942
Cariús,230330,CE,Nordeste,FIOCRUZ/ASTRAZENECA,1684,1286,398
Carlinda,510279,MT,Centro-Oeste,BUTANTAN/SINOVAC,2069,1081,988
Carlinda,510279,MT,Centro-Oeste,FIOCRUZ/ASTRAZENECA,1583,1461,122
Carlinda,510279,MT,Centro-Oeste,PFIZER/BIONTECH,36,36,0
Carlópolis,410470,PR,Sul,FIOCRUZ/ASTRAZENECA,3545,3363,182
Carlópolis,410470,PR,Sul,BUTANTAN/SINOVAC,3162,1632,1530
Carlos Barbosa,430480,RS,Sul,FIOCRUZ/ASTRAZENECA,6694,6239,455
Carlos Barbosa,430480,RS,Sul,BUTANTAN/SINOVAC,6154,3226,2928
Carlos Barbosa,430480,RS,Sul,PFIZER/BIONTECH,855,855,0
Carlos Chagas,311370,MG,Sudeste,BUTANTAN/SINOVAC,4085,2120,1965
Carlos Chagas,311370,MG,Sudeste,FIOCRUZ/ASTRAZENECA,3256,3050,206
Carlos Chagas,311370,MG,Sudeste,PFIZER/BIONTECH,319,318,1
Carlos Gomes,430485,RS,Sul,BUTANTAN/SINOVAC,511,253,258
Carlos Gomes,430485,RS,Sul,FIOCRUZ/ASTRAZENECA,376,325,51
Carlos Gomes,430485,RS,Sul,PFIZER/BIONTECH,52,52,0
Carmésia,311380,MG,Sudeste,BUTANTAN/SINOVAC,1053,540,513
Carmésia,311380,MG,Sudeste,FIOCRUZ/ASTRAZENECA,761,701,60
Carmésia,311380,MG,Sudeste,PFIZER/BIONTECH,44,44,0
Carmo,330120,RJ,Sudeste,BUTANTAN/SINOVAC,6974,3824,3150
Carmo,330120,RJ,Sudeste,FIOCRUZ/ASTRAZENECA,5796,5316,480
Carmo,330120,RJ,Sudeste,PFIZER/BIONTECH,6,6,0
Carmo Da Cachoeira,311390,MG,Sudeste,FIOCRUZ/ASTRAZENECA,2682,2475,207
Carmo Da Cachoeira,311390,MG,Sudeste,BUTANTAN/SINOVAC,2242,1169,1073
Carmo Da Cachoeira,311390,MG,Sudeste,PFIZER/BIONTECH,187,187,0
Carmo Da Mata,311400,MG,Sudeste,BUTANTAN/SINOVAC,2604,1326,1278
Carmo Da Mata,311400,MG,Sudeste,FIOCRUZ/ASTRAZENECA,2398,2170,228
Carmo Da Mata,311400,MG,Sudeste,PFIZER/BIONTECH,20,20,0
Carmo De Minas,311410,MG,Sudeste,FIOCRUZ/ASTRAZENECA,3118,2858,260
Carmo De Minas,311410,MG,Sudeste,BUTANTAN/SINOVAC,2471,1256,1215
Carmo De Minas,311410,MG,Sudeste,PFIZER/BIONTECH,92,92,0
Carmo Do Cajuru,311420,MG,Sudeste,FIOCRUZ/ASTRAZENECA,3394,3185,209
Carmo Do Cajuru,311420,MG,Sudeste,BUTANTAN/SINOVAC,3270,1730,1540
Carmo Do Cajuru,311420,MG,Sudeste,PFIZER/BIONTECH,151,150,1
Carmo Do Paranaíba,311430,MG,Sudeste,BUTANTAN/SINOVAC,8056,4101,3955
Carmo Do Paranaíba,311430,MG,Sudeste,FIOCRUZ/ASTRAZENECA,7269,5943,1326
Carmo Do Paranaíba,311430,MG,Sudeste,PFIZER/BIONTECH,504,504,0
Carmo Do Rio Claro,311440,MG,Sudeste,BUTANTAN/SINOVAC,4628,2333,2295
Carmo Do Rio Claro,311440,MG,Sudeste,FIOCRUZ/ASTRAZENECA,4511,4233,278
Carmo Do Rio Claro,311440,MG,Sudeste,PFIZER/BIONTECH,268,268,0
Carmo Do Rio Verde,520500,GO,Centro-Oeste,BUTANTAN/SINOVAC,1329,672,657
Carmo Do Rio Verde,520500,GO,Centro-Oeste,FIOCRUZ/ASTRAZENECA,1303,1192,111
Carmolândia,170388,TO,Norte,BUTANTAN/SINOVAC,479,251,228
Carmolândia,170388,TO,Norte,FIOCRUZ/ASTRAZENECA,360,350,10
Carmópolis,280150,SE,Nordeste,BUTANTAN/SINOVAC,959,496,463
Carmópolis,280150,SE,Nordeste,FIOCRUZ/ASTRAZENECA,736,728,8
Carmópolis De Minas,311450,MG,Sudeste,BUTANTAN/SINOVAC,3783,1982,1801
Carmópolis De Minas,311450,MG,Sudeste,FIOCRUZ/ASTRAZENECA,2921,2653,268
Carmópolis De Minas,311450,MG,Sudeste,PFIZER/BIONTECH,140,140,0
Carnaíba,260390,PE,Nordeste,FIOCRUZ/ASTRAZENECA,4932,4469,463
Carnaíba,260390,PE,Nordeste,BUTANTAN/SINOVAC,3343,1654,1689
Carnaíba,260390,PE,Nordeste,PFIZER/BIONTECH,411,409,2
Carnaúba Dos Dantas,240240,RN,Nordeste,BUTANTAN/SINOVAC,1738,920,818
Carnaúba Dos Dantas,240240,RN,Nordeste,FIOCRUZ/ASTRAZENECA,1190,1069,121
Carnaúba Dos Dantas,240240,RN,Nordeste,PFIZER/BIONTECH,66,66,0
Carnaubais,240250,RN,Nordeste,BUTANTAN/SINOVAC,2133,1106,1027
Carnaubais,240250,RN,Nordeste,FIOCRUZ/ASTRAZENECA,1463,1292,171
Carnaubais,240250,RN,Nordeste,PFIZER/BIONTECH,76,76,0
Carnaubal,230340,CE,Nordeste,BUTANTAN/SINOVAC,2374,1475,899
Carnaubal,230340,CE,Nordeste,FIOCRUZ/ASTRAZENECA,787,653,134
Carnaubeira Da Penha,260392,PE,Nordeste,BUTANTAN/SINOVAC,10178,5206,4972
Carnaubeira Da Penha,260392,PE,Nordeste,FIOCRUZ/ASTRAZENECA,1650,1532,118
Carnaubeira Da Penha,260392,PE,Nordeste,PFIZER/BIONTECH,232,232,0
Carneirinho,311455,MG,Sudeste,FIOCRUZ/ASTRAZENECA,2422,2157,265
Carneirinho,311455,MG,Sudeste,BUTANTAN/SINOVAC,2417,1233,1184
Carneirinho,311455,MG,Sudeste,PFIZER/BIONTECH,93,93,0
Carneiros,270180,AL,Nordeste,FIOCRUZ/ASTRAZENECA,1560,1447,113
Carneiros,270180,AL,Nordeste,BUTANTAN/SINOVAC,1154,577,577
Caroebe,140023,RR,Norte,BUTANTAN/SINOVAC,1981,1058,923
Caroebe,140023,RR,Norte,FIOCRUZ/ASTRAZENECA,504,492,12
Carolina,210280,MA,Nordeste,FIOCRUZ/ASTRAZENECA,4278,3955,323
Carolina,210280,MA,Nordeste,BUTANTAN/SINOVAC,3680,1930,1750
Carpina,260400,PE,Nordeste,FIOCRUZ/ASTRAZENECA,14391,13309,1082
Carpina,260400,PE,Nordeste,BUTANTAN/SINOVAC,10724,5590,5134
Carpina,260400,PE,Nordeste,PFIZER/BIONTECH,1625,1625,0
Carrancas,311460,MG,Sudeste,FIOCRUZ/ASTRAZENECA,1125,1058,67
Carrancas,311460,MG,Sudeste,BUTANTAN/SINOVAC,1083,541,542
Carrancas,311460,MG,Sudeste,PFIZER/BIONTECH,23,23,0
Carrapateira,250410,PB,Nordeste,BUTANTAN/SINOVAC,596,306,290
Carrapateira,250410,PB,Nordeste,FIOCRUZ/ASTRAZENECA,439,408,31
Carrapateira,250410,PB,Nordeste,PFIZER/BIONTECH,48,48,0
Carrasco Bonito,170389,TO,Norte,BUTANTAN/SINOVAC,645,329,316
Carrasco Bonito,170389,TO,Norte,FIOCRUZ/ASTRAZENECA,589,549,40
Caruaru,260410,PE,Nordeste,FIOCRUZ/ASTRAZENECA,64043,59691,4352
Caruaru,260410,PE,Nordeste,BUTANTAN/SINOVAC,62531,32248,30283
Caruaru,260410,PE,Nordeste,PFIZER/BIONTECH,12434,12410,24
Carutapera,210290,MA,Nordeste,FIOCRUZ/ASTRAZENECA,3249,2987,262
Carutapera,210290,MA,Nordeste,BUTANTAN/SINOVAC,2675,1418,1257
Carvalhópolis,311470,MG,Sudeste,BUTANTAN/SINOVAC,1088,547,541
Carvalhópolis,311470,MG,Sudeste,FIOCRUZ/ASTRAZENECA,923,825,98
Carvalhópolis,311470,MG,Sudeste,PFIZER/BIONTECH,40,40,0
Carvalhos,311480,MG,Sudeste,FIOCRUZ/ASTRAZENECA,1350,1256,94
Carvalhos,311480,MG,Sudeste,BUTANTAN/SINOVAC,1208,616,592
Carvalhos,311480,MG,Sudeste,PFIZER/BIONTECH,5,5,0
Casa Branca,351080,SP,Sudeste,BUTANTAN/SINOVAC,6898,3678,3220
Casa Branca,351080,SP,Sudeste,FIOCRUZ/ASTRAZENECA,5254,4768,486
Casa Branca,351080,SP,Sudeste,PFIZER/BIONTECH,219,219,0
Casa Grande,311490,MG,Sudeste,BUTANTAN/SINOVAC,563,285,278
Casa Grande,311490,MG,Sudeste,FIOCRUZ/ASTRAZENECA,555,423,132
Casa Grande,311490,MG,Sudeste,PFIZER/BIONTECH,44,44,0
Casa Nova,290720,BA,Nordeste,BUTANTAN/SINOVAC,11804,6257,5547
Casa Nova,290720,BA,Nordeste,FIOCRUZ/ASTRAZENECA,11427,10588,839
Casa Nova,290720,BA,Nordeste,PFIZER/BIONTECH,29,29,0
Casca,430490,RS,Sul,FIOCRUZ/ASTRAZENECA,3051,2647,404
Casca,430490,RS,Sul,BUTANTAN/SINOVAC,2614,1335,1279
Casca,430490,RS,Sul,PFIZER/BIONTECH,281,281,0
Cascalho Rico,311500,MG,Sudeste,BUTANTAN/SINOVAC,841,433,408
Cascalho Rico,311500,MG,Sudeste,FIOCRUZ/ASTRAZENECA,747,664,83
Cascalho Rico,311500,MG,Sudeste,PFIZER/BIONTECH,48,48,0
Cascavel,230350,CE,Nordeste,FIOCRUZ/ASTRAZENECA,4888,4739,149
Cascavel,230350,CE,Nordeste,BUTANTAN/SINOVAC,1886,1190,696
Cascavel,230350,CE,Nordeste,PFIZER/BIONTECH,354,354,0
Cascavel,410480,PR,Sul,FIOCRUZ/ASTRAZENECA,80030,71726,8304
Cascavel,410480,PR,Sul,BUTANTAN/SINOVAC,63902,32135,31767
Cascavel,410480,PR,Sul,PFIZER/BIONTECH,17206,17196,10
Caseara,170390,TO,Norte,BUTANTAN/SINOVAC,798,418,380
Caseara,170390,TO,Norte,FIOCRUZ/ASTRAZENECA,640,622,18
Caseiros,430495,RS,Sul,BUTANTAN/SINOVAC,909,455,454
Caseiros,430495,RS,Sul,FIOCRUZ/ASTRAZENECA,737,677,60
Caseiros,430495,RS,Sul,PFIZER/BIONTECH,150,150,0
Casimiro De Abreu,330130,RJ,Sudeste,BUTANTAN/SINOVAC,10054,5667,4387
Casimiro De Abreu,330130,RJ,Sudeste,FIOCRUZ/ASTRAZENECA,5912,5375,537
Casimiro De Abreu,330130,RJ,Sudeste,PFIZER/BIONTECH,817,814,3
Casinhas,260415,PE,Nordeste,FIOCRUZ/ASTRAZENECA,3240,3006,234
Casinhas,260415,PE,Nordeste,BUTANTAN/SINOVAC,2349,1318,1031
Casinhas,260415,PE,Nordeste,PFIZER/BIONTECH,165,165,0
Casserengue,250415,PB,Nordeste,BUTANTAN/SINOVAC,1861,1034,827
Casserengue,250415,PB,Nordeste,FIOCRUZ/ASTRAZENECA,885,759,126
Casserengue,250415,PB,Nordeste,PFIZER/BIONTECH,30,30,0
Cássia,311510,MG,Sudeste,BUTANTAN/SINOVAC,4339,2230,2109
Cássia,311510,MG,Sudeste,FIOCRUZ/ASTRAZENECA,3812,3511,301
Cássia,311510,MG,Sudeste,PFIZER/BIONTECH,304,304,0
Cássia Dos Coqueiros,351090,SP,Sudeste,BUTANTAN/SINOVAC,1540,743,797
Cássia Dos Coqueiros,351090,SP,Sudeste,FIOCRUZ/ASTRAZENECA,1303,1177,126
Cássia Dos Coqueiros,351090,SP,Sudeste,PFIZER/BIONTECH,41,41,0
Cassilândia,500290,MS,Centro-Oeste,FIOCRUZ/ASTRAZENECA,7113,6423,690
Cassilândia,500290,MS,Centro-Oeste,BUTANTAN/SINOVAC,6830,3599,3231
Cassilândia,500290,MS,Centro-Oeste,PFIZER/BIONTECH,746,744,2
Castanhal,150240,PA,Norte,FIOCRUZ/ASTRAZENECA,21968,20067,1901
Castanhal,150240,PA,Norte,BUTANTAN/SINOVAC,21571,13024,8547
Castanheira,510285,MT,Centro-Oeste,FIOCRUZ/ASTRAZENECA,1745,1678,67
Castanheira,510285,MT,Centro-Oeste,BUTANTAN/SINOVAC,1272,646,626
Castanheiras,110090,RO,Norte,BUTANTAN/SINOVAC,883,456,427
Castanheiras,110090,RO,Norte,FIOCRUZ/ASTRAZENECA,650,618,32
Castanheiras,110090,RO,Norte,PFIZER/BIONTECH,6,6,0
Castelândia,520505,GO,Centro-Oeste,FIOCRUZ/ASTRAZENECA,874,816,58
Castelândia,520505,GO,Centro-Oeste,BUTANTAN/SINOVAC,712,403,309
Castelo,320140,ES,Sudeste,BUTANTAN/SINOVAC,10017,5228,4789
Castelo,320140,ES,Sudeste,FIOCRUZ/ASTRAZENECA,8082,7618,464
Castelo,320140,ES,Sudeste,PFIZER/BIONTECH,1173,1173,0
Castelo Do Piauí,220260,PI,Nordeste,FIOCRUZ/ASTRAZENECA,3748,3471,277
Castelo Do Piauí,220260,PI,Nordeste,BUTANTAN/SINOVAC,3535,1869,1666
Castilho,351100,SP,Sudeste,BUTANTAN/SINOVAC,5250,2697,2553
Castilho,351100,SP,Sudeste,FIOCRUZ/ASTRAZENECA,4358,4010,348
Castilho,351100,SP,Sudeste,PFIZER/BIONTECH,513,513,0
Castro,410490,PR,Sul,FIOCRUZ/ASTRAZENECA,12970,12280,690
Castro,410490,PR,Sul,BUTANTAN/SINOVAC,10847,5665,5182
Castro,410490,PR,Sul,PFIZER/BIONTECH,3196,3193,3
Castro Alves,290730,BA,Nordeste,FIOCRUZ/ASTRAZENECA,5287,4940,347
Castro Alves,290730,BA,Nordeste,BUTANTAN/SINOVAC,4576,2352,2224
Castro Alves,290730,BA,Nordeste,PFIZER/BIONTECH,735,734,1
Cataguases,311530,MG,Sudeste,BUTANTAN/SINOVAC,16195,8362,7833
Cataguases,311530,MG,Sudeste,FIOCRUZ/ASTRAZENECA,13263,12446,817
Cataguases,311530,MG,Sudeste,PFIZER/BIONTECH,774,774,0
Catalão,520510,GO,Centro-Oeste,FIOCRUZ/ASTRAZENECA,26356,24934,1422
Catalão,520510,GO,Centro-Oeste,BUTANTAN/SINOVAC,13450,7492,5958
Catalão,520510,GO,Centro-Oeste,PFIZER/BIONTECH,2817,2812,5
Catanduva,351110,SP,Sudeste,BUTANTAN/SINOVAC,33298,18176,15122
Catanduva,351110,SP,Sudeste,FIOCRUZ/ASTRAZENECA,29826,26382,3444
Catanduva,351110,SP,Sudeste,PFIZER/BIONTECH,1087,1083,4
Catanduvas,410500,PR,Sul,FIOCRUZ/ASTRAZENECA,2225,2107,118
Catanduvas,410500,PR,Sul,BUTANTAN/SINOVAC,1796,947,849
Catanduvas,420400,SC,Sul,FIOCRUZ/ASTRAZENECA,2697,2544,153
Catanduvas,420400,SC,Sul,BUTANTAN/SINOVAC,1935,989,946
Catanduvas,420400,SC,Sul,PFIZER/BIONTECH,132,132,0
Catarina,230360,CE,Nordeste,BUTANTAN/SINOVAC,3501,1872,1629
Catarina,230360,CE,Nordeste,FIOCRUZ/ASTRAZENECA,1170,944,226
Catarina,230360,CE,Nordeste,PFIZER/BIONTECH,2,2,0
Catas Altas,311535,MG,Sudeste,FIOCRUZ/ASTRAZENECA,1501,1344,157
Catas Altas,311535,MG,Sudeste,BUTANTAN/SINOVAC,1214,627,587
Catas Altas,311535,MG,Sudeste,PFIZER/BIONTECH,49,49,0
Catas Altas Da Noruega,311540,MG,Sudeste,FIOCRUZ/ASTRAZENECA,845,661,184
Catas Altas Da Noruega,311540,MG,Sudeste,BUTANTAN/SINOVAC,824,452,372
Catas Altas Da Noruega,311540,MG,Sudeste,PFIZER/BIONTECH,7,7,0
Catende,260420,PE,Nordeste,BUTANTAN/SINOVAC,5174,2740,2434
Catende,260420,PE,Nordeste,FIOCRUZ/ASTRAZENECA,3915,3610,305
Catende,260420,PE,Nordeste,PFIZER/BIONTECH,294,291,3
Catiguá,351120,SP,Sudeste,FIOCRUZ/ASTRAZENECA,1893,1746,147
Catiguá,351120,SP,Sudeste,BUTANTAN/SINOVAC,1750,938,812
Catiguá,351120,SP,Sudeste,PFIZER/BIONTECH,181,181,0
Catingueira,250420,PB,Nordeste,BUTANTAN/SINOVAC,1084,560,524
Catingueira,250420,PB,Nordeste,FIOCRUZ/ASTRAZENECA,821,760,61
Catingueira,250420,PB,Nordeste,PFIZER/BIONTECH,111,111,0
Catolândia,290740,BA,Nordeste,FIOCRUZ/ASTRAZENECA,1491,1242,249
Catolândia,290740,BA,Nordeste,BUTANTAN/SINOVAC,1447,808,639
Catolândia,290740,BA,Nordeste,PFIZER/BIONTECH,34,34,0
Catolé Do Rocha,250430,PB,Nordeste,BUTANTAN/SINOVAC,6823,3427,3396
Catolé Do Rocha,250430,PB,Nordeste,FIOCRUZ/ASTRAZENECA,5260,4800,460
Catolé Do Rocha,250430,PB,Nordeste,PFIZER/BIONTECH,149,149,0
Catu,290750,BA,Nordeste,FIOCRUZ/ASTRAZENECA,8988,8375,613
Catu,290750,BA,Nordeste,BUTANTAN/SINOVAC,8383,4216,4167
Catu,290750,BA,Nordeste,PFIZER/BIONTECH,808,808,0
Catuípe,430500,RS,Sul,BUTANTAN/SINOVAC,2949,1521,1428
Catuípe,430500,RS,Sul,FIOCRUZ/ASTRAZENECA,2654,2301,353
Catuípe,430500,RS,Sul,PFIZER/BIONTECH,346,346,0
Catuji,311545,MG,Sudeste,BUTANTAN/SINOVAC,987,498,489
Catuji,311545,MG,Sudeste,FIOCRUZ/ASTRAZENECA,778,773,5
Catunda,230365,CE,Nordeste,BUTANTAN/SINOVAC,2149,1077,1072
Catunda,230365,CE,Nordeste,FIOCRUZ/ASTRAZENECA,1936,1702,234
Caturaí,520520,GO,Centro-Oeste,FIOCRUZ/ASTRAZENECA,1301,1236,65
Caturaí,520520,GO,Centro-Oeste,BUTANTAN/SINOVAC,1153,675,478
Caturaí,520520,GO,Centro-Oeste,PFIZER/BIONTECH,71,71,0
Caturama,290755,BA,Nordeste,FIOCRUZ/ASTRAZENECA,3866,3536,330
Caturama,290755,BA,Nordeste,BUTANTAN/SINOVAC,2638,1342,1296
Caturama,290755,BA,Nordeste,PFIZER/BIONTECH,30,30,0
Caturité,250435,PB,Nordeste,BUTANTAN/SINOVAC,1171,590,581
Caturité,250435,PB,Nordeste,FIOCRUZ/ASTRAZENECA,653,613,40
Caturité,250435,PB,Nordeste,PFIZER/BIONTECH,34,34,0
Catuti,311547,MG,Sudeste,FIOCRUZ/ASTRAZENECA,1140,1087,53
Catuti,311547,MG,Sudeste,BUTANTAN/SINOVAC,1027,530,497
Catuti,311547,MG,Sudeste,PFIZER/BIONTECH,35,35,0
Caucaia,230370,CE,Nordeste,BUTANTAN/SINOVAC,50930,29370,21560
Caucaia,230370,CE,Nordeste,FIOCRUZ/ASTRAZENECA,11710,10709,1001
Cavalcante,520530,GO,Centro-Oeste,BUTANTAN/SINOVAC,5794,2987,2807
Cavalcante,520530,GO,Centro-Oeste,FIOCRUZ/ASTRAZENECA,2886,2668,218
Caxambu,311550,MG,Sudeste,BUTANTAN/SINOVAC,5491,2774,2717
Caxambu,311550,MG,Sudeste,FIOCRUZ/ASTRAZENECA,5171,4644,527
Caxambu,311550,MG,Sudeste,PFIZER/BIONTECH,44,44,0
Caxambu Do Sul,420410,SC,Sul,BUTANTAN/SINOVAC,1226,639,587
Caxambu Do Sul,420410,SC,Sul,FIOCRUZ/ASTRAZENECA,1186,1090,96
Caxambu Do Sul,420410,SC,Sul,PFIZER/BIONTECH,70,70,0
Caxias,210300,MA,Nordeste,FIOCRUZ/ASTRAZENECA,40266,37962,2304
Caxias,210300,MA,Nordeste,BUTANTAN/SINOVAC,29289,16026,13263
Caxias,210300,MA,Nordeste,PFIZER/BIONTECH,3790,3787,3
Caxias Do Sul,430510,RS,Sul,FIOCRUZ/ASTRAZENECA,123105,111878,11227
Caxias Do Sul,430510,RS,Sul,BUTANTAN/SINOVAC,103705,52718,50987
Caxias Do Sul,430510,RS,Sul,PFIZER/BIONTECH,10309,10293,16
Caxingó,220265,PI,Nordeste,BUTANTAN/SINOVAC,619,341,278
Caxingó,220265,PI,Nordeste,FIOCRUZ/ASTRAZENECA,519,494,25
Ceará-Mirim,240260,RN,Nordeste,FIOCRUZ/ASTRAZENECA,13674,12623,1051
Ceará-Mirim,240260,RN,Nordeste,BUTANTAN/SINOVAC,10866,5557,5309
Ceará-Mirim,240260,RN,Nordeste,PFIZER/BIONTECH,957,956,1
Cedral,210310,MA,Nordeste,FIOCRUZ/ASTRAZENECA,4267,3709,558
Cedral,210310,MA,Nordeste,BUTANTAN/SINOVAC,1528,830,698
Cedral,351130,SP,Sudeste,BUTANTAN/SINOVAC,2925,1617,1308
Cedral,351130,SP,Sudeste,FIOCRUZ/ASTRAZENECA,2736,2383,353
Cedral,351130,SP,Sudeste,PFIZER/BIONTECH,106,106,0
Cedro,230380,CE,Nordeste,BUTANTAN/SINOVAC,5588,3016,2572
Cedro,230380,CE,Nordeste,FIOCRUZ/ASTRAZENECA,2680,2207,473
Cedro,230380,CE,Nordeste,PFIZER/BIONTECH,1,1,0
Cedro,260430,PE,Nordeste,FIOCRUZ/ASTRAZENECA,2098,1892,206
Cedro,260430,PE,Nordeste,BUTANTAN/SINOVAC,1998,1014,984
Cedro,260430,PE,Nordeste,PFIZER/BIONTECH,311,311,0
Cedro De São João,280160,SE,Nordeste,BUTANTAN/SINOVAC,1461,758,703
Cedro De São João,280160,SE,Nordeste,FIOCRUZ/ASTRAZENECA,1124,1110,14
Cedro De São João,280160,SE,Nordeste,PFIZER/BIONTECH,153,153,0
Cedro Do Abaeté,311560,MG,Sudeste,BUTANTAN/SINOVAC,455,236,219
Cedro Do Abaeté,311560,MG,Sudeste,FIOCRUZ/ASTRAZENECA,384,344,40
Cedro Do Abaeté,311560,MG,Sudeste,PFIZER/BIONTECH,30,30,0
Celso Ramos,420415,SC,Sul,BUTANTAN/SINOVAC,776,400,376
Celso Ramos,420415,SC,Sul,FIOCRUZ/ASTRAZENECA,755,725,30
Celso Ramos,420415,SC,Sul,PFIZER/BIONTECH,66,66,0
Centenário,170410,TO,Norte,BUTANTAN/SINOVAC,513,268,245
Centenário,170410,TO,Norte,FIOCRUZ/ASTRAZENECA,399,367,32
Centenário,430511,RS,Sul,BUTANTAN/SINOVAC,1090,542,548
Centenário,430511,RS,Sul,FIOCRUZ/ASTRAZENECA,979,896,83
Centenário,430511,RS,Sul,PFIZER/BIONTECH,31,31,0
Centenário Do Sul,410510,PR,Sul,FIOCRUZ/ASTRAZENECA,3213,3018,195
Centenário Do Sul,410510,PR,Sul,BUTANTAN/SINOVAC,2430,1272,1158
Central,290760,BA,Nordeste,FIOCRUZ/ASTRAZENECA,5749,4864,885
Central,290760,BA,Nordeste,BUTANTAN/SINOVAC,3592,1838,1754
Central,290760,BA,Nordeste,PFIZER/BIONTECH,165,162,3
Central De Minas,311570,MG,Sudeste,BUTANTAN/SINOVAC,1396,819,577
Central De Minas,311570,MG,Sudeste,FIOCRUZ/ASTRAZENECA,943,853,90
Central De Minas,311570,MG,Sudeste,PFIZER/BIONTECH,31,30,1
Central Do Maranhão,210312,MA,Nordeste,FIOCRUZ/ASTRAZENECA,2119,2024,95
Central Do Maranhão,210312,MA,Nordeste,BUTANTAN/SINOVAC,1138,590,548
Centralina,311580,MG,Sudeste,BUTANTAN/SINOVAC,2207,1113,1094
Centralina,311580,MG,Sudeste,FIOCRUZ/ASTRAZENECA,1710,1539,171
Centralina,311580,MG,Sudeste,PFIZER/BIONTECH,158,158,0
Centro Do Guilherme,210315,MA,Nordeste,FIOCRUZ/ASTRAZENECA,1483,1422,61
Centro Do Guilherme,210315,MA,Nordeste,BUTANTAN/SINOVAC,1274,752,522
Centro Novo Do Maranhão,210317,MA,Nordeste,FIOCRUZ/ASTRAZENECA,2820,2677,143
Centro Novo Do Maranhão,210317,MA,Nordeste,BUTANTAN/SINOVAC,2075,1091,984
Cerejeiras,110005,RO,Norte,BUTANTAN/SINOVAC,3291,1689,1602
Cerejeiras,110005,RO,Norte,FIOCRUZ/ASTRAZENECA,2999,2853,146
Cerejeiras,110005,RO,Norte,PFIZER/BIONTECH,335,334,1
Ceres,520540,GO,Centro-Oeste,FIOCRUZ/ASTRAZENECA,4449,4339,110
Ceres,520540,GO,Centro-Oeste,BUTANTAN/SINOVAC,3390,2269,1121
Ceres,520540,GO,Centro-Oeste,PFIZER/BIONTECH,1010,1010,0
Cerqueira César,351140,SP,Sudeste,BUTANTAN/SINOVAC,4909,2481,2428
Cerqueira César,351140,SP,Sudeste,FIOCRUZ/ASTRAZENECA,4348,4068,280
Cerqueira César,351140,SP,Sudeste,PFIZER/BIONTECH,586,586,0
Cerquilho,351150,SP,Sudeste,FIOCRUZ/ASTRAZENECA,11621,10757,864
Cerquilho,351150,SP,Sudeste,BUTANTAN/SINOVAC,7961,4365,3596
Cerquilho,351150,SP,Sudeste,PFIZER/BIONTECH,294,294,0
Cerrito,430512,RS,Sul,BUTANTAN/SINOVAC,2163,1106,1057
Cerrito,430512,RS,Sul,FIOCRUZ/ASTRAZENECA,1816,1524,292
Cerrito,430512,RS,Sul,PFIZER/BIONTECH,100,100,0
Cerro Azul,410520,PR,Sul,FIOCRUZ/ASTRAZENECA,3756,3619,137
Cerro Azul,410520,PR,Sul,BUTANTAN/SINOVAC,3064,1590,1474
Cerro Branco,430513,RS,Sul,BUTANTAN/SINOVAC,1430,718,712
Cerro Branco,430513,RS,Sul,FIOCRUZ/ASTRAZENECA,929,828,101
Cerro Branco,430513,RS,Sul,PFIZER/BIONTECH,117,117,0
Cerro Corá,240270,RN,Nordeste,BUTANTAN/SINOVAC,2147,1059,1088
Cerro Corá,240270,RN,Nordeste,FIOCRUZ/ASTRAZENECA,2084,1905,179
Cerro Corá,240270,RN,Nordeste,PFIZER/BIONTECH,200,198,2
Cerro Grande,430515,RS,Sul,BUTANTAN/SINOVAC,702,371,331
Cerro Grande,430515,RS,Sul,FIOCRUZ/ASTRAZENECA,646,597,49
Cerro Grande,430515,RS,Sul,PFIZER/BIONTECH,87,87,0
Cerro Grande Do Sul,430517,RS,Sul,FIOCRUZ/ASTRAZENECA,2438,2304,134
Cerro Grande Do Sul,430517,RS,Sul,BUTANTAN/SINOVAC,2211,1113,1098
Cerro Grande Do Sul,430517,RS,Sul,PFIZER/BIONTECH,167,167,0
Cerro Largo,430520,RS,Sul,BUTANTAN/SINOVAC,4105,2103,2002
Cerro Largo,430520,RS,Sul,FIOCRUZ/ASTRAZENECA,3483,3039,444
Cerro Largo,430520,RS,Sul,PFIZER/BIONTECH,599,597,2
Cerro Negro,420417,SC,Sul,FIOCRUZ/ASTRAZENECA,1179,1113,66
Cerro Negro,420417,SC,Sul,BUTANTAN/SINOVAC,982,550,432
Cesário Lange,351160,SP,Sudeste,FIOCRUZ/ASTRAZENECA,3853,3615,238
Cesário Lange,351160,SP,Sudeste,BUTANTAN/SINOVAC,3391,1788,1603
Cesário Lange,351160,SP,Sudeste,PFIZER/BIONTECH,275,275,0
Céu Azul,410530,PR,Sul,FIOCRUZ/ASTRAZENECA,2611,2470,141
Céu Azul,410530,PR,Sul,BUTANTAN/SINOVAC,2401,1265,1136
Céu Azul,410530,PR,Sul,PFIZER/BIONTECH,159,159,0
Cezarina,520545,GO,Centro-Oeste,FIOCRUZ/ASTRAZENECA,1399,1316,83
Cezarina,520545,GO,Centro-Oeste,BUTANTAN/SINOVAC,1229,684,545
Chã De Alegria,260440,PE,Nordeste,BUTANTAN/SINOVAC,2525,1336,1189
Chã De Alegria,260440,PE,Nordeste,FIOCRUZ/ASTRAZENECA,2052,1842,210
Chã De Alegria,260440,PE,Nordeste,PFIZER/BIONTECH,99,99,0
Chã Grande,260450,PE,Nordeste,FIOCRUZ/ASTRAZENECA,4369,4046,323
Chã Grande,260450,PE,Nordeste,BUTANTAN/SINOVAC,3474,1778,1696
Chã Grande,260450,PE,Nordeste,PFIZER/BIONTECH,370,370,0
Chã Preta,270190,AL,Nordeste,FIOCRUZ/ASTRAZENECA,1194,1034,160
Chã Preta,270190,AL,Nordeste,BUTANTAN/SINOVAC,1122,559,563
Chã Preta,270190,AL,Nordeste,PFIZER/BIONTECH,80,80,0
Chácara,311590,MG,Sudeste,FIOCRUZ/ASTRAZENECA,1404,1316,88
Chácara,311590,MG,Sudeste,BUTANTAN/SINOVAC,849,441,408
Chácara,311590,MG,Sudeste,PFIZER/BIONTECH,67,67,0
Chalé,311600,MG,Sudeste,FIOCRUZ/ASTRAZENECA,1678,1419,259
Chalé,311600,MG,Sudeste,BUTANTAN/SINOVAC,1293,654,639
Chalé,311600,MG,Sudeste,PFIZER/BIONTECH,84,84,0
Chapada,430530,RS,Sul,BUTANTAN/SINOVAC,3015,1519,1496
Chapada,430530,RS,Sul,FIOCRUZ/ASTRAZENECA,2531,2294,237
Chapada,430530,RS,Sul,PFIZER/BIONTECH,367,367,0
Chapada Da Natividade,170510,TO,Norte,BUTANTAN/SINOVAC,691,362,329
Chapada Da Natividade,170510,TO,Norte,FIOCRUZ/ASTRAZENECA,668,633,35
Chapada De Areia,170460,TO,Norte,BUTANTAN/SINOVAC,400,211,189
Chapada De Areia,170460,TO,Norte,FIOCRUZ/ASTRAZENECA,288,268,20
Chapada Do Norte,311610,MG,Sudeste,FIOCRUZ/ASTRAZENECA,3558,3385,173
Chapada Do Norte,311610,MG,Sudeste,BUTANTAN/SINOVAC,2083,1056,1027
Chapada Do Norte,311610,MG,Sudeste,PFIZER/BIONTECH,160,160,0
Chapada Dos Guimarães,510300,MT,Centro-Oeste,BUTANTAN/SINOVAC,4561,2340,2221
Chapada Dos Guimarães,510300,MT,Centro-Oeste,FIOCRUZ/ASTRAZENECA,3883,3696,187
Chapada Dos Guimarães,510300,MT,Centro-Oeste,PFIZER/BIONTECH,67,67,0
Chapada Gaúcha,311615,MG,Sudeste,BUTANTAN/SINOVAC,2635,1344,1291
Chapada Gaúcha,311615,MG,Sudeste,FIOCRUZ/ASTRAZENECA,1428,1279,149
Chapada Gaúcha,311615,MG,Sudeste,PFIZER/BIONTECH,28,28,0
Chapadão Do Céu,520547,GO,Centro-Oeste,FIOCRUZ/ASTRAZENECA,1594,1512,82
Chapadão Do Céu,520547,GO,Centro-Oeste,BUTANTAN/SINOVAC,875,450,425
Chapadão Do Céu,520547,GO,Centro-Oeste,PFIZER/BIONTECH,55,55,0
Chapadão Do Lageado,420419,SC,Sul,FIOCRUZ/ASTRAZENECA,673,633,40
Chapadão Do Lageado,420419,SC,Sul,BUTANTAN/SINOVAC,560,284,276
Chapadão Do Lageado,420419,SC,Sul,PFIZER/BIONTECH,61,61,0
Chapadão Do Sul,500295,MS,Centro-Oeste,FIOCRUZ/ASTRAZENECA,4816,4508,308
Chapadão Do Sul,500295,MS,Centro-Oeste,BUTANTAN/SINOVAC,3128,1588,1540
Chapadão Do Sul,500295,MS,Centro-Oeste,PFIZER/BIONTECH,741,741,0
Chapadinha,210320,MA,Nordeste,FIOCRUZ/ASTRAZENECA,12744,12147,597
Chapadinha,210320,MA,Nordeste,BUTANTAN/SINOVAC,8790,4554,4236
Chapadinha,210320,MA,Nordeste,PFIZER/BIONTECH,629,629,0
Chapecó,420420,SC,Sul,FIOCRUZ/ASTRAZENECA,57872,53383,4489
Chapecó,420420,SC,Sul,BUTANTAN/SINOVAC,46329,24472,21857
Chapecó,420420,SC,Sul,PFIZER/BIONTECH,5893,5888,5
Charqueada,351170,SP,Sudeste,FIOCRUZ/ASTRAZENECA,3425,3237,188
Charqueada,351170,SP,Sudeste,BUTANTAN/SINOVAC,3076,1623,1453
Charqueada,351170,SP,Sudeste,PFIZER/BIONTECH,136,136,0
Charqueadas,430535,RS,Sul,BUTANTAN/SINOVAC,9277,4778,4499
Charqueadas,430535,RS,Sul,FIOCRUZ/ASTRAZENECA,8383,7645,738
Charqueadas,430535,RS,Sul,PFIZER/BIONTECH,533,533,0
Charrua,430537,RS,Sul,BUTANTAN/SINOVAC,2501,1243,1258
Charrua,430537,RS,Sul,FIOCRUZ/ASTRAZENECA,685,587,98
Charrua,430537,RS,Sul,PFIZER/BIONTECH,90,90,0
Chaval,230390,CE,Nordeste,BUTANTAN/SINOVAC,2129,1160,969
Chaval,230390,CE,Nordeste,FIOCRUZ/ASTRAZENECA,888,742,146
Chaval,230390,CE,Nordeste,PFIZER/BIONTECH,10,10,0
Chavantes,355720,SP,Sudeste,BUTANTAN/SINOVAC,2627,1300,1327
Chavantes,355720,SP,Sudeste,FIOCRUZ/ASTRAZENECA,1923,1830,93
Chavantes,355720,SP,Sudeste,PFIZER/BIONTECH,20,20,0
Chaves,150250,PA,Norte,FIOCRUZ/ASTRAZENECA,3295,3178,117
Chaves,150250,PA,Norte,BUTANTAN/SINOVAC,824,442,382
Chiador,311620,MG,Sudeste,BUTANTAN/SINOVAC,818,413,405
Chiador,311620,MG,Sudeste,FIOCRUZ/ASTRAZENECA,707,630,77
Chiapetta,430540,RS,Sul,BUTANTAN/SINOVAC,1274,651,623
Chiapetta,430540,RS,Sul,FIOCRUZ/ASTRAZENECA,1119,967,152
Chiapetta,430540,RS,Sul,PFIZER/BIONTECH,166,166,0
Chopinzinho,410540,PR,Sul,BUTANTAN/SINOVAC,4895,2503,2392
Chopinzinho,410540,PR,Sul,FIOCRUZ/ASTRAZENECA,4536,4188,348
Chopinzinho,410540,PR,Sul,PFIZER/BIONTECH,77,77,0
Choró,230393,CE,Nordeste,BUTANTAN/SINOVAC,2088,1157,931
Choró,230393,CE,Nordeste,FIOCRUZ/ASTRAZENECA,436,417,19
Chorozinho,230395,CE,Nordeste,BUTANTAN/SINOVAC,2717,1471,1246
Chorozinho,230395,CE,Nordeste,FIOCRUZ/ASTRAZENECA,1083,896,187
Chorrochó,290770,BA,Nordeste,FIOCRUZ/ASTRAZENECA,1778,1551,227
Chorrochó,290770,BA,Nordeste,BUTANTAN/SINOVAC,1724,955,769
Chorrochó,290770,BA,Nordeste,PFIZER/BIONTECH,239,239,0
Chuí,430543,RS,Sul,BUTANTAN/SINOVAC,1335,695,640
Chuí,430543,RS,Sul,FIOCRUZ/ASTRAZENECA,504,419,85
Chuí,430543,RS,Sul,PFIZER/BIONTECH,53,53,0
Chupinguaia,110092,RO,Norte,BUTANTAN/SINOVAC,1189,641,548
Chupinguaia,110092,RO,Norte,FIOCRUZ/ASTRAZENECA,1173,1062,111
Chuvisca,430544,RS,Sul,BUTANTAN/SINOVAC,1112,687,425
Chuvisca,430544,RS,Sul,FIOCRUZ/ASTRAZENECA,647,589,58
Chuvisca,430544,RS,Sul,PFIZER/BIONTECH,20,20,0
Cianorte,410550,PR,Sul,FIOCRUZ/ASTRAZENECA,19509,18372,1137
Cianorte,410550,PR,Sul,BUTANTAN/SINOVAC,15638,8150,7488
Cianorte,410550,PR,Sul,PFIZER/BIONTECH,2073,2073,0
Cícero Dantas,290780,BA,Nordeste,BUTANTAN/SINOVAC,7266,4026,3240
Cícero Dantas,290780,BA,Nordeste,FIOCRUZ/ASTRAZENECA,6767,6453,314
Cícero Dantas,290780,BA,Nordeste,PFIZER/BIONTECH,587,587,0
Cidade Gaúcha,410560,PR,Sul,FIOCRUZ/ASTRAZENECA,3269,3103,166
Cidade Gaúcha,410560,PR,Sul,BUTANTAN/SINOVAC,2225,1148,1077
Cidade Gaúcha,410560,PR,Sul,PFIZER/BIONTECH,147,147,0
Cidade Ocidental,520549,GO,Centro-Oeste,FIOCRUZ/ASTRAZENECA,11383,10630,753
Cidade Ocidental,520549,GO,Centro-Oeste,BUTANTAN/SINOVAC,10427,5245,5182
Cidade Ocidental,520549,GO,Centro-Oeste,PFIZER/BIONTECH,3,1,2
Cidelândia,210325,MA,Nordeste,FIOCRUZ/ASTRAZENECA,2218,2084,134
Cidelândia,210325,MA,Nordeste,BUTANTAN/SINOVAC,1936,992,944
Cidreira,430545,RS,Sul,BUTANTAN/SINOVAC,5871,3155,2716
Cidreira,430545,RS,Sul,FIOCRUZ/ASTRAZENECA,5198,4863,335
Cidreira,430545,RS,Sul,PFIZER/BIONTECH,561,559,2
Cipó,290790,BA,Nordeste,FIOCRUZ/ASTRAZENECA,4610,3993,617
Cipó,290790,BA,Nordeste,BUTANTAN/SINOVAC,4077,2320,1757
Cipó,290790,BA,Nordeste,PFIZER/BIONTECH,350,349,1
Cipotânea,311630,MG,Sudeste,BUTANTAN/SINOVAC,1737,868,869
Cipotânea,311630,MG,Sudeste,FIOCRUZ/ASTRAZENECA,1483,1338,145
Cipotânea,311630,MG,Sudeste,PFIZER/BIONTECH,6,6,0
Ciríaco,430550,RS,Sul,BUTANTAN/SINOVAC,1481,805,676
Ciríaco,430550,RS,Sul,FIOCRUZ/ASTRAZENECA,1171,1062,109
Ciríaco,430550,RS,Sul,PFIZER/BIONTECH,161,161,0
Claraval,311640,MG,Sudeste,BUTANTAN/SINOVAC,965,493,472
Claraval,311640,MG,Sudeste,FIOCRUZ/ASTRAZENECA,665,661,4
Claraval,311640,MG,Sudeste,PFIZER/BIONTECH,39,39,0
Claro Dos Poções,311650,MG,Sudeste,BUTANTAN/SINOVAC,1802,917,885
Claro Dos Poções,311650,MG,Sudeste,FIOCRUZ/ASTRAZENECA,1742,1632,110
Claro Dos Poções,311650,MG,Sudeste,PFIZER/BIONTECH,123,123,0
Cláudia,510305,MT,Centro-Oeste,FIOCRUZ/ASTRAZENECA,2157,2065,92
Cláudia,510305,MT,Centro-Oeste,BUTANTAN/SINOVAC,1425,722,703
Cláudia,510305,MT,Centro-Oeste,PFIZER/BIONTECH,8,8,0
Cláudio,311660,MG,Sudeste,FIOCRUZ/ASTRAZENECA,5476,4991,485
Cláudio,311660,MG,Sudeste,BUTANTAN/SINOVAC,4969,2532,2437
Cláudio,311660,MG,Sudeste,PFIZER/BIONTECH,218,217,1
Clementina,351190,SP,Sudeste,FIOCRUZ/ASTRAZENECA,1739,1615,124
Clementina,351190,SP,Sudeste,BUTANTAN/SINOVAC,1616,827,789
Clementina,351190,SP,Sudeste,PFIZER/BIONTECH,143,143,0
Clevelândia,410570,PR,Sul,FIOCRUZ/ASTRAZENECA,3605,3378,227
Clevelândia,410570,PR,Sul,BUTANTAN/SINOVAC,3447,1760,1687
Clevelândia,410570,PR,Sul,PFIZER/BIONTECH,302,302,0
Coaraci,290800,BA,Nordeste,BUTANTAN/SINOVAC,4893,2570,2323
Coaraci,290800,BA,Nordeste,FIOCRUZ/ASTRAZENECA,4595,4217,378
Coaraci,290800,BA,Nordeste,PFIZER/BIONTECH,209,209,0
Coari,130120,AM,Norte,FIOCRUZ/ASTRAZENECA,11441,9342,2099
Coari,130120,AM,Norte,BUTANTAN/SINOVAC,6860,4073,2787
Cocal,220270,PI,Nordeste,BUTANTAN/SINOVAC,3605,1945,1660
Cocal,220270,PI,Nordeste,FIOCRUZ/ASTRAZENECA,2653,2457,196
Cocal De Telha,220271,PI,Nordeste,BUTANTAN/SINOVAC,1077,547,530
Cocal De Telha,220271,PI,Nordeste,FIOCRUZ/ASTRAZENECA,846,766,80
Cocal De Telha,220271,PI,Nordeste,PFIZER/BIONTECH,58,58,0
Cocal Do Sul,420425,SC,Sul,BUTANTAN/SINOVAC,2617,1521,1096
Cocal Do Sul,420425,SC,Sul,FIOCRUZ/ASTRAZENECA,2290,2133,157
Cocal Dos Alves,220272,PI,Nordeste,FIOCRUZ/ASTRAZENECA,1335,1253,82
Cocal Dos Alves,220272,PI,Nordeste,BUTANTAN/SINOVAC,998,522,476
Cocal Dos Alves,220272,PI,Nordeste,PFIZER/BIONTECH,54,54,0
Cocalinho,510310,MT,Centro-Oeste,BUTANTAN/SINOVAC,1100,579,521
Cocalinho,510310,MT,Centro-Oeste,FIOCRUZ/ASTRAZENECA,1027,972,55
Cocalinho,510310,MT,Centro-Oeste,PFIZER/BIONTECH,52,52,0
Cocalzinho De Goiás,520551,GO,Centro-Oeste,FIOCRUZ/ASTRAZENECA,3992,3717,275
Cocalzinho De Goiás,520551,GO,Centro-Oeste,BUTANTAN/SINOVAC,2954,1539,1415
Cocalzinho De Goiás,520551,GO,Centro-Oeste,PFIZER/BIONTECH,161,161,0
Cocos,290810,BA,Nordeste,BUTANTAN/SINOVAC,3837,1974,1863
Cocos,290810,BA,Nordeste,FIOCRUZ/ASTRAZENECA,3543,3230,313
Cocos,290810,BA,Nordeste,PFIZER/BIONTECH,490,490,0
Codajás,130130,AM,Norte,BUTANTAN/SINOVAC,2819,1637,1182
Codajás,130130,AM,Norte,FIOCRUZ/ASTRAZENECA,2040,1551,489
Codó,210330,MA,Nordeste,FIOCRUZ/ASTRAZENECA,25118,23841,1277
Codó,210330,MA,Nordeste,BUTANTAN/SINOVAC,17624,9920,7704
Codó,210330,MA,Nordeste,PFIZER/BIONTECH,341,341,0
Coelho Neto,210340,MA,Nordeste,BUTANTAN/SINOVAC,9323,5403,3920
Coelho Neto,210340,MA,Nordeste,FIOCRUZ/ASTRAZENECA,8447,7934,513
Coimbra,311670,MG,Sudeste,FIOCRUZ/ASTRAZENECA,1625,1502,123
Coimbra,311670,MG,Sudeste,BUTANTAN/SINOVAC,1489,797,692
Coimbra,311670,MG,Sudeste,PFIZER/BIONTECH,150,150,0
Coité Do Nóia,270200,AL,Nordeste,FIOCRUZ/ASTRAZENECA,2189,1919,270
Coité Do Nóia,270200,AL,Nordeste,BUTANTAN/SINOVAC,2024,1048,976
Coivaras,220273,PI,Nordeste,BUTANTAN/SINOVAC,941,488,453
Coivaras,220273,PI,Nordeste,FIOCRUZ/ASTRAZENECA,729,703,26
Colares,150260,PA,Norte,FIOCRUZ/ASTRAZENECA,2071,1531,540
Colares,150260,PA,Norte,BUTANTAN/SINOVAC,1339,805,534
Colatina,320150,ES,Sudeste,BUTANTAN/SINOVAC,30269,16937,13332
Colatina,320150,ES,Sudeste,FIOCRUZ/ASTRAZENECA,29243,26530,2713
Colatina,320150,ES,Sudeste,PFIZER/BIONTECH,1694,1692,2
Colíder,510320,MT,Centro-Oeste,BUTANTAN/SINOVAC,8687,4563,4124
Colíder,510320,MT,Centro-Oeste,FIOCRUZ/ASTRAZENECA,5967,5209,758
Colíder,510320,MT,Centro-Oeste,PFIZER/BIONTECH,13,13,0
Colina,351200,SP,Sudeste,FIOCRUZ/ASTRAZENECA,4597,4004,593
Colina,351200,SP,Sudeste,BUTANTAN/SINOVAC,4206,2278,1928
Colina,351200,SP,Sudeste,PFIZER/BIONTECH,223,223,0
Colinas,210350,MA,Nordeste,FIOCRUZ/ASTRAZENECA,6794,6409,385
Colinas,210350,MA,Nordeste,BUTANTAN/SINOVAC,4980,2738,2242
Colinas,430558,RS,Sul,BUTANTAN/SINOVAC,1005,517,488
Colinas,430558,RS,Sul,FIOCRUZ/ASTRAZENECA,717,614,103
Colinas,430558,RS,Sul,PFIZER/BIONTECH,70,70,0
Colinas Do Sul,520552,GO,Centro-Oeste,FIOCRUZ/ASTRAZENECA,937,864,73
Colinas Do Sul,520552,GO,Centro-Oeste,BUTANTAN/SINOVAC,582,299,283
Colinas Do Sul,520552,GO,Centro-Oeste,PFIZER/BIONTECH,36,36,0
Colinas Do Tocantins,170550,TO,Norte,BUTANTAN/SINOVAC,5707,3146,2561
Colinas Do Tocantins,170550,TO,Norte,FIOCRUZ/ASTRAZENECA,5369,5177,192
Colméia,171670,TO,Norte,BUTANTAN/SINOVAC,1481,758,723
Colméia,171670,TO,Norte,FIOCRUZ/ASTRAZENECA,1263,1202,61
Colniza,510325,MT,Centro-Oeste,BUTANTAN/SINOVAC,3302,1752,1550
Colniza,510325,MT,Centro-Oeste,FIOCRUZ/ASTRAZENECA,1766,1746,20
Colniza,510325,MT,Centro-Oeste,PFIZER/BIONTECH,85,85,0
Colômbia,351210,SP,Sudeste,FIOCRUZ/ASTRAZENECA,1775,1602,173
Colômbia,351210,SP,Sudeste,BUTANTAN/SINOVAC,1554,743,811
Colômbia,351210,SP,Sudeste,PFIZER/BIONTECH,45,45,0
Colombo,410580,PR,Sul,FIOCRUZ/ASTRAZENECA,42602,40501,2101
Colombo,410580,PR,Sul,BUTANTAN/SINOVAC,27832,14600,13232
Colombo,410580,PR,Sul,PFIZER/BIONTECH,7699,7674,25
Colônia Do Gurguéia,220275,PI,Nordeste,FIOCRUZ/ASTRAZENECA,1526,1425,101
Colônia Do Gurguéia,220275,PI,Nordeste,BUTANTAN/SINOVAC,1074,558,516
Colônia Do Gurguéia,220275,PI,Nordeste,PFIZER/BIONTECH,109,109,0
Colônia Do Piauí,220277,PI,Nordeste,BUTANTAN/SINOVAC,1692,854,838
Colônia Do Piauí,220277,PI,Nordeste,FIOCRUZ/ASTRAZENECA,1666,1615,51
Colônia Leopoldina,270210,AL,Nordeste,FIOCRUZ/ASTRAZENECA,2595,2376,219
Colônia Leopoldina,270210,AL,Nordeste,BUTANTAN/SINOVAC,2472,1305,1167
Colorado,410590,PR,Sul,BUTANTAN/SINOVAC,5400,2822,2578
Colorado,410590,PR,Sul,FIOCRUZ/ASTRAZENECA,4380,4089,291
Colorado,430560,RS,Sul,FIOCRUZ/ASTRAZENECA,1300,1205,95
Colorado,430560,RS,Sul,BUTANTAN/SINOVAC,1202,604,598
Colorado,430560,RS,Sul,PFIZER/BIONTECH,126,126,0
Colorado Do Oeste,110006,RO,Norte,BUTANTAN/SINOVAC,3579,1943,1636
Colorado Do Oeste,110006,RO,Norte,FIOCRUZ/ASTRAZENECA,3529,3506,23
Colorado Do Oeste,110006,RO,Norte,PFIZER/BIONTECH,48,48,0
Coluna,311680,MG,Sudeste,FIOCRUZ/ASTRAZENECA,2308,1861,447
Coluna,311680,MG,Sudeste,BUTANTAN/SINOVAC,1827,963,864
Coluna,311680,MG,Sudeste,PFIZER/BIONTECH,55,55,0
Combinado,170555,TO,Norte,BUTANTAN/SINOVAC,864,436,428
Combinado,170555,TO,Norte,FIOCRUZ/ASTRAZENECA,748,711,37
Comendador Gomes,311690,MG,Sudeste,FIOCRUZ/ASTRAZENECA,723,665,58
Comendador Gomes,311690,MG,Sudeste,BUTANTAN/SINOVAC,638,323,315
Comendador Gomes,311690,MG,Sudeste,PFIZER/BIONTECH,13,13,0
Comendador Levy Gasparian,330095,RJ,Sudeste,FIOCRUZ/ASTRAZENECA,1977,1743,234
Comendador Levy Gasparian,330095,RJ,Sudeste,BUTANTAN/SINOVAC,1970,865,1105
Comercinho,311700,MG,Sudeste,BUTANTAN/SINOVAC,1742,898,844
Comercinho,311700,MG,Sudeste,FIOCRUZ/ASTRAZENECA,1471,1320,151
Comercinho,311700,MG,Sudeste,PFIZER/BIONTECH,98,98,0
Comodoro,510330,MT,Centro-Oeste,FIOCRUZ/ASTRAZENECA,3020,2734,286
Comodoro,510330,MT,Centro-Oeste,BUTANTAN/SINOVAC,2966,1541,1425
Comodoro,510330,MT,Centro-Oeste,PFIZER/BIONTECH,192,192,0
Conceição,250440,PB,Nordeste,BUTANTAN/SINOVAC,4455,2273,2182
Conceição,250440,PB,Nordeste,FIOCRUZ/ASTRAZENECA,3822,3489,333
Conceição,250440,PB,Nordeste,PFIZER/BIONTECH,450,450,0
Conceição Da Aparecida,311710,MG,Sudeste,BUTANTAN/SINOVAC,2200,1111,1089
Conceição Da Aparecida,311710,MG,Sudeste,FIOCRUZ/ASTRAZENECA,2184,1984,200
Conceição Da Aparecida,311710,MG,Sudeste,PFIZER/BIONTECH,203,203,0
Conceição Da Barra,320160,ES,Sudeste,FIOCRUZ/ASTRAZENECA,9369,9194,175
Conceição Da Barra,320160,ES,Sudeste,BUTANTAN/SINOVAC,4313,2362,1951
Conceição Da Barra,320160,ES,Sudeste,PFIZER/BIONTECH,161,161,0
Conceição Da Barra De Minas,311520,MG,Sudeste,BUTANTAN/SINOVAC,954,485,469
Conceição Da Barra De Minas,311520,MG,Sudeste,FIOCRUZ/ASTRAZENECA,820,737,83
Conceição Da Barra De Minas,311520,MG,Sudeste,PFIZER/BIONTECH,41,41,0
Conceição Da Feira,290820,BA,Nordeste,FIOCRUZ/ASTRAZENECA,4047,3554,493
Conceição Da Feira,290820,BA,Nordeste,BUTANTAN/SINOVAC,3474,1881,1593
Conceição Da Feira,290820,BA,Nordeste,PFIZER/BIONTECH,809,809,0
Conceição Das Alagoas,311730,MG,Sudeste,FIOCRUZ/ASTRAZENECA,4637,4337,300
Conceição Das Alagoas,311730,MG,Sudeste,BUTANTAN/SINOVAC,3345,1690,1655
Conceição Das Alagoas,311730,MG,Sudeste,PFIZER/BIONTECH,562,561,1
Conceição Das Pedras,311720,MG,Sudeste,BUTANTAN/SINOVAC,830,436,394
Conceição Das Pedras,311720,MG,Sudeste,FIOCRUZ/ASTRAZENECA,586,529,57
Conceição Das Pedras,311720,MG,Sudeste,PFIZER/BIONTECH,78,78,0
Conceição De Ipanema,311740,MG,Sudeste,BUTANTAN/SINOVAC,1021,517,504
Conceição De Ipanema,311740,MG,Sudeste,FIOCRUZ/ASTRAZENECA,830,766,64
Conceição De Ipanema,311740,MG,Sudeste,PFIZER/BIONTECH,24,24,0
Conceição De Macabu,330140,RJ,Sudeste,BUTANTAN/SINOVAC,6160,3246,2914
Conceição De Macabu,330140,RJ,Sudeste,FIOCRUZ/ASTRAZENECA,4709,4125,584
Conceição De Macabu,330140,RJ,Sudeste,PFIZER/BIONTECH,1156,1156,0
Conceição Do Almeida,290830,BA,Nordeste,BUTANTAN/SINOVAC,3639,1905,1734
Conceição Do Almeida,290830,BA,Nordeste,FIOCRUZ/ASTRAZENECA,3498,3132,366
Conceição Do Almeida,290830,BA,Nordeste,PFIZER/BIONTECH,447,447,0
Conceição Do Araguaia,150270,PA,Norte,FIOCRUZ/ASTRAZENECA,9872,7692,2180
Conceição Do Araguaia,150270,PA,Norte,BUTANTAN/SINOVAC,6305,3356,2949
Conceição Do Araguaia,150270,PA,Norte,PFIZER/BIONTECH,33,33,0
Conceição Do Canindé,220280,PI,Nordeste,BUTANTAN/SINOVAC,968,492,476
Conceição Do Canindé,220280,PI,Nordeste,FIOCRUZ/ASTRAZENECA,869,794,75
Conceição Do Castelo,320170,ES,Sudeste,BUTANTAN/SINOVAC,3786,2064,1722
Conceição Do Castelo,320170,ES,Sudeste,FIOCRUZ/ASTRAZENECA,2362,2253,109
Conceição Do Castelo,320170,ES,Sudeste,PFIZER/BIONTECH,19,19,0
Conceição Do Coité,290840,BA,Nordeste,BUTANTAN/SINOVAC,11299,6116,5183
Conceição Do Coité,290840,BA,Nordeste,FIOCRUZ/ASTRAZENECA,10501,9202,1299
Conceição Do Coité,290840,BA,Nordeste,PFIZER/BIONTECH,864,863,1
Conceição Do Jacuípe,290850,BA,Nordeste,FIOCRUZ/ASTRAZENECA,5942,5226,716
Conceição Do Jacuípe,290850,BA,Nordeste,BUTANTAN/SINOVAC,5560,3011,2549
Conceição Do Jacuípe,290850,BA,Nordeste,PFIZER/BIONTECH,753,752,1
Conceição Do Lago-Açu,210355,MA,Nordeste,FIOCRUZ/ASTRAZENECA,2457,2322,135
Conceição Do Lago-Açu,210355,MA,Nordeste,BUTANTAN/SINOVAC,1574,818,756
Conceição Do Mato Dentro,311750,MG,Sudeste,FIOCRUZ/ASTRAZENECA,3745,3381,364
Conceição Do Mato Dentro,311750,MG,Sudeste,BUTANTAN/SINOVAC,3684,1919,1765
Conceição Do Mato Dentro,311750,MG,Sudeste,PFIZER/BIONTECH,149,149,0
Conceição Do Pará,311760,MG,Sudeste,BUTANTAN/SINOVAC,1313,668,645
Conceição Do Pará,311760,MG,Sudeste,FIOCRUZ/ASTRAZENECA,1025,992,33
Conceição Do Rio Verde,311770,MG,Sudeste,BUTANTAN/SINOVAC,2764,1462,1302
Conceição Do Rio Verde,311770,MG,Sudeste,FIOCRUZ/ASTRAZENECA,2192,2181,11
Conceição Do Rio Verde,311770,MG,Sudeste,PFIZER/BIONTECH,117,117,0
Conceição Do Tocantins,170560,TO,Norte,BUTANTAN/SINOVAC,893,454,439
Conceição Do Tocantins,170560,TO,Norte,FIOCRUZ/ASTRAZENECA,747,696,51
Conceição Dos Ouros,311780,MG,Sudeste,BUTANTAN/SINOVAC,1981,1019,962
Conceição Dos Ouros,311780,MG,Sudeste,FIOCRUZ/ASTRAZENECA,1626,1457,169
Conceição Dos Ouros,311780,MG,Sudeste,PFIZER/BIONTECH,41,41,0
Conchal,351220,SP,Sudeste,BUTANTAN/SINOVAC,6058,3469,2589
Conchal,351220,SP,Sudeste,FIOCRUZ/ASTRAZENECA,6020,5535,485
Conchal,351220,SP,Sudeste,PFIZER/BIONTECH,585,584,1
Conchas,351230,SP,Sudeste,FIOCRUZ/ASTRAZENECA,4050,3727,323
Conchas,351230,SP,Sudeste,BUTANTAN/SINOVAC,3922,2106,1816
Conchas,351230,SP,Sudeste,PFIZER/BIONTECH,340,337,3
Concórdia,420430,SC,Sul,FIOCRUZ/ASTRAZENECA,17739,16511,1228
Concórdia,420430,SC,Sul,BUTANTAN/SINOVAC,15456,7960,7496
Concórdia,420430,SC,Sul,PFIZER/BIONTECH,1919,1919,0
Concórdia Do Pará,150275,PA,Norte,FIOCRUZ/ASTRAZENECA,10242,9128,1114
Concórdia Do Pará,150275,PA,Norte,BUTANTAN/SINOVAC,2464,1299,1165
Condado,250450,PB,Nordeste,BUTANTAN/SINOVAC,1928,988,940
Condado,250450,PB,Nordeste,FIOCRUZ/ASTRAZENECA,1583,1431,152
Condado,250450,PB,Nordeste,PFIZER/BIONTECH,221,221,0
Condado,260460,PE,Nordeste,FIOCRUZ/ASTRAZENECA,3916,3659,257
Condado,260460,PE,Nordeste,BUTANTAN/SINOVAC,3228,1762,1466
Condado,260460,PE,Nordeste,PFIZER/BIONTECH,164,164,0
Conde,250460,PB,Nordeste,FIOCRUZ/ASTRAZENECA,5067,4828,239
Conde,250460,PB,Nordeste,BUTANTAN/SINOVAC,3360,1801,1559
Conde,250460,PB,Nordeste,PFIZER/BIONTECH,135,135,0
Conde,290860,BA,Nordeste,BUTANTAN/SINOVAC,3793,2095,1698
Conde,290860,BA,Nordeste,FIOCRUZ/ASTRAZENECA,3571,3353,218
Conde,290860,BA,Nordeste,PFIZER/BIONTECH,763,763,0
Condeúba,290870,BA,Nordeste,BUTANTAN/SINOVAC,4530,2324,2206
Condeúba,290870,BA,Nordeste,FIOCRUZ/ASTRAZENECA,3579,3145,434
Condeúba,290870,BA,Nordeste,PFIZER/BIONTECH,179,179,0
Condor,430570,RS,Sul,BUTANTAN/SINOVAC,1798,908,890
Condor,430570,RS,Sul,FIOCRUZ/ASTRAZENECA,1607,1466,141
Condor,430570,RS,Sul,PFIZER/BIONTECH,122,122,0
Cônego Marinho,311783,MG,Sudeste,BUTANTAN/SINOVAC,1718,885,833
Cônego Marinho,311783,MG,Sudeste,FIOCRUZ/ASTRAZENECA,1143,967,176
Cônego Marinho,311783,MG,Sudeste,PFIZER/BIONTECH,53,53,0
Confins,311787,MG,Sudeste,FIOCRUZ/ASTRAZENECA,5204,5032,172
Confins,311787,MG,Sudeste,BUTANTAN/SINOVAC,1481,761,720
Confins,311787,MG,Sudeste,PFIZER/BIONTECH,922,922,0
Confresa,510335,MT,Centro-Oeste,BUTANTAN/SINOVAC,3636,2040,1596
Confresa,510335,MT,Centro-Oeste,FIOCRUZ/ASTRAZENECA,2841,2694,147
Confresa,510335,MT,Centro-Oeste,PFIZER/BIONTECH,89,89,0
Congo,250470,PB,Nordeste,BUTANTAN/SINOVAC,1366,688,678
Congo,250470,PB,Nordeste,FIOCRUZ/ASTRAZENECA,838,757,81
Congo,250470,PB,Nordeste,PFIZER/BIONTECH,50,50,0
Congonhal,311790,MG,Sudeste,BUTANTAN/SINOVAC,2738,1415,1323
Congonhal,311790,MG,Sudeste,FIOCRUZ/ASTRAZENECA,2562,2383,179
Congonhal,311790,MG,Sudeste,PFIZER/BIONTECH,95,95,0
Congonhas,311800,MG,Sudeste,FIOCRUZ/ASTRAZENECA,11155,9489,1666
Congonhas,311800,MG,Sudeste,BUTANTAN/SINOVAC,9755,4977,4778
Congonhas,311800,MG,Sudeste,PFIZER/BIONTECH,1883,1883,0
Congonhas Do Norte,311810,MG,Sudeste,BUTANTAN/SINOVAC,1146,575,571
Congonhas Do Norte,311810,MG,Sudeste,FIOCRUZ/ASTRAZENECA,747,648,99
Congonhas Do Norte,311810,MG,Sudeste,PFIZER/BIONTECH,48,48,0
Congonhinhas,410600,PR,Sul,BUTANTAN/SINOVAC,2099,1081,1018
Congonhinhas,410600,PR,Sul,FIOCRUZ/ASTRAZENECA,1928,1804,124
Conquista,311820,MG,Sudeste,FIOCRUZ/ASTRAZENECA,2278,2118,160
Conquista,311820,MG,Sudeste,BUTANTAN/SINOVAC,1659,844,815
Conquista,311820,MG,Sudeste,PFIZER/BIONTECH,148,148,0
Conquista D'Oeste,510336,MT,Centro-Oeste,FIOCRUZ/ASTRAZENECA,720,685,35
Conquista D'Oeste,510336,MT,Centro-Oeste,BUTANTAN/SINOVAC,687,352,335
Conquista D'Oeste,510336,MT,Centro-Oeste,PFIZER/BIONTECH,32,32,0
Conselheiro Lafaiete,311830,MG,Sudeste,BUTANTAN/SINOVAC,21190,11135,10055
Conselheiro Lafaiete,311830,MG,Sudeste,FIOCRUZ/ASTRAZENECA,18063,15740,2323
Conselheiro Lafaiete,311830,MG,Sudeste,PFIZER/BIONTECH,836,836,0
Conselheiro Mairinck,410610,PR,Sul,FIOCRUZ/ASTRAZENECA,1051,992,59
Conselheiro Mairinck,410610,PR,Sul,BUTANTAN/SINOVAC,869,449,420
Conselheiro Pena,311840,MG,Sudeste,BUTANTAN/SINOVAC,4911,2468,2443
Conselheiro Pena,311840,MG,Sudeste,FIOCRUZ/ASTRAZENECA,2820,2454,366
Conselheiro Pena,311840,MG,Sudeste,PFIZER/BIONTECH,221,221,0
Consolação,311850,MG,Sudeste,FIOCRUZ/ASTRAZENECA,548,502,46
Consolação,311850,MG,Sudeste,BUTANTAN/SINOVAC,496,246,250
Consolação,311850,MG,Sudeste,PFIZER/BIONTECH,27,27,0
Constantina,430580,RS,Sul,BUTANTAN/SINOVAC,3229,1659,1570
Constantina,430580,RS,Sul,FIOCRUZ/ASTRAZENECA,2545,2345,200
Constantina,430580,RS,Sul,PFIZER/BIONTECH,368,367,1
Contagem,311860,MG,Sudeste,FIOCRUZ/ASTRAZENECA,117562,109101,8461
Contagem,311860,MG,Sudeste,BUTANTAN/SINOVAC,109967,58103,51864
Contagem,311860,MG,Sudeste,PFIZER/BIONTECH,10883,10877,6
Contenda,410620,PR,Sul,FIOCRUZ/ASTRAZENECA,3697,3564,133
Contenda,410620,PR,Sul,BUTANTAN/SINOVAC,2841,1515,1326
Contenda,410620,PR,Sul,PFIZER/BIONTECH,252,227,25
Contendas Do Sincorá,290880,BA,Nordeste,BUTANTAN/SINOVAC,1727,901,826
Contendas Do Sincorá,290880,BA,Nordeste,FIOCRUZ/ASTRAZENECA,1437,1334,103
Contendas Do Sincorá,290880,BA,Nordeste,PFIZER/BIONTECH,69,69,0
Coqueiral,311870,MG,Sudeste,BUTANTAN/SINOVAC,2055,1032,1023
Coqueiral,311870,MG,Sudeste,FIOCRUZ/ASTRAZENECA,2019,1842,177
Coqueiral,311870,MG,Sudeste,PFIZER/BIONTECH,141,141,0
Coqueiro Baixo,430583,RS,Sul,BUTANTAN/SINOVAC,732,363,369
Coqueiro Baixo,430583,RS,Sul,FIOCRUZ/ASTRAZENECA,482,389,93
Coqueiro Baixo,430583,RS,Sul,PFIZER/BIONTECH,70,70,0
Coqueiro Seco,270220,AL,Nordeste,FIOCRUZ/ASTRAZENECA,1064,971,93
Coqueiro Seco,270220,AL,Nordeste,BUTANTAN/SINOVAC,1029,521,508
Coqueiros Do Sul,430585,RS,Sul,BUTANTAN/SINOVAC,1105,581,524
Coqueiros Do Sul,430585,RS,Sul,FIOCRUZ/ASTRAZENECA,932,850,82
Coqueiros Do Sul,430585,RS,Sul,PFIZER/BIONTECH,42,42,0
Coração De Jesus,311880,MG,Sudeste,BUTANTAN/SINOVAC,4630,2430,2200
Coração De Jesus,311880,MG,Sudeste,FIOCRUZ/ASTRAZENECA,3878,3625,253
Coração De Maria,290890,BA,Nordeste,FIOCRUZ/ASTRAZENECA,5602,4932,670
Coração De Maria,290890,BA,Nordeste,BUTANTAN/SINOVAC,4947,2598,2349
Coração De Maria,290890,BA,Nordeste,PFIZER/BIONTECH,631,627,4
Corbélia,410630,PR,Sul,FIOCRUZ/ASTRAZENECA,4218,3958,260
Corbélia,410630,PR,Sul,BUTANTAN/SINOVAC,2988,1588,1400
Cordeiro,330150,RJ,Sudeste,FIOCRUZ/ASTRAZENECA,6243,5722,521
Cordeiro,330150,RJ,Sudeste,BUTANTAN/SINOVAC,5265,2652,2613
Cordeiro,330150,RJ,Sudeste,PFIZER/BIONTECH,1255,1254,1
Cordeirópolis,351240,SP,Sudeste,BUTANTAN/SINOVAC,5723,3077,2646
Cordeirópolis,351240,SP,Sudeste,FIOCRUZ/ASTRAZENECA,5417,4969,448
Cordeirópolis,351240,SP,Sudeste,PFIZER/BIONTECH,23,23,0
Cordeiros,290900,BA,Nordeste,BUTANTAN/SINOVAC,1905,944,961
Cordeiros,290900,BA,Nordeste,FIOCRUZ/ASTRAZENECA,1316,1189,127
Cordeiros,290900,BA,Nordeste,PFIZER/BIONTECH,17,17,0
Cordilheira Alta,420435,SC,Sul,FIOCRUZ/ASTRAZENECA,967,890,77
Cordilheira Alta,420435,SC,Sul,BUTANTAN/SINOVAC,861,456,405
Cordilheira Alta,420435,SC,Sul,PFIZER/BIONTECH,49,49,0
Cordisburgo,311890,MG,Sudeste,BUTANTAN/SINOVAC,2277,1145,1132
Cordisburgo,311890,MG,Sudeste,FIOCRUZ/ASTRAZENECA,1476,1367,109
Cordisburgo,311890,MG,Sudeste,PFIZER/BIONTECH,80,80,0
Cordislândia,311900,MG,Sudeste,BUTANTAN/SINOVAC,823,419,404
Cordislândia,311900,MG,Sudeste,FIOCRUZ/ASTRAZENECA,386,361,25
Coreaú,230400,CE,Nordeste,BUTANTAN/SINOVAC,2262,1390,872
Coreaú,230400,CE,Nordeste,FIOCRUZ/ASTRAZENECA,1707,1625,82
Coremas,250480,PB,Nordeste,FIOCRUZ/ASTRAZENECA,3853,3534,319
Coremas,250480,PB,Nordeste,BUTANTAN/SINOVAC,3538,1774,1764
Coremas,250480,PB,Nordeste,PFIZER/BIONTECH,360,360,0
Corguinho,500310,MS,Centro-Oeste,FIOCRUZ/ASTRAZENECA,1700,1500,200
Corguinho,500310,MS,Centro-Oeste,BUTANTAN/SINOVAC,1305,658,647
Corguinho,500310,MS,Centro-Oeste,PFIZER/BIONTECH,183,183,0
Coribe,290910,BA,Nordeste,BUTANTAN/SINOVAC,3268,1704,1564
Coribe,290910,BA,Nordeste,FIOCRUZ/ASTRAZENECA,3213,2942,271
Coribe,290910,BA,Nordeste,PFIZER/BIONTECH,236,236,0
Corinto,311910,MG,Sudeste,FIOCRUZ/ASTRAZENECA,4727,4360,367
Corinto,311910,MG,Sudeste,BUTANTAN/SINOVAC,4462,2286,2176
Corinto,311910,MG,Sudeste,PFIZER/BIONTECH,147,147,0
Cornélio Procópio,410640,PR,Sul,BUTANTAN/SINOVAC,15668,8229,7439
Cornélio Procópio,410640,PR,Sul,FIOCRUZ/ASTRAZENECA,13019,12357,662
Cornélio Procópio,410640,PR,Sul,PFIZER/BIONTECH,2682,2682,0
Coroaci,311920,MG,Sudeste,BUTANTAN/SINOVAC,2436,1288,1148
Coroaci,311920,MG,Sudeste,FIOCRUZ/ASTRAZENECA,2255,2056,199
Coroaci,311920,MG,Sudeste,PFIZER/BIONTECH,253,253,0
Coroados,351250,SP,Sudeste,FIOCRUZ/ASTRAZENECA,1499,1398,101
Coroados,351250,SP,Sudeste,BUTANTAN/SINOVAC,1323,737,586
Coroados,351250,SP,Sudeste,PFIZER/BIONTECH,34,34,0
Coroatá,210360,MA,Nordeste,FIOCRUZ/ASTRAZENECA,10298,9606,692
Coroatá,210360,MA,Nordeste,BUTANTAN/SINOVAC,8735,4628,4107
Coromandel,311930,MG,Sudeste,FIOCRUZ/ASTRAZENECA,5980,4867,1113
Coromandel,311930,MG,Sudeste,BUTANTAN/SINOVAC,5950,3015,2935
Coromandel,311930,MG,Sudeste,PFIZER/BIONTECH,256,256,0
Coronel Barros,430587,RS,Sul,BUTANTAN/SINOVAC,980,499,481
Coronel Barros,430587,RS,Sul,FIOCRUZ/ASTRAZENECA,744,646,98
Coronel Barros,430587,RS,Sul,PFIZER/BIONTECH,108,108,0
Coronel Bicaco,430590,RS,Sul,BUTANTAN/SINOVAC,1923,972,951
Coronel Bicaco,430590,RS,Sul,FIOCRUZ/ASTRAZENECA,961,839,122
Coronel Bicaco,430590,RS,Sul,PFIZER/BIONTECH,90,90,0
Coronel Domingos Soares,410645,PR,Sul,FIOCRUZ/ASTRAZENECA,1354,1289,65
Coronel Domingos Soares,410645,PR,Sul,BUTANTAN/SINOVAC,1051,550,501
Coronel Ezequiel,240280,RN,Nordeste,FIOCRUZ/ASTRAZENECA,1149,1055,94
Coronel Ezequiel,240280,RN,Nordeste,BUTANTAN/SINOVAC,1138,591,547
Coronel Ezequiel,240280,RN,Nordeste,PFIZER/BIONTECH,140,140,0
Coronel Fabriciano,311940,MG,Sudeste,BUTANTAN/SINOVAC,18777,9761,9016
Coronel Fabriciano,311940,MG,Sudeste,FIOCRUZ/ASTRAZENECA,5401,4647,754
Coronel Fabriciano,311940,MG,Sudeste,PFIZER/BIONTECH,615,614,1
Coronel Freitas,420440,SC,Sul,BUTANTAN/SINOVAC,2579,1400,1179
Coronel Freitas,420440,SC,Sul,FIOCRUZ/ASTRAZENECA,2424,2193,231
Coronel Freitas,420440,SC,Sul,PFIZER/BIONTECH,270,270,0
Coronel João Pessoa,240290,RN,Nordeste,BUTANTAN/SINOVAC,1546,886,660
Coronel João Pessoa,240290,RN,Nordeste,FIOCRUZ/ASTRAZENECA,1412,1240,172
Coronel João Pessoa,240290,RN,Nordeste,PFIZER/BIONTECH,60,60,0
Coronel João Sá,290920,BA,Nordeste,FIOCRUZ/ASTRAZENECA,3395,3078,317
Coronel João Sá,290920,BA,Nordeste,BUTANTAN/SINOVAC,2845,1474,1371
Coronel José Dias,220285,PI,Nordeste,BUTANTAN/SINOVAC,688,355,333
Coronel José Dias,220285,PI,Nordeste,FIOCRUZ/ASTRAZENECA,421,421,0
Coronel Macedo,351260,SP,Sudeste,BUTANTAN/SINOVAC,1732,893,839
Coronel Macedo,351260,SP,Sudeste,FIOCRUZ/ASTRAZENECA,1657,1521,136
Coronel Macedo,351260,SP,Sudeste,PFIZER/BIONTECH,184,184,0
Coronel Martins,420445,SC,Sul,BUTANTAN/SINOVAC,726,375,351
Coronel Martins,420445,SC,Sul,FIOCRUZ/ASTRAZENECA,529,505,24
Coronel Martins,420445,SC,Sul,PFIZER/BIONTECH,40,40,0
Coronel Murta,311950,MG,Sudeste,BUTANTAN/SINOVAC,1917,981,936
Coronel Murta,311950,MG,Sudeste,FIOCRUZ/ASTRAZENECA,1652,1477,175
Coronel Murta,311950,MG,Sudeste,PFIZER/BIONTECH,150,150,0
Coronel Pacheco,311960,MG,Sudeste,FIOCRUZ/ASTRAZENECA,851,781,70
Coronel Pacheco,311960,MG,Sudeste,BUTANTAN/SINOVAC,847,428,419
Coronel Pacheco,311960,MG,Sudeste,PFIZER/BIONTECH,61,61,0
Coronel Pilar,430593,RS,Sul,BUTANTAN/SINOVAC,656,344,312
Coronel Pilar,430593,RS,Sul,FIOCRUZ/ASTRAZENECA,532,455,77
Coronel Pilar,430593,RS,Sul,PFIZER/BIONTECH,47,47,0
Coronel Sapucaia,500315,MS,Centro-Oeste,BUTANTAN/SINOVAC,3031,1738,1293
Coronel Sapucaia,500315,MS,Centro-Oeste,FIOCRUZ/ASTRAZENECA,2205,2115,90
Coronel Sapucaia,500315,MS,Centro-Oeste,PFIZER/BIONTECH,327,327,0
Coronel Vivida,410650,PR,Sul,BUTANTAN/SINOVAC,5764,2951,2813
Coronel Vivida,410650,PR,Sul,FIOCRUZ/ASTRAZENECA,5043,4725,318
Coronel Vivida,410650,PR,Sul,PFIZER/BIONTECH,2,2,0
Coronel Xavier Chaves,311970,MG,Sudeste,FIOCRUZ/ASTRAZENECA,968,898,70
Coronel Xavier Chaves,311970,MG,Sudeste,BUTANTAN/SINOVAC,892,452,440
Coronel Xavier Chaves,311970,MG,Sudeste,PFIZER/BIONTECH,74,74,0
Córrego Danta,311980,MG,Sudeste,BUTANTAN/SINOVAC,1162,599,563
Córrego Danta,311980,MG,Sudeste,FIOCRUZ/ASTRAZENECA,666,596,70
Córrego Danta,311980,MG,Sudeste,PFIZER/BIONTECH,21,21,0
Córrego Do Bom Jesus,311990,MG,Sudeste,BUTANTAN/SINOVAC,1233,625,608
Córrego Do Bom Jesus,311990,MG,Sudeste,FIOCRUZ/ASTRAZENECA,765,682,83
Córrego Do Bom Jesus,311990,MG,Sudeste,PFIZER/BIONTECH,29,29,0
Córrego Do Ouro,520570,GO,Centro-Oeste,FIOCRUZ/ASTRAZENECA,708,659,49
Córrego Do Ouro,520570,GO,Centro-Oeste,BUTANTAN/SINOVAC,577,294,283
Córrego Do Ouro,520570,GO,Centro-Oeste,PFIZER/BIONTECH,30,30,0
Córrego Fundo,311995,MG,Sudeste,BUTANTAN/SINOVAC,1167,600,567
Córrego Fundo,311995,MG,Sudeste,FIOCRUZ/ASTRAZENECA,977,901,76
Córrego Fundo,311995,MG,Sudeste,PFIZER/BIONTECH,40,40,0
Córrego Novo,312000,MG,Sudeste,BUTANTAN/SINOVAC,667,341,326
Córrego Novo,312000,MG,Sudeste,FIOCRUZ/ASTRAZENECA,613,594,19
Córrego Novo,312000,MG,Sudeste,PFIZER/BIONTECH,96,96,0
Correia Pinto,420455,SC,Sul,FIOCRUZ/ASTRAZENECA,3475,3259,216
Correia Pinto,420455,SC,Sul,BUTANTAN/SINOVAC,2491,1284,1207
Corrente,220290,PI,Nordeste,BUTANTAN/SINOVAC,2692,1566,1126
Corrente,220290,PI,Nordeste,FIOCRUZ/ASTRAZENECA,422,363,59
Correntes,260470,PE,Nordeste,FIOCRUZ/ASTRAZENECA,3268,3007,261
Correntes,260470,PE,Nordeste,BUTANTAN/SINOVAC,2261,1218,1043
Correntes,260470,PE,Nordeste,PFIZER/BIONTECH,282,282,0
Correntina,290930,BA,Nordeste,FIOCRUZ/ASTRAZENECA,5412,4911,501
Correntina,290930,BA,Nordeste,BUTANTAN/SINOVAC,5365,3014,2351
Correntina,290930,BA,Nordeste,PFIZER/BIONTECH,124,124,0
Cortês,260480,PE,Nordeste,BUTANTAN/SINOVAC,1560,792,768
Cortês,260480,PE,Nordeste,FIOCRUZ/ASTRAZENECA,1517,1388,129
Cortês,260480,PE,Nordeste,PFIZER/BIONTECH,56,56,0
Corumbá,500320,MS,Centro-Oeste,FIOCRUZ/ASTRAZENECA,27249,25404,1845
Corumbá,500320,MS,Centro-Oeste,BUTANTAN/SINOVAC,20660,10786,9874
Corumbá,500320,MS,Centro-Oeste,PFIZER/BIONTECH,913,913,0
Corumbá De Goiás,520580,GO,Centro-Oeste,FIOCRUZ/ASTRAZENECA,2568,2335,233
Corumbá De Goiás,520580,GO,Centro-Oeste,BUTANTAN/SINOVAC,2435,1246,1189
Corumbá De Goiás,520580,GO,Centro-Oeste,PFIZER/BIONTECH,148,148,0
Corumbaíba,520590,GO,Centro-Oeste,FIOCRUZ/ASTRAZENECA,2559,2313,246
Corumbaíba,520590,GO,Centro-Oeste,BUTANTAN/SINOVAC,1479,754,725
Corumbaíba,520590,GO,Centro-Oeste,PFIZER/BIONTECH,148,148,0
Corumbataí,351270,SP,Sudeste,BUTANTAN/SINOVAC,980,570,410
Corumbataí,351270,SP,Sudeste,FIOCRUZ/ASTRAZENECA,922,839,83
Corumbataí,351270,SP,Sudeste,PFIZER/BIONTECH,65,65,0
Corumbataí Do Sul,410655,PR,Sul,FIOCRUZ/ASTRAZENECA,1122,1062,60
Corumbataí Do Sul,410655,PR,Sul,BUTANTAN/SINOVAC,872,446,426
Corumbataí Do Sul,410655,PR,Sul,PFIZER/BIONTECH,18,18,0
Corumbiara,110007,RO,Norte,FIOCRUZ/ASTRAZENECA,1467,1426,41
Corumbiara,110007,RO,Norte,BUTANTAN/SINOVAC,1422,779,643
Corumbiara,110007,RO,Norte,PFIZER/BIONTECH,163,162,1
Corupá,420450,SC,Sul,FIOCRUZ/ASTRAZENECA,3237,2968,269
Corupá,420450,SC,Sul,BUTANTAN/SINOVAC,2869,1572,1297
Corupá,420450,SC,Sul,PFIZER/BIONTECH,290,290,0
Coruripe,270230,AL,Nordeste,FIOCRUZ/ASTRAZENECA,8043,7514,529
Coruripe,270230,AL,Nordeste,BUTANTAN/SINOVAC,7058,3665,3393
Coruripe,270230,AL,Nordeste,PFIZER/BIONTECH,4558,4557,1
Cosmópolis,351280,SP,Sudeste,BUTANTAN/SINOVAC,9693,5115,4578
Cosmópolis,351280,SP,Sudeste,FIOCRUZ/ASTRAZENECA,9295,8610,685
Cosmópolis,351280,SP,Sudeste,PFIZER/BIONTECH,99,99,0
Cosmorama,351290,SP,Sudeste,BUTANTAN/SINOVAC,2473,1392,1081
Cosmorama,351290,SP,Sudeste,FIOCRUZ/ASTRAZENECA,2014,1838,176
Cosmorama,351290,SP,Sudeste,PFIZER/BIONTECH,150,150,0
Costa Marques,110008,RO,Norte,FIOCRUZ/ASTRAZENECA,2222,2152,70
Costa Marques,110008,RO,Norte,BUTANTAN/SINOVAC,1914,1003,911
Costa Rica,500325,MS,Centro-Oeste,FIOCRUZ/ASTRAZENECA,5228,4969,259
Costa Rica,500325,MS,Centro-Oeste,BUTANTAN/SINOVAC,4009,2118,1891
Costa Rica,500325,MS,Centro-Oeste,PFIZER/BIONTECH,666,663,3
Cotegipe,290940,BA,Nordeste,FIOCRUZ/ASTRAZENECA,2859,2558,301
Cotegipe,290940,BA,Nordeste,BUTANTAN/SINOVAC,2279,1195,1084
Cotegipe,290940,BA,Nordeste,PFIZER/BIONTECH,90,89,1
Cotia,351300,SP,Sudeste,FIOCRUZ/ASTRAZENECA,40891,38122,2769
Cotia,351300,SP,Sudeste,BUTANTAN/SINOVAC,36687,21508,15179
Cotia,351300,SP,Sudeste,PFIZER/BIONTECH,4448,4444,4
Cotiporã,430595,RS,Sul,BUTANTAN/SINOVAC,1369,681,688
Cotiporã,430595,RS,Sul,FIOCRUZ/ASTRAZENECA,1278,1038,240
Cotiporã,430595,RS,Sul,PFIZER/BIONTECH,48,48,0
Cotriguaçu,510337,MT,Centro-Oeste,BUTANTAN/SINOVAC,1463,768,695
Cotriguaçu,510337,MT,Centro-Oeste,FIOCRUZ/ASTRAZENECA,975,924,51
Cotriguaçu,510337,MT,Centro-Oeste,PFIZER/BIONTECH,10,10,0
Couto De Magalhães De Minas,312010,MG,Sudeste,FIOCRUZ/ASTRAZENECA,1677,1552,125
Couto De Magalhães De Minas,312010,MG,Sudeste,BUTANTAN/SINOVAC,1111,569,542
Couto De Magalhães De Minas,312010,MG,Sudeste,PFIZER/BIONTECH,102,102,0
Couto Magalhães,170600,TO,Norte,FIOCRUZ/ASTRAZENECA,795,767,28
Couto Magalhães,170600,TO,Norte,BUTANTAN/SINOVAC,773,397,376
Coxilha,430597,RS,Sul,FIOCRUZ/ASTRAZENECA,757,657,100
Coxilha,430597,RS,Sul,BUTANTAN/SINOVAC,587,290,297
Coxilha,430597,RS,Sul,PFIZER/BIONTECH,139,139,0
Coxim,500330,MS,Centro-Oeste,FIOCRUZ/ASTRAZENECA,8787,7984,803
Coxim,500330,MS,Centro-Oeste,BUTANTAN/SINOVAC,6909,3611,3298
Coxim,500330,MS,Centro-Oeste,PFIZER/BIONTECH,840,840,0
Coxixola,250485,PB,Nordeste,BUTANTAN/SINOVAC,639,316,323
Coxixola,250485,PB,Nordeste,FIOCRUZ/ASTRAZENECA,367,317,50
Coxixola,250485,PB,Nordeste,PFIZER/BIONTECH,36,36,0
Craíbas,270235,AL,Nordeste,BUTANTAN/SINOVAC,3795,2112,1683
Craíbas,270235,AL,Nordeste,FIOCRUZ/ASTRAZENECA,2939,2779,160
Crateús,230410,CE,Nordeste,BUTANTAN/SINOVAC,13189,7176,6013
Crateús,230410,CE,Nordeste,FIOCRUZ/ASTRAZENECA,5521,5008,513
Crato,230420,CE,Nordeste,BUTANTAN/SINOVAC,9536,5566,3970
Crato,230420,CE,Nordeste,FIOCRUZ/ASTRAZENECA,2520,2102,418
Cravinhos,351310,SP,Sudeste,FIOCRUZ/ASTRAZENECA,7311,6790,521
Cravinhos,351310,SP,Sudeste,BUTANTAN/SINOVAC,6159,3238,2921
Cravinhos,351310,SP,Sudeste,PFIZER/BIONTECH,213,213,0
Cravolândia,290950,BA,Nordeste,BUTANTAN/SINOVAC,1287,673,614
Cravolândia,290950,BA,Nordeste,FIOCRUZ/ASTRAZENECA,1235,1059,176
Cravolândia,290950,BA,Nordeste,PFIZER/BIONTECH,36,36,0
Criciúma,420460,SC,Sul,FIOCRUZ/ASTRAZENECA,35912,34903,1009
Criciúma,420460,SC,Sul,BUTANTAN/SINOVAC,33288,17142,16146
Criciúma,420460,SC,Sul,PFIZER/BIONTECH,10876,10851,25
Crisólita,312015,MG,Sudeste,BUTANTAN/SINOVAC,1291,654,637
Crisólita,312015,MG,Sudeste,FIOCRUZ/ASTRAZENECA,785,711,74
Crisólita,312015,MG,Sudeste,PFIZER/BIONTECH,57,57,0
Crisópolis,290960,BA,Nordeste,BUTANTAN/SINOVAC,3024,1805,1219
Crisópolis,290960,BA,Nordeste,FIOCRUZ/ASTRAZENECA,1682,1671,11
Crisópolis,290960,BA,Nordeste,PFIZER/BIONTECH,146,146,0
Crissiumal,430600,RS,Sul,BUTANTAN/SINOVAC,4381,2291,2090
Crissiumal,430600,RS,Sul,FIOCRUZ/ASTRAZENECA,3386,3140,246
Crissiumal,430600,RS,Sul,PFIZER/BIONTECH,354,354,0
Cristais,312020,MG,Sudeste,FIOCRUZ/ASTRAZENECA,2713,2540,173
Cristais,312020,MG,Sudeste,BUTANTAN/SINOVAC,2532,1323,1209
Cristais,312020,MG,Sudeste,PFIZER/BIONTECH,136,135,1
Cristais Paulista,351320,SP,Sudeste,BUTANTAN/SINOVAC,1743,913,830
Cristais Paulista,351320,SP,Sudeste,FIOCRUZ/ASTRAZENECA,1641,1488,153
Cristais Paulista,351320,SP,Sudeste,PFIZER/BIONTECH,108,108,0
Cristal,430605,RS,Sul,BUTANTAN/SINOVAC,2236,1184,1052
Cristal,430605,RS,Sul,FIOCRUZ/ASTRAZENECA,1328,1240,88
Cristal,430605,RS,Sul,PFIZER/BIONTECH,111,111,0
Cristal Do Sul,430607,RS,Sul,BUTANTAN/SINOVAC,962,481,481
Cristal Do Sul,430607,RS,Sul,FIOCRUZ/ASTRAZENECA,720,636,84
Cristal Do Sul,430607,RS,Sul,PFIZER/BIONTECH,78,78,0
Cristalândia,170610,TO,Norte,BUTANTAN/SINOVAC,1918,1059,859
Cristalândia,170610,TO,Norte,FIOCRUZ/ASTRAZENECA,1320,1262,58
Cristalândia Do Piauí,220300,PI,Nordeste,FIOCRUZ/ASTRAZENECA,1764,1686,78
Cristalândia Do Piauí,220300,PI,Nordeste,BUTANTAN/SINOVAC,1455,782,673
Cristália,312030,MG,Sudeste,FIOCRUZ/ASTRAZENECA,1050,979,71
Cristália,312030,MG,Sudeste,BUTANTAN/SINOVAC,849,434,415
Cristália,312030,MG,Sudeste,PFIZER/BIONTECH,70,70,0
Cristalina,520620,GO,Centro-Oeste,FIOCRUZ/ASTRAZENECA,11678,11055,623
Cristalina,520620,GO,Centro-Oeste,BUTANTAN/SINOVAC,7649,3944,3705
Cristalina,520620,GO,Centro-Oeste,PFIZER/BIONTECH,882,882,0
Cristiano Otoni,312040,MG,Sudeste,BUTANTAN/SINOVAC,253,168,85
Cristiano Otoni,312040,MG,Sudeste,FIOCRUZ/ASTRAZENECA,83,83,0
Cristianópolis,520630,GO,Centro-Oeste,BUTANTAN/SINOVAC,752,400,352
Cristianópolis,520630,GO,Centro-Oeste,FIOCRUZ/ASTRAZENECA,729,663,66
Cristina,312050,MG,Sudeste,BUTANTAN/SINOVAC,2421,1277,1144
Cristina,312050,MG,Sudeste,FIOCRUZ/ASTRAZENECA,1660,1599,61
Cristinápolis,280170,SE,Nordeste,BUTANTAN/SINOVAC,2216,1267,949
Cristinápolis,280170,SE,Nordeste,FIOCRUZ/ASTRAZENECA,388,388,0
Cristino Castro,220310,PI,Nordeste,FIOCRUZ/ASTRAZENECA,2016,1809,207
Cristino Castro,220310,PI,Nordeste,BUTANTAN/SINOVAC,1463,764,699
Cristino Castro,220310,PI,Nordeste,PFIZER/BIONTECH,81,81,0
Cristópolis,290970,BA,Nordeste,FIOCRUZ/ASTRAZENECA,4261,3816,445
Cristópolis,290970,BA,Nordeste,BUTANTAN/SINOVAC,4050,2153,1897
Cristópolis,290970,BA,Nordeste,PFIZER/BIONTECH,268,268,0
Crixás,520640,GO,Centro-Oeste,FIOCRUZ/ASTRAZENECA,3583,3453,130
Crixás,520640,GO,Centro-Oeste,BUTANTAN/SINOVAC,2748,1417,1331
Crixás,520640,GO,Centro-Oeste,PFIZER/BIONTECH,263,263,0
Crixás Do Tocantins,170625,TO,Norte,BUTANTAN/SINOVAC,417,221,196
Crixás Do Tocantins,170625,TO,Norte,FIOCRUZ/ASTRAZENECA,377,367,10
Croatá,230423,CE,Nordeste,BUTANTAN/SINOVAC,2070,1276,794
Croatá,230423,CE,Nordeste,FIOCRUZ/ASTRAZENECA,975,914,61
Croatá,230423,CE,Nordeste,PFIZER/BIONTECH,6,6,0
Cromínia,520650,GO,Centro-Oeste,BUTANTAN/SINOVAC,2027,1043,984
Cromínia,520650,GO,Centro-Oeste,FIOCRUZ/ASTRAZENECA,1011,927,84
Crucilândia,312060,MG,Sudeste,BUTANTAN/SINOVAC,1639,837,802
Crucilândia,312060,MG,Sudeste,FIOCRUZ/ASTRAZENECA,1380,1251,129
Crucilândia,312060,MG,Sudeste,PFIZER/BIONTECH,83,83,0
Cruz,230425,CE,Nordeste,BUTANTAN/SINOVAC,3935,1952,1983
Cruz,230425,CE,Nordeste,FIOCRUZ/ASTRAZENECA,3593,3239,354
Cruz Alta,430610,RS,Sul,BUTANTAN/SINOVAC,16300,8219,8081
Cruz Alta,430610,RS,Sul,FIOCRUZ/ASTRAZENECA,14800,13399,1401
Cruz Alta,430610,RS,Sul,PFIZER/BIONTECH,762,761,1
Cruz Das Almas,290980,BA,Nordeste,BUTANTAN/SINOVAC,9466,5246,4220
Cruz Das Almas,290980,BA,Nordeste,FIOCRUZ/ASTRAZENECA,7317,6858,459
Cruz Das Almas,290980,BA,Nordeste,PFIZER/BIONTECH,892,891,1
Cruz Do Espírito Santo,250490,PB,Nordeste,BUTANTAN/SINOVAC,2360,1232,1128
Cruz Do Espírito Santo,250490,PB,Nordeste,FIOCRUZ/ASTRAZENECA,2129,1979,150
Cruz Do Espírito Santo,250490,PB,Nordeste,PFIZER/BIONTECH,309,309,0
Cruz Machado,410680,PR,Sul,BUTANTAN/SINOVAC,3044,1562,1482
Cruz Machado,410680,PR,Sul,FIOCRUZ/ASTRAZENECA,2544,2380,164
Cruzália,351330,SP,Sudeste,BUTANTAN/SINOVAC,1235,619,616
Cruzália,351330,SP,Sudeste,FIOCRUZ/ASTRAZENECA,913,805,108
Cruzália,351330,SP,Sudeste,PFIZER/BIONTECH,64,64,0
Cruzaltense,430613,RS,Sul,BUTANTAN/SINOVAC,600,323,277
Cruzaltense,430613,RS,Sul,FIOCRUZ/ASTRAZENECA,538,456,82
Cruzaltense,430613,RS,Sul,PFIZER/BIONTECH,78,78,0
Cruzeiro,351340,SP,Sudeste,BUTANTAN/SINOVAC,14434,7682,6752
Cruzeiro,351340,SP,Sudeste,FIOCRUZ/ASTRAZENECA,13125,11773,1352
Cruzeiro Da Fortaleza,312070,MG,Sudeste,FIOCRUZ/ASTRAZENECA,1006,916,90
Cruzeiro Da Fortaleza,312070,MG,Sudeste,BUTANTAN/SINOVAC,805,416,389
Cruzeiro Da Fortaleza,312070,MG,Sudeste,PFIZER/BIONTECH,69,69,0
Cruzeiro Do Iguaçu,410657,PR,Sul,FIOCRUZ/ASTRAZENECA,1277,1209,68
Cruzeiro Do Iguaçu,410657,PR,Sul,BUTANTAN/SINOVAC,840,433,407
Cruzeiro Do Oeste,410660,PR,Sul,FIOCRUZ/ASTRAZENECA,6193,5867,326
Cruzeiro Do Oeste,410660,PR,Sul,BUTANTAN/SINOVAC,4798,2540,2258
Cruzeiro Do Oeste,410660,PR,Sul,PFIZER/BIONTECH,566,566,0
Cruzeiro Do Sul,120020,AC,Norte,FIOCRUZ/ASTRAZENECA,22688,20384,2304
Cruzeiro Do Sul,120020,AC,Norte,BUTANTAN/SINOVAC,10981,5699,5282
Cruzeiro Do Sul,120020,AC,Norte,PFIZER/BIONTECH,172,172,0
Cruzeiro Do Sul,410670,PR,Sul,FIOCRUZ/ASTRAZENECA,1175,1089,86
Cruzeiro Do Sul,410670,PR,Sul,BUTANTAN/SINOVAC,1100,574,526
Cruzeiro Do Sul,430620,RS,Sul,BUTANTAN/SINOVAC,4066,2092,1974
Cruzeiro Do Sul,430620,RS,Sul,FIOCRUZ/ASTRAZENECA,2499,2263,236
Cruzeiro Do Sul,430620,RS,Sul,PFIZER/BIONTECH,151,150,1
Cruzeta,240300,RN,Nordeste,BUTANTAN/SINOVAC,2020,1072,948
Cruzeta,240300,RN,Nordeste,FIOCRUZ/ASTRAZENECA,1599,1497,102
Cruzeta,240300,RN,Nordeste,PFIZER/BIONTECH,169,169,0
Cruzília,312080,MG,Sudeste,FIOCRUZ/ASTRAZENECA,3869,3582,287
Cruzília,312080,MG,Sudeste,BUTANTAN/SINOVAC,3688,1878,1810
Cruzília,312080,MG,Sudeste,PFIZER/BIONTECH,81,81,0
Cruzmaltina,410685,PR,Sul,FIOCRUZ/ASTRAZENECA,679,628,51
Cruzmaltina,410685,PR,Sul,BUTANTAN/SINOVAC,638,331,307
Cubatão,351350,SP,Sudeste,FIOCRUZ/ASTRAZENECA,24195,22694,1501
Cubatão,351350,SP,Sudeste,BUTANTAN/SINOVAC,20632,10800,9832
Cubatão,351350,SP,Sudeste,PFIZER/BIONTECH,2243,2240,3
Cubati,250500,PB,Nordeste,BUTANTAN/SINOVAC,1590,822,768
Cubati,250500,PB,Nordeste,FIOCRUZ/ASTRAZENECA,1301,1164,137
Cubati,250500,PB,Nordeste,PFIZER/BIONTECH,47,47,0
Cuiabá,510340,MT,Centro-Oeste,BUTANTAN/SINOVAC,118281,62049,56232
Cuiabá,510340,MT,Centro-Oeste,FIOCRUZ/ASTRAZENECA,106351,96512,9839
Cuiabá,510340,MT,Centro-Oeste,PFIZER/BIONTECH,40845,40777,68
Cuité,250510,PB,Nordeste,BUTANTAN/SINOVAC,5285,2729,2556
Cuité,250510,PB,Nordeste,FIOCRUZ/ASTRAZENECA,3402,2975,427
Cuité,250510,PB,Nordeste,PFIZER/BIONTECH,290,289,1
Cuité De Mamanguape,250523,PB,Nordeste,BUTANTAN/SINOVAC,1325,776,549
Cuité De Mamanguape,250523,PB,Nordeste,FIOCRUZ/ASTRAZENECA,584,492,92
Cuité De Mamanguape,250523,PB,Nordeste,PFIZER/BIONTECH,4,4,0
Cuitegi,250520,PB,Nordeste,BUTANTAN/SINOVAC,1299,707,592
Cuitegi,250520,PB,Nordeste,FIOCRUZ/ASTRAZENECA,320,291,29
Cujubim,110094,RO,Norte,FIOCRUZ/ASTRAZENECA,3297,3254,43
Cujubim,110094,RO,Norte,BUTANTAN/SINOVAC,1855,1011,844
Cujubim,110094,RO,Norte,PFIZER/BIONTECH,99,99,0
Cumari,520660,GO,Centro-Oeste,FIOCRUZ/ASTRAZENECA,1133,1057,76
Cumari,520660,GO,Centro-Oeste,BUTANTAN/SINOVAC,601,308,293
Cumari,520660,GO,Centro-Oeste,PFIZER/BIONTECH,18,18,0
Cumaru,260490,PE,Nordeste,FIOCRUZ/ASTRAZENECA,3221,2973,248
Cumaru,260490,PE,Nordeste,BUTANTAN/SINOVAC,2903,1508,1395
Cumaru,260490,PE,Nordeste,PFIZER/BIONTECH,225,225,0
Cumaru Do Norte,150276,PA,Norte,BUTANTAN/SINOVAC,1130,692,438
Cumaru Do Norte,150276,PA,Norte,FIOCRUZ/ASTRAZENECA,1061,889,172
Cumbe,280190,SE,Nordeste,FIOCRUZ/ASTRAZENECA,964,913,51
Cumbe,280190,SE,Nordeste,BUTANTAN/SINOVAC,942,501,441
Cumbe,280190,SE,Nordeste,PFIZER/BIONTECH,87,87,0
Cunha,351360,SP,Sudeste,FIOCRUZ/ASTRAZENECA,5129,4757,372
Cunha,351360,SP,Sudeste,BUTANTAN/SINOVAC,5107,2747,2360
Cunha,351360,SP,Sudeste,PFIZER/BIONTECH,606,606,0
Cunha Porã,420470,SC,Sul,FIOCRUZ/ASTRAZENECA,3127,2761,366
Cunha Porã,420470,SC,Sul,BUTANTAN/SINOVAC,3016,1534,1482
Cunha Porã,420470,SC,Sul,PFIZER/BIONTECH,138,138,0
Cunhataí,420475,SC,Sul,FIOCRUZ/ASTRAZENECA,630,569,61
Cunhataí,420475,SC,Sul,BUTANTAN/SINOVAC,588,311,277
Cunhataí,420475,SC,Sul,PFIZER/BIONTECH,60,60,0
Cuparaque,312083,MG,Sudeste,BUTANTAN/SINOVAC,974,504,470
Cuparaque,312083,MG,Sudeste,FIOCRUZ/ASTRAZENECA,960,894,66
Cuparaque,312083,MG,Sudeste,PFIZER/BIONTECH,142,142,0
Cupira,260500,PE,Nordeste,BUTANTAN/SINOVAC,3859,2077,1782
Cupira,260500,PE,Nordeste,FIOCRUZ/ASTRAZENECA,3285,3013,272
Cupira,260500,PE,Nordeste,PFIZER/BIONTECH,40,40,0
Curaçá,290990,BA,Nordeste,BUTANTAN/SINOVAC,5550,3020,2530
Curaçá,290990,BA,Nordeste,FIOCRUZ/ASTRAZENECA,4093,3923,170
Curimatá,220320,PI,Nordeste,FIOCRUZ/ASTRAZENECA,2144,1891,253
Curimatá,220320,PI,Nordeste,BUTANTAN/SINOVAC,1853,947,906
Curimatá,220320,PI,Nordeste,PFIZER/BIONTECH,223,223,0
Curionópolis,150277,PA,Norte,FIOCRUZ/ASTRAZENECA,3759,3473,286
Curionópolis,150277,PA,Norte,BUTANTAN/SINOVAC,843,473,370
Curitiba,410690,PR,Sul,FIOCRUZ/ASTRAZENECA,410940,364235,46705
Curitiba,410690,PR,Sul,BUTANTAN/SINOVAC,400374,207719,192655
Curitiba,410690,PR,Sul,PFIZER/BIONTECH,136129,136119,10
Curitibanos,420480,SC,Sul,BUTANTAN/SINOVAC,7706,4223,3483
Curitibanos,420480,SC,Sul,FIOCRUZ/ASTRAZENECA,7551,6828,723
Curitibanos,420480,SC,Sul,PFIZER/BIONTECH,1,0,1
Curiúva,410700,PR,Sul,BUTANTAN/SINOVAC,3861,2141,1720
Curiúva,410700,PR,Sul,FIOCRUZ/ASTRAZENECA,3605,3454,151
Currais,220323,PI,Nordeste,FIOCRUZ/ASTRAZENECA,927,839,88
Currais,220323,PI,Nordeste,BUTANTAN/SINOVAC,605,325,280
Currais,220323,PI,Nordeste,PFIZER/BIONTECH,119,119,0
Currais Novos,240310,RN,Nordeste,FIOCRUZ/ASTRAZENECA,6505,5870,635
Currais Novos,240310,RN,Nordeste,BUTANTAN/SINOVAC,5795,3011,2784
Currais Novos,240310,RN,Nordeste,PFIZER/BIONTECH,1264,1263,1
Curral De Cima,250527,PB,Nordeste,BUTANTAN/SINOVAC,1229,645,584
Curral De Cima,250527,PB,Nordeste,FIOCRUZ/ASTRAZENECA,842,766,76
Curral De Cima,250527,PB,Nordeste,PFIZER/BIONTECH,48,48,0
Curral De Dentro,312087,MG,Sudeste,BUTANTAN/SINOVAC,1397,713,684
Curral De Dentro,312087,MG,Sudeste,FIOCRUZ/ASTRAZENECA,1260,1163,97
Curral De Dentro,312087,MG,Sudeste,PFIZER/BIONTECH,100,100,0
Curral Novo Do Piauí,220327,PI,Nordeste,BUTANTAN/SINOVAC,655,345,310
Curral Novo Do Piauí,220327,PI,Nordeste,FIOCRUZ/ASTRAZENECA,506,447,59
Curral Velho,250530,PB,Nordeste,BUTANTAN/SINOVAC,556,290,266
Curral Velho,250530,PB,Nordeste,FIOCRUZ/ASTRAZENECA,440,408,32
Curral Velho,250530,PB,Nordeste,PFIZER/BIONTECH,43,43,0
Curralinho,150280,PA,Norte,FIOCRUZ/ASTRAZENECA,5049,4717,332
Curralinho,150280,PA,Norte,BUTANTAN/SINOVAC,1493,839,654
Curralinhos,220325,PI,Nordeste,BUTANTAN/SINOVAC,1025,529,496
Curralinhos,220325,PI,Nordeste,FIOCRUZ/ASTRAZENECA,461,441,20
Curralinhos,220325,PI,Nordeste,PFIZER/BIONTECH,130,130,0
Curuá,150285,PA,Norte,FIOCRUZ/ASTRAZENECA,4312,3308,1004
Curuá,150285,PA,Norte,BUTANTAN/SINOVAC,455,249,206
Curuçá,150290,PA,Norte,FIOCRUZ/ASTRAZENECA,5763,4636,1127
Curuçá,150290,PA,Norte,BUTANTAN/SINOVAC,5075,2766,2309
Cururupu,210370,MA,Nordeste,FIOCRUZ/ASTRAZENECA,7872,7475,397
Cururupu,210370,MA,Nordeste,BUTANTAN/SINOVAC,5264,2827,2437
Curvelândia,510343,MT,Centro-Oeste,BUTANTAN/SINOVAC,1121,596,525
Curvelândia,510343,MT,Centro-Oeste,FIOCRUZ/ASTRAZENECA,906,859,47
Curvelândia,510343,MT,Centro-Oeste,PFIZER/BIONTECH,4,4,0
Curvelo,312090,MG,Sudeste,BUTANTAN/SINOVAC,17770,8991,8779
Curvelo,312090,MG,Sudeste,FIOCRUZ/ASTRAZENECA,16811,15370,1441
Curvelo,312090,MG,Sudeste,PFIZER/BIONTECH,1402,1401,1
Custódia,260510,PE,Nordeste,FIOCRUZ/ASTRAZENECA,9075,8369,706
Custódia,260510,PE,Nordeste,BUTANTAN/SINOVAC,6097,3093,3004
Custódia,260510,PE,Nordeste,PFIZER/BIONTECH,526,526,0
Cutias,160021,AP,Norte,FIOCRUZ/ASTRAZENECA,1505,1468,37
Cutias,160021,AP,Norte,BUTANTAN/SINOVAC,797,412,385
Cutias,160021,AP,Norte,PFIZER/BIONTECH,420,420,0
Damianópolis,520670,GO,Centro-Oeste,FIOCRUZ/ASTRAZENECA,1368,1158,210
Damianópolis,520670,GO,Centro-Oeste,BUTANTAN/SINOVAC,390,214,176
Damião,250535,PB,Nordeste,BUTANTAN/SINOVAC,1041,530,511
Damião,250535,PB,Nordeste,FIOCRUZ/ASTRAZENECA,775,694,81
Damião,250535,PB,Nordeste,PFIZER/BIONTECH,62,62,0
Damolândia,520680,GO,Centro-Oeste,FIOCRUZ/ASTRAZENECA,885,819,66
Damolândia,520680,GO,Centro-Oeste,BUTANTAN/SINOVAC,722,371,351
Damolândia,520680,GO,Centro-Oeste,PFIZER/BIONTECH,41,41,0
Darcinópolis,170650,TO,Norte,BUTANTAN/SINOVAC,971,502,469
Darcinópolis,170650,TO,Norte,FIOCRUZ/ASTRAZENECA,459,436,23
Dário Meira,291000,BA,Nordeste,BUTANTAN/SINOVAC,1724,898,826
Dário Meira,291000,BA,Nordeste,FIOCRUZ/ASTRAZENECA,1439,1252,187
Dário Meira,291000,BA,Nordeste,PFIZER/BIONTECH,29,29,0
Datas,312100,MG,Sudeste,BUTANTAN/SINOVAC,752,424,328
Datas,312100,MG,Sudeste,FIOCRUZ/ASTRAZENECA,396,358,38
David Canabarro,430630,RS,Sul,BUTANTAN/SINOVAC,1443,737,706
David Canabarro,430630,RS,Sul,FIOCRUZ/ASTRAZENECA,1230,1142,88
David Canabarro,430630,RS,Sul,PFIZER/BIONTECH,174,174,0
Davinópolis,210375,MA,Nordeste,FIOCRUZ/ASTRAZENECA,2291,2155,136
Davinópolis,210375,MA,Nordeste,BUTANTAN/SINOVAC,2058,1080,978
Davinópolis,520690,GO,Centro-Oeste,FIOCRUZ/ASTRAZENECA,804,704,100
Davinópolis,520690,GO,Centro-Oeste,BUTANTAN/SINOVAC,453,229,224
Davinópolis,520690,GO,Centro-Oeste,PFIZER/BIONTECH,24,24,0
Delfim Moreira,312110,MG,Sudeste,FIOCRUZ/ASTRAZENECA,1424,1342,82
Delfim Moreira,312110,MG,Sudeste,BUTANTAN/SINOVAC,1334,688,646
Delfim Moreira,312110,MG,Sudeste,PFIZER/BIONTECH,70,70,0
Delfinópolis,312120,MG,Sudeste,BUTANTAN/SINOVAC,1648,868,780
Delfinópolis,312120,MG,Sudeste,FIOCRUZ/ASTRAZENECA,1478,1403,75
Delfinópolis,312120,MG,Sudeste,PFIZER/BIONTECH,47,47,0
Delmiro Gouveia,270240,AL,Nordeste,FIOCRUZ/ASTRAZENECA,9649,9004,645
Delmiro Gouveia,270240,AL,Nordeste,BUTANTAN/SINOVAC,7452,3833,3619
Delta,312125,MG,Sudeste,FIOCRUZ/ASTRAZENECA,1343,1272,71
Delta,312125,MG,Sudeste,BUTANTAN/SINOVAC,1150,590,560
Delta,312125,MG,Sudeste,PFIZER/BIONTECH,141,141,0
Demerval Lobão,220330,PI,Nordeste,BUTANTAN/SINOVAC,1781,907,874
Demerval Lobão,220330,PI,Nordeste,FIOCRUZ/ASTRAZENECA,1554,1431,123
Denise,510345,MT,Centro-Oeste,BUTANTAN/SINOVAC,944,527,417
Denise,510345,MT,Centro-Oeste,FIOCRUZ/ASTRAZENECA,693,681,12
Deodápolis,500345,MS,Centro-Oeste,BUTANTAN/SINOVAC,3330,1772,1558
Deodápolis,500345,MS,Centro-Oeste,FIOCRUZ/ASTRAZENECA,3218,2767,451
Deodápolis,500345,MS,Centro-Oeste,PFIZER/BIONTECH,472,471,1
Deputado Irapuan Pinheiro,230426,CE,Nordeste,BUTANTAN/SINOVAC,1460,835,625
Deputado Irapuan Pinheiro,230426,CE,Nordeste,FIOCRUZ/ASTRAZENECA,607,476,131
Derrubadas,430632,RS,Sul,BUTANTAN/SINOVAC,926,474,452
Derrubadas,430632,RS,Sul,FIOCRUZ/ASTRAZENECA,737,662,75
Derrubadas,430632,RS,Sul,PFIZER/BIONTECH,102,101,1
Descalvado,351370,SP,Sudeste,BUTANTAN/SINOVAC,8685,4644,4041
Descalvado,351370,SP,Sudeste,FIOCRUZ/ASTRAZENECA,8524,7645,879
Descalvado,351370,SP,Sudeste,PFIZER/BIONTECH,583,583,0
Descanso,420490,SC,Sul,BUTANTAN/SINOVAC,3418,1636,1782
Descanso,420490,SC,Sul,FIOCRUZ/ASTRAZENECA,3318,3060,258
Descanso,420490,SC,Sul,PFIZER/BIONTECH,133,133,0
Descoberto,312130,MG,Sudeste,BUTANTAN/SINOVAC,1290,668,622
Descoberto,312130,MG,Sudeste,FIOCRUZ/ASTRAZENECA,441,428,13
Desterro,250540,PB,Nordeste,BUTANTAN/SINOVAC,1830,972,858
Desterro,250540,PB,Nordeste,FIOCRUZ/ASTRAZENECA,1281,1166,115
Desterro,250540,PB,Nordeste,PFIZER/BIONTECH,167,167,0
Desterro De Entre Rios,312140,MG,Sudeste,BUTANTAN/SINOVAC,2090,1082,1008
Desterro De Entre Rios,312140,MG,Sudeste,FIOCRUZ/ASTRAZENECA,1917,1772,145
Desterro De Entre Rios,312140,MG,Sudeste,PFIZER/BIONTECH,20,20,0
Desterro Do Melo,312150,MG,Sudeste,BUTANTAN/SINOVAC,1051,535,516
Desterro Do Melo,312150,MG,Sudeste,FIOCRUZ/ASTRAZENECA,914,637,277
Desterro Do Melo,312150,MG,Sudeste,PFIZER/BIONTECH,66,66,0
Dezesseis De Novembro,430635,RS,Sul,BUTANTAN/SINOVAC,935,469,466
Dezesseis De Novembro,430635,RS,Sul,FIOCRUZ/ASTRAZENECA,650,572,78
Dezesseis De Novembro,430635,RS,Sul,PFIZER/BIONTECH,118,118,0
Diadema,351380,SP,Sudeste,FIOCRUZ/ASTRAZENECA,80690,75461,5229
Diadema,351380,SP,Sudeste,BUTANTAN/SINOVAC,65882,34764,31118
Diadema,351380,SP,Sudeste,PFIZER/BIONTECH,6295,6288,7
Diamante,250560,PB,Nordeste,FIOCRUZ/ASTRAZENECA,1937,1842,95
Diamante,250560,PB,Nordeste,BUTANTAN/SINOVAC,1366,711,655
Diamante,250560,PB,Nordeste,PFIZER/BIONTECH,177,177,0
Diamante D'Oeste,410715,PR,Sul,BUTANTAN/SINOVAC,1641,845,796
Diamante D'Oeste,410715,PR,Sul,FIOCRUZ/ASTRAZENECA,1214,1146,68
Diamante D'Oeste,410715,PR,Sul,PFIZER/BIONTECH,28,28,0
Diamante Do Norte,410710,PR,Sul,FIOCRUZ/ASTRAZENECA,1558,1438,120
Diamante Do Norte,410710,PR,Sul,BUTANTAN/SINOVAC,1544,869,675
Diamante Do Norte,410710,PR,Sul,PFIZER/BIONTECH,24,24,0
Diamante Do Sul,410712,PR,Sul,FIOCRUZ/ASTRAZENECA,715,673,42
Diamante Do Sul,410712,PR,Sul,BUTANTAN/SINOVAC,606,316,290
Diamantina,312160,MG,Sudeste,BUTANTAN/SINOVAC,8824,4670,4154
Diamantina,312160,MG,Sudeste,FIOCRUZ/ASTRAZENECA,6059,5460,599
Diamantina,312160,MG,Sudeste,PFIZER/BIONTECH,534,533,1
Diamantino,510350,MT,Centro-Oeste,BUTANTAN/SINOVAC,3306,1755,1551
Diamantino,510350,MT,Centro-Oeste,FIOCRUZ/ASTRAZENECA,3173,2981,192
Diamantino,510350,MT,Centro-Oeste,PFIZER/BIONTECH,243,243,0
Dianópolis,170700,TO,Norte,FIOCRUZ/ASTRAZENECA,3858,3704,154
Dianópolis,170700,TO,Norte,BUTANTAN/SINOVAC,3342,1703,1639
Dias D'Ávila,291005,BA,Nordeste,FIOCRUZ/ASTRAZENECA,10567,9073,1494
Dias D'Ávila,291005,BA,Nordeste,BUTANTAN/SINOVAC,8759,4559,4200
Dias D'Ávila,291005,BA,Nordeste,PFIZER/BIONTECH,3147,3145,2
Dilermando De Aguiar,430637,RS,Sul,BUTANTAN/SINOVAC,879,438,441
Dilermando De Aguiar,430637,RS,Sul,FIOCRUZ/ASTRAZENECA,843,706,137
Dilermando De Aguiar,430637,RS,Sul,PFIZER/BIONTECH,132,132,0
Diogo De Vasconcelos,312170,MG,Sudeste,FIOCRUZ/ASTRAZENECA,985,926,59
Diogo De Vasconcelos,312170,MG,Sudeste,BUTANTAN/SINOVAC,883,494,389
Diogo De Vasconcelos,312170,MG,Sudeste,PFIZER/BIONTECH,57,57,0
Dionísio,312180,MG,Sudeste,BUTANTAN/SINOVAC,2919,1715,1204
Dionísio,312180,MG,Sudeste,FIOCRUZ/ASTRAZENECA,2005,1969,36
Dionísio,312180,MG,Sudeste,PFIZER/BIONTECH,115,115,0
Dionísio Cerqueira,420500,SC,Sul,BUTANTAN/SINOVAC,4040,2185,1855
Dionísio Cerqueira,420500,SC,Sul,FIOCRUZ/ASTRAZENECA,2262,1966,296
Dionísio Cerqueira,420500,SC,Sul,PFIZER/BIONTECH,70,70,0
Diorama,520710,GO,Centro-Oeste,FIOCRUZ/ASTRAZENECA,623,565,58
Diorama,520710,GO,Centro-Oeste,BUTANTAN/SINOVAC,593,313,280
Diorama,520710,GO,Centro-Oeste,PFIZER/BIONTECH,30,30,0
Dirce Reis,351385,SP,Sudeste,BUTANTAN/SINOVAC,603,318,285
Dirce Reis,351385,SP,Sudeste,FIOCRUZ/ASTRAZENECA,568,512,56
Dirce Reis,351385,SP,Sudeste,PFIZER/BIONTECH,56,56,0
Dirceu Arcoverde,220335,PI,Nordeste,FIOCRUZ/ASTRAZENECA,1347,1234,113
Dirceu Arcoverde,220335,PI,Nordeste,BUTANTAN/SINOVAC,1245,657,588
Divina Pastora,280200,SE,Nordeste,BUTANTAN/SINOVAC,1261,717,544
Divina Pastora,280200,SE,Nordeste,FIOCRUZ/ASTRAZENECA,943,904,39
Divina Pastora,280200,SE,Nordeste,PFIZER/BIONTECH,109,109,0
Divinésia,312190,MG,Sudeste,FIOCRUZ/ASTRAZENECA,982,929,53
Divinésia,312190,MG,Sudeste,BUTANTAN/SINOVAC,751,386,365
Divinésia,312190,MG,Sudeste,PFIZER/BIONTECH,64,64,0
Divino,312200,MG,Sudeste,FIOCRUZ/ASTRAZENECA,4935,4453,482
Divino,312200,MG,Sudeste,BUTANTAN/SINOVAC,3694,1897,1797
Divino,312200,MG,Sudeste,PFIZER/BIONTECH,358,358,0
Divino Das Laranjeiras,312210,MG,Sudeste,BUTANTAN/SINOVAC,1363,688,675
Divino Das Laranjeiras,312210,MG,Sudeste,FIOCRUZ/ASTRAZENECA,992,880,112
Divino Das Laranjeiras,312210,MG,Sudeste,PFIZER/BIONTECH,60,60,0
Divino De São Lourenço,320180,ES,Sudeste,FIOCRUZ/ASTRAZENECA,1523,1337,186
Divino De São Lourenço,320180,ES,Sudeste,BUTANTAN/SINOVAC,835,421,414
Divino De São Lourenço,320180,ES,Sudeste,PFIZER/BIONTECH,135,135,0
Divinolândia,351390,SP,Sudeste,BUTANTAN/SINOVAC,3606,1920,1686
Divinolândia,351390,SP,Sudeste,FIOCRUZ/ASTRAZENECA,3578,3041,537
Divinolândia,351390,SP,Sudeste,PFIZER/BIONTECH,93,93,0
Divinolândia De Minas,312220,MG,Sudeste,BUTANTAN/SINOVAC,1653,839,814
Divinolândia De Minas,312220,MG,Sudeste,FIOCRUZ/ASTRAZENECA,1100,954,146
Divinolândia De Minas,312220,MG,Sudeste,PFIZER/BIONTECH,50,50,0
Divinópolis,312230,MG,Sudeste,BUTANTAN/SINOVAC,50916,27354,23562
Divinópolis,312230,MG,Sudeste,FIOCRUZ/ASTRAZENECA,35053,31106,3947
Divinópolis,312230,MG,Sudeste,PFIZER/BIONTECH,1199,1199,0
Divinópolis De Goiás,520830,GO,Centro-Oeste,FIOCRUZ/ASTRAZENECA,2405,2272,133
Divinópolis De Goiás,520830,GO,Centro-Oeste,BUTANTAN/SINOVAC,518,288,230
Divinópolis Do Tocantins,170710,TO,Norte,BUTANTAN/SINOVAC,1386,710,676
Divinópolis Do Tocantins,170710,TO,Norte,FIOCRUZ/ASTRAZENECA,935,897,38
Divisa Alegre,312235,MG,Sudeste,BUTANTAN/SINOVAC,997,583,414
Divisa Alegre,312235,MG,Sudeste,FIOCRUZ/ASTRAZENECA,617,525,92
Divisa Nova,312240,MG,Sudeste,BUTANTAN/SINOVAC,1373,687,686
Divisa Nova,312240,MG,Sudeste,FIOCRUZ/ASTRAZENECA,1343,1212,131
Divisa Nova,312240,MG,Sudeste,PFIZER/BIONTECH,49,49,0
Divisópolis,312245,MG,Sudeste,BUTANTAN/SINOVAC,2329,1213,1116
Divisópolis,312245,MG,Sudeste,FIOCRUZ/ASTRAZENECA,2033,1828,205
Divisópolis,312245,MG,Sudeste,PFIZER/BIONTECH,49,49,0
Dobrada,351400,SP,Sudeste,FIOCRUZ/ASTRAZENECA,1442,1310,132
Dobrada,351400,SP,Sudeste,BUTANTAN/SINOVAC,1437,724,713
Dobrada,351400,SP,Sudeste,PFIZER/BIONTECH,234,233,1
Dois Córregos,351410,SP,Sudeste,BUTANTAN/SINOVAC,5758,3079,2679
Dois Córregos,351410,SP,Sudeste,FIOCRUZ/ASTRAZENECA,5637,5144,493
Dois Córregos,351410,SP,Sudeste,PFIZER/BIONTECH,416,416,0
Dois Irmãos,430640,RS,Sul,FIOCRUZ/ASTRAZENECA,6425,6022,403
Dois Irmãos,430640,RS,Sul,BUTANTAN/SINOVAC,6176,3246,2930
Dois Irmãos,430640,RS,Sul,PFIZER/BIONTECH,847,847,0
Dois Irmãos Das Missões,430642,RS,Sul,BUTANTAN/SINOVAC,579,300,279
Dois Irmãos Das Missões,430642,RS,Sul,FIOCRUZ/ASTRAZENECA,552,513,39
Dois Irmãos Das Missões,430642,RS,Sul,PFIZER/BIONTECH,52,52,0
Dois Irmãos Do Buriti,500348,MS,Centro-Oeste,BUTANTAN/SINOVAC,5146,2835,2311
Dois Irmãos Do Buriti,500348,MS,Centro-Oeste,FIOCRUZ/ASTRAZENECA,1606,1314,292
Dois Irmãos Do Buriti,500348,MS,Centro-Oeste,PFIZER/BIONTECH,173,173,0
Dois Irmãos Do Tocantins,170720,TO,Norte,BUTANTAN/SINOVAC,1361,760,601
Dois Irmãos Do Tocantins,170720,TO,Norte,FIOCRUZ/ASTRAZENECA,1019,967,52
Dois Lajeados,430645,RS,Sul,BUTANTAN/SINOVAC,1346,682,664
Dois Lajeados,430645,RS,Sul,FIOCRUZ/ASTRAZENECA,1082,978,104
Dois Lajeados,430645,RS,Sul,PFIZER/BIONTECH,145,143,2
Dois Riachos,270250,AL,Nordeste,FIOCRUZ/ASTRAZENECA,1951,1664,287
Dois Riachos,270250,AL,Nordeste,BUTANTAN/SINOVAC,1767,993,774
Dois Vizinhos,410720,PR,Sul,FIOCRUZ/ASTRAZENECA,9117,8548,569
Dois Vizinhos,410720,PR,Sul,BUTANTAN/SINOVAC,6563,3320,3243
Dois Vizinhos,410720,PR,Sul,PFIZER/BIONTECH,1333,1332,1
Dolcinópolis,351420,SP,Sudeste,BUTANTAN/SINOVAC,709,380,329
Dolcinópolis,351420,SP,Sudeste,FIOCRUZ/ASTRAZENECA,643,568,75
Dolcinópolis,351420,SP,Sudeste,PFIZER/BIONTECH,66,66,0
Dom Aquino,510360,MT,Centro-Oeste,BUTANTAN/SINOVAC,2101,1171,930
Dom Aquino,510360,MT,Centro-Oeste,FIOCRUZ/ASTRAZENECA,1919,1794,125
Dom Aquino,510360,MT,Centro-Oeste,PFIZER/BIONTECH,53,53,0
Dom Basílio,291010,BA,Nordeste,FIOCRUZ/ASTRAZENECA,3126,2694,432
Dom Basílio,291010,BA,Nordeste,BUTANTAN/SINOVAC,2688,1419,1269
Dom Basílio,291010,BA,Nordeste,PFIZER/BIONTECH,242,241,1
Dom Bosco,312247,MG,Sudeste,BUTANTAN/SINOVAC,963,492,471
Dom Bosco,312247,MG,Sudeste,FIOCRUZ/ASTRAZENECA,873,801,72
Dom Bosco,312247,MG,Sudeste,PFIZER/BIONTECH,45,45,0
Dom Cavati,312250,MG,Sudeste,BUTANTAN/SINOVAC,1485,763,722
Dom Cavati,312250,MG,Sudeste,FIOCRUZ/ASTRAZENECA,1480,1322,158
Dom Cavati,312250,MG,Sudeste,PFIZER/BIONTECH,76,76,0
Dom Eliseu,150293,PA,Norte,FIOCRUZ/ASTRAZENECA,5440,4999,441
Dom Eliseu,150293,PA,Norte,BUTANTAN/SINOVAC,4598,2411,2187
Dom Expedito Lopes,220340,PI,Nordeste,FIOCRUZ/ASTRAZENECA,1396,1137,259
Dom Expedito Lopes,220340,PI,Nordeste,BUTANTAN/SINOVAC,1105,597,508
Dom Feliciano,430650,RS,Sul,BUTANTAN/SINOVAC,3758,2013,1745
Dom Feliciano,430650,RS,Sul,FIOCRUZ/ASTRAZENECA,2783,2572,211
Dom Feliciano,430650,RS,Sul,PFIZER/BIONTECH,588,588,0
Dom Inocêncio,220345,PI,Nordeste,FIOCRUZ/ASTRAZENECA,1846,1723,123
Dom Inocêncio,220345,PI,Nordeste,BUTANTAN/SINOVAC,1618,832,786
Dom Joaquim,312260,MG,Sudeste,BUTANTAN/SINOVAC,1233,654,579
Dom Joaquim,312260,MG,Sudeste,FIOCRUZ/ASTRAZENECA,829,716,113
Dom Joaquim,312260,MG,Sudeste,PFIZER/BIONTECH,83,83,0
Dom Macedo Costa,291020,BA,Nordeste,FIOCRUZ/ASTRAZENECA,1004,918,86
Dom Macedo Costa,291020,BA,Nordeste,BUTANTAN/SINOVAC,964,485,479
Dom Macedo Costa,291020,BA,Nordeste,PFIZER/BIONTECH,106,106,0
Dom Pedrito,430660,RS,Sul,FIOCRUZ/ASTRAZENECA,10578,9385,1193
Dom Pedrito,430660,RS,Sul,BUTANTAN/SINOVAC,9668,4945,4723
Dom Pedrito,430660,RS,Sul,PFIZER/BIONTECH,1503,1502,1
Dom Pedro,210380,MA,Nordeste,FIOCRUZ/ASTRAZENECA,5173,4565,608
Dom Pedro,210380,MA,Nordeste,BUTANTAN/SINOVAC,4718,2503,2215
Dom Pedro De Alcântara,430655,RS,Sul,BUTANTAN/SINOVAC,1116,585,531
Dom Pedro De Alcântara,430655,RS,Sul,FIOCRUZ/ASTRAZENECA,684,638,46
Dom Pedro De Alcântara,430655,RS,Sul,PFIZER/BIONTECH,98,98,0
Dom Silvério,312270,MG,Sudeste,FIOCRUZ/ASTRAZENECA,1373,1259,114
Dom Silvério,312270,MG,Sudeste,BUTANTAN/SINOVAC,1166,601,565
Dom Silvério,312270,MG,Sudeste,PFIZER/BIONTECH,33,33,0
Dom Viçoso,312280,MG,Sudeste,FIOCRUZ/ASTRAZENECA,1175,1101,74
Dom Viçoso,312280,MG,Sudeste,BUTANTAN/SINOVAC,809,416,393
Dom Viçoso,312280,MG,Sudeste,PFIZER/BIONTECH,89,89,0
Domingos Martins,320190,ES,Sudeste,BUTANTAN/SINOVAC,9404,4988,4416
Domingos Martins,320190,ES,Sudeste,FIOCRUZ/ASTRAZENECA,7784,7554,230
Domingos Martins,320190,ES,Sudeste,PFIZER/BIONTECH,1036,1034,2
Domingos Mourão,220342,PI,Nordeste,BUTANTAN/SINOVAC,790,442,348
Domingos Mourão,220342,PI,Nordeste,FIOCRUZ/ASTRAZENECA,633,570,63
Dona Emma,420510,SC,Sul,BUTANTAN/SINOVAC,907,458,449
Dona Emma,420510,SC,Sul,FIOCRUZ/ASTRAZENECA,874,816,58
Dona Emma,420510,SC,Sul,PFIZER/BIONTECH,73,73,0
Dona Euzebia,312290,MG,Sudeste,BUTANTAN/SINOVAC,1256,641,615
Dona Euzebia,312290,MG,Sudeste,FIOCRUZ/ASTRAZENECA,958,867,91
Dona Francisca,430670,RS,Sul,FIOCRUZ/ASTRAZENECA,1190,1106,84
Dona Francisca,430670,RS,Sul,BUTANTAN/SINOVAC,897,512,385
Dona Francisca,430670,RS,Sul,PFIZER/BIONTECH,47,46,1
Dona Inês,250570,PB,Nordeste,BUTANTAN/SINOVAC,2440,1228,1212
Dona Inês,250570,PB,Nordeste,FIOCRUZ/ASTRAZENECA,2045,1859,186
Dona Inês,250570,PB,Nordeste,PFIZER/BIONTECH,116,116,0
Dores De Campos,312300,MG,Sudeste,FIOCRUZ/ASTRAZENECA,3150,3071,79
Dores De Campos,312300,MG,Sudeste,BUTANTAN/SINOVAC,2037,1089,948
Dores De Campos,312300,MG,Sudeste,PFIZER/BIONTECH,21,21,0
Dores De Guanhães,312310,MG,Sudeste,BUTANTAN/SINOVAC,1335,852,483
Dores De Guanhães,312310,MG,Sudeste,FIOCRUZ/ASTRAZENECA,930,877,53
Dores De Guanhães,312310,MG,Sudeste,PFIZER/BIONTECH,46,46,0
Dores Do Indaiá,312320,MG,Sudeste,BUTANTAN/SINOVAC,4150,2141,2009
Dores Do Indaiá,312320,MG,Sudeste,FIOCRUZ/ASTRAZENECA,3560,3243,317
Dores Do Indaiá,312320,MG,Sudeste,PFIZER/BIONTECH,134,134,0
Dores Do Rio Preto,320200,ES,Sudeste,BUTANTAN/SINOVAC,1506,854,652
Dores Do Rio Preto,320200,ES,Sudeste,FIOCRUZ/ASTRAZENECA,1204,1150,54
Dores Do Rio Preto,320200,ES,Sudeste,PFIZER/BIONTECH,119,119,0
Dores Do Turvo,312330,MG,Sudeste,FIOCRUZ/ASTRAZENECA,1174,1088,86
Dores Do Turvo,312330,MG,Sudeste,BUTANTAN/SINOVAC,1034,547,487
Dores Do Turvo,312330,MG,Sudeste,PFIZER/BIONTECH,67,67,0
Doresópolis,312340,MG,Sudeste,BUTANTAN/SINOVAC,460,237,223
Doresópolis,312340,MG,Sudeste,FIOCRUZ/ASTRAZENECA,413,360,53
Doresópolis,312340,MG,Sudeste,PFIZER/BIONTECH,16,16,0
Dormentes,260515,PE,Nordeste,FIOCRUZ/ASTRAZENECA,3748,3406,342
Dormentes,260515,PE,Nordeste,BUTANTAN/SINOVAC,3237,1640,1597
Dormentes,260515,PE,Nordeste,PFIZER/BIONTECH,466,466,0
Douradina,410725,PR,Sul,FIOCRUZ/ASTRAZENECA,2589,2474,115
Douradina,410725,PR,Sul,BUTANTAN/SINOVAC,1606,825,781
Douradina,410725,PR,Sul,PFIZER/BIONTECH,23,23,0
Douradina,500350,MS,Centro-Oeste,BUTANTAN/SINOVAC,2106,1088,1018
Douradina,500350,MS,Centro-Oeste,FIOCRUZ/ASTRAZENECA,1513,1206,307
Douradina,500350,MS,Centro-Oeste,PFIZER/BIONTECH,198,197,1
Dourado,351430,SP,Sudeste,FIOCRUZ/ASTRAZENECA,2506,2277,229
Dourado,351430,SP,Sudeste,BUTANTAN/SINOVAC,2112,1172,940
Dourado,351430,SP,Sudeste,PFIZER/BIONTECH,168,168,0
Douradoquara,312350,MG,Sudeste,BUTANTAN/SINOVAC,584,295,289
Douradoquara,312350,MG,Sudeste,FIOCRUZ/ASTRAZENECA,531,469,62
Douradoquara,312350,MG,Sudeste,PFIZER/BIONTECH,35,35,0
Dourados,500370,MS,Centro-Oeste,BUTANTAN/SINOVAC,68026,36840,31186
Dourados,500370,MS,Centro-Oeste,FIOCRUZ/ASTRAZENECA,52063,48010,4053
Dourados,500370,MS,Centro-Oeste,PFIZER/BIONTECH,7393,7384,9
Doutor Camargo,410730,PR,Sul,FIOCRUZ/ASTRAZENECA,2198,2063,135
Doutor Camargo,410730,PR,Sul,BUTANTAN/SINOVAC,1765,902,863
Doutor Maurício Cardoso,430673,RS,Sul,BUTANTAN/SINOVAC,2059,1138,921
Doutor Maurício Cardoso,430673,RS,Sul,FIOCRUZ/ASTRAZENECA,1086,928,158
Doutor Maurício Cardoso,430673,RS,Sul,PFIZER/BIONTECH,84,83,1
Doutor Pedrinho,420515,SC,Sul,BUTANTAN/SINOVAC,954,526,428
Doutor Pedrinho,420515,SC,Sul,FIOCRUZ/ASTRAZENECA,824,815,9
Doutor Ricardo,430675,RS,Sul,BUTANTAN/SINOVAC,704,354,350
Doutor Ricardo,430675,RS,Sul,FIOCRUZ/ASTRAZENECA,660,610,50
Doutor Ricardo,430675,RS,Sul,PFIZER/BIONTECH,87,87,0
Doutor Severiano,240320,RN,Nordeste,BUTANTAN/SINOVAC,1989,1011,978
Doutor Severiano,240320,RN,Nordeste,FIOCRUZ/ASTRAZENECA,1647,1550,97
Doutor Severiano,240320,RN,Nordeste,PFIZER/BIONTECH,174,174,0
Doutor Ulysses,412863,PR,Sul,BUTANTAN/SINOVAC,1115,588,527
Doutor Ulysses,412863,PR,Sul,FIOCRUZ/ASTRAZENECA,892,861,31
Doverlândia,520725,GO,Centro-Oeste,BUTANTAN/SINOVAC,1450,761,689
Doverlândia,520725,GO,Centro-Oeste,FIOCRUZ/ASTRAZENECA,1375,1277,98
Doverlândia,520725,GO,Centro-Oeste,PFIZER/BIONTECH,94,94,0
Dracena,351440,SP,Sudeste,FIOCRUZ/ASTRAZENECA,13048,11775,1273
Dracena,351440,SP,Sudeste,BUTANTAN/SINOVAC,12550,6566,5984
Dracena,351440,SP,Sudeste,PFIZER/BIONTECH,925,925,0
Duartina,351450,SP,Sudeste,BUTANTAN/SINOVAC,3489,1791,1698
Duartina,351450,SP,Sudeste,FIOCRUZ/ASTRAZENECA,3411,3065,346
Duartina,351450,SP,Sudeste,PFIZER/BIONTECH,126,126,0
Duas Barras,330160,RJ,Sudeste,BUTANTAN/SINOVAC,873,439,434
Duas Barras,330160,RJ,Sudeste,FIOCRUZ/ASTRAZENECA,303,223,80
Duas Estradas,250580,PB,Nordeste,BUTANTAN/SINOVAC,857,435,422
Duas Estradas,250580,PB,Nordeste,FIOCRUZ/ASTRAZENECA,841,762,79
Duas Estradas,250580,PB,Nordeste,PFIZER/BIONTECH,24,24,0
Dueré,170730,TO,Norte,BUTANTAN/SINOVAC,1097,576,521
Dueré,170730,TO,Norte,FIOCRUZ/ASTRAZENECA,1057,982,75
Dumont,351460,SP,Sudeste,FIOCRUZ/ASTRAZENECA,1942,1829,113
Dumont,351460,SP,Sudeste,BUTANTAN/SINOVAC,1548,831,717
Dumont,351460,SP,Sudeste,PFIZER/BIONTECH,142,142,0
Duque Bacelar,210390,MA,Nordeste,FIOCRUZ/ASTRAZENECA,1165,1065,100
Duque Bacelar,210390,MA,Nordeste,BUTANTAN/SINOVAC,1045,587,458
Duque De Caxias,330170,RJ,Sudeste,BUTANTAN/SINOVAC,141890,76563,65327
Duque De Caxias,330170,RJ,Sudeste,FIOCRUZ/ASTRAZENECA,99168,92670,6498
Duque De Caxias,330170,RJ,Sudeste,PFIZER/BIONTECH,13125,13100,25
Durandé,312352,MG,Sudeste,FIOCRUZ/ASTRAZENECA,1612,1519,93
Durandé,312352,MG,Sudeste,BUTANTAN/SINOVAC,1194,599,595
Durandé,312352,MG,Sudeste,PFIZER/BIONTECH,89,89,0
Echaporã,351470,SP,Sudeste,BUTANTAN/SINOVAC,2089,947,1142
Echaporã,351470,SP,Sudeste,FIOCRUZ/ASTRAZENECA,1757,1558,199
Echaporã,351470,SP,Sudeste,PFIZER/BIONTECH,113,113,0
Ecoporanga,320210,ES,Sudeste,BUTANTAN/SINOVAC,6216,3298,2918
Ecoporanga,320210,ES,Sudeste,FIOCRUZ/ASTRAZENECA,5156,4929,227
Ecoporanga,320210,ES,Sudeste,PFIZER/BIONTECH,700,699,1
Edealina,520735,GO,Centro-Oeste,BUTANTAN/SINOVAC,931,507,424
Edealina,520735,GO,Centro-Oeste,FIOCRUZ/ASTRAZENECA,333,300,33
Edéia,520740,GO,Centro-Oeste,FIOCRUZ/ASTRAZENECA,3355,3110,245
Edéia,520740,GO,Centro-Oeste,BUTANTAN/SINOVAC,2586,1426,1160
Edéia,520740,GO,Centro-Oeste,PFIZER/BIONTECH,185,185,0
Eirunepé,130140,AM,Norte,BUTANTAN/SINOVAC,3406,1957,1449
Eirunepé,130140,AM,Norte,FIOCRUZ/ASTRAZENECA,3249,2627,622
Eldorado,351480,SP,Sudeste,BUTANTAN/SINOVAC,5608,2817,2791
Eldorado,351480,SP,Sudeste,FIOCRUZ/ASTRAZENECA,3631,3115,516
Eldorado,351480,SP,Sudeste,PFIZER/BIONTECH,52,52,0
Eldorado,500375,MS,Centro-Oeste,BUTANTAN/SINOVAC,3153,1669,1484
Eldorado,500375,MS,Centro-Oeste,FIOCRUZ/ASTRAZENECA,2673,2547,126
Eldorado,500375,MS,Centro-Oeste,PFIZER/BIONTECH,277,277,0
Eldorado Do Carajás,150295,PA,Norte,FIOCRUZ/ASTRAZENECA,2714,2447,267
Eldorado Do Carajás,150295,PA,Norte,BUTANTAN/SINOVAC,956,511,445
Eldorado Do Sul,430676,RS,Sul,BUTANTAN/SINOVAC,6782,3641,3141
Eldorado Do Sul,430676,RS,Sul,FIOCRUZ/ASTRAZENECA,6231,5891,340
Eldorado Do Sul,430676,RS,Sul,PFIZER/BIONTECH,255,255,0
Elesbão Veloso,220350,PI,Nordeste,BUTANTAN/SINOVAC,2619,1557,1062
Elesbão Veloso,220350,PI,Nordeste,FIOCRUZ/ASTRAZENECA,1439,1273,166
Elias Fausto,351490,SP,Sudeste,FIOCRUZ/ASTRAZENECA,4088,3852,236
Elias Fausto,351490,SP,Sudeste,BUTANTAN/SINOVAC,3000,1549,1451
Elias Fausto,351490,SP,Sudeste,PFIZER/BIONTECH,226,226,0
Eliseu Martins,220360,PI,Nordeste,BUTANTAN/SINOVAC,981,499,482
Eliseu Martins,220360,PI,Nordeste,FIOCRUZ/ASTRAZENECA,931,840,91
Eliseu Martins,220360,PI,Nordeste,PFIZER/BIONTECH,35,35,0
Elisiário,351492,SP,Sudeste,FIOCRUZ/ASTRAZENECA,895,816,79
Elisiário,351492,SP,Sudeste,BUTANTAN/SINOVAC,858,436,422
Elisiário,351492,SP,Sudeste,PFIZER/BIONTECH,25,25,0
Elísio Medrado,291030,BA,Nordeste,FIOCRUZ/ASTRAZENECA,2091,1779,312
Elísio Medrado,291030,BA,Nordeste,BUTANTAN/SINOVAC,1986,1042,944
Elísio Medrado,291030,BA,Nordeste,PFIZER/BIONTECH,339,339,0
Elói Mendes,312360,MG,Sudeste,BUTANTAN/SINOVAC,5273,2650,2623
Elói Mendes,312360,MG,Sudeste,FIOCRUZ/ASTRAZENECA,4471,4063,408
Elói Mendes,312360,MG,Sudeste,PFIZER/BIONTECH,383,383,0
Emas,250590,PB,Nordeste,BUTANTAN/SINOVAC,733,394,339
Emas,250590,PB,Nordeste,FIOCRUZ/ASTRAZENECA,543,486,57
Emas,250590,PB,Nordeste,PFIZER/BIONTECH,26,26,0
Embaúba,351495,SP,Sudeste,FIOCRUZ/ASTRAZENECA,744,670,74
Embaúba,351495,SP,Sudeste,BUTANTAN/SINOVAC,682,326,356
Embaúba,351495,SP,Sudeste,PFIZER/BIONTECH,52,52,0
Embu,351500,SP,Sudeste,FIOCRUZ/ASTRAZENECA,49065,46401,2664
Embu,351500,SP,Sudeste,BUTANTAN/SINOVAC,35526,19007,16519
Embu,351500,SP,Sudeste,PFIZER/BIONTECH,2804,2804,0
Embu-Guaçu,351510,SP,Sudeste,BUTANTAN/SINOVAC,11710,6585,5125
Embu-Guaçu,351510,SP,Sudeste,FIOCRUZ/ASTRAZENECA,10768,9966,802
Embu-Guaçu,351510,SP,Sudeste,PFIZER/BIONTECH,408,408,0
Emilianópolis,351512,SP,Sudeste,BUTANTAN/SINOVAC,1324,748,576
Emilianópolis,351512,SP,Sudeste,FIOCRUZ/ASTRAZENECA,1202,1081,121
Emilianópolis,351512,SP,Sudeste,PFIZER/BIONTECH,97,97,0
Encantado,430680,RS,Sul,BUTANTAN/SINOVAC,6520,3338,3182
Encantado,430680,RS,Sul,FIOCRUZ/ASTRAZENECA,5211,4693,518
Encantado,430680,RS,Sul,PFIZER/BIONTECH,527,527,0
Encanto,240330,RN,Nordeste,BUTANTAN/SINOVAC,1232,673,559
Encanto,240330,RN,Nordeste,FIOCRUZ/ASTRAZENECA,1203,1118,85
Encanto,240330,RN,Nordeste,PFIZER/BIONTECH,148,148,0
Encruzilhada,291040,BA,Nordeste,BUTANTAN/SINOVAC,3659,1955,1704
Encruzilhada,291040,BA,Nordeste,FIOCRUZ/ASTRAZENECA,3519,3050,469
Encruzilhada,291040,BA,Nordeste,PFIZER/BIONTECH,306,306,0
Encruzilhada Do Sul,430690,RS,Sul,BUTANTAN/SINOVAC,6806,3460,3346
Encruzilhada Do Sul,430690,RS,Sul,FIOCRUZ/ASTRAZENECA,4088,3575,513
Encruzilhada Do Sul,430690,RS,Sul,PFIZER/BIONTECH,407,407,0
Enéas Marques,410740,PR,Sul,FIOCRUZ/ASTRAZENECA,1542,1441,101
Enéas Marques,410740,PR,Sul,BUTANTAN/SINOVAC,1169,616,553
Enéas Marques,410740,PR,Sul,PFIZER/BIONTECH,29,29,0
Engenheiro Beltrão,410750,PR,Sul,FIOCRUZ/ASTRAZENECA,3173,3046,127
Engenheiro Beltrão,410750,PR,Sul,BUTANTAN/SINOVAC,2940,1507,1433
Engenheiro Caldas,312370,MG,Sudeste,BUTANTAN/SINOVAC,1961,988,973
Engenheiro Caldas,312370,MG,Sudeste,FIOCRUZ/ASTRAZENECA,1618,1446,172
Engenheiro Caldas,312370,MG,Sudeste,PFIZER/BIONTECH,75,75,0
Engenheiro Coelho,351515,SP,Sudeste,FIOCRUZ/ASTRAZENECA,3718,3543,175
Engenheiro Coelho,351515,SP,Sudeste,BUTANTAN/SINOVAC,3371,2128,1243
Engenheiro Coelho,351515,SP,Sudeste,PFIZER/BIONTECH,392,392,0
Engenheiro Navarro,312380,MG,Sudeste,BUTANTAN/SINOVAC,1565,993,572
Engenheiro Navarro,312380,MG,Sudeste,FIOCRUZ/ASTRAZENECA,1157,1035,122
Engenheiro Navarro,312380,MG,Sudeste,PFIZER/BIONTECH,2,2,0
Engenheiro Paulo De Frontin,330180,RJ,Sudeste,BUTANTAN/SINOVAC,3786,1984,1802
Engenheiro Paulo De Frontin,330180,RJ,Sudeste,FIOCRUZ/ASTRAZENECA,3203,2859,344
Engenheiro Paulo De Frontin,330180,RJ,Sudeste,PFIZER/BIONTECH,43,43,0
Engenho Velho,430692,RS,Sul,BUTANTAN/SINOVAC,939,479,460
Engenho Velho,430692,RS,Sul,FIOCRUZ/ASTRAZENECA,316,268,48
Engenho Velho,430692,RS,Sul,PFIZER/BIONTECH,42,42,0
Entre Folhas,312385,MG,Sudeste,FIOCRUZ/ASTRAZENECA,1374,1239,135
Entre Folhas,312385,MG,Sudeste,BUTANTAN/SINOVAC,1324,674,650
Entre Folhas,312385,MG,Sudeste,PFIZER/BIONTECH,82,82,0
Entre Rios,291050,BA,Nordeste,FIOCRUZ/ASTRAZENECA,5977,5609,368
Entre Rios,291050,BA,Nordeste,BUTANTAN/SINOVAC,4881,2508,2373
Entre Rios,291050,BA,Nordeste,PFIZER/BIONTECH,448,448,0
Entre Rios,420517,SC,Sul,FIOCRUZ/ASTRAZENECA,580,520,60
Entre Rios,420517,SC,Sul,BUTANTAN/SINOVAC,567,283,284
Entre Rios De Minas,312390,MG,Sudeste,BUTANTAN/SINOVAC,3955,1994,1961
Entre Rios De Minas,312390,MG,Sudeste,FIOCRUZ/ASTRAZENECA,3576,3212,364
Entre Rios De Minas,312390,MG,Sudeste,PFIZER/BIONTECH,216,216,0
Entre Rios Do Oeste,410753,PR,Sul,FIOCRUZ/ASTRAZENECA,1213,1133,80
Entre Rios Do Oeste,410753,PR,Sul,BUTANTAN/SINOVAC,1024,517,507
Entre Rios Do Sul,430695,RS,Sul,BUTANTAN/SINOVAC,1045,522,523
Entre Rios Do Sul,430695,RS,Sul,FIOCRUZ/ASTRAZENECA,844,760,84
Entre Rios Do Sul,430695,RS,Sul,PFIZER/BIONTECH,133,132,1
Entre-Ijuís,430693,RS,Sul,BUTANTAN/SINOVAC,2599,1341,1258
Entre-Ijuís,430693,RS,Sul,FIOCRUZ/ASTRAZENECA,2330,2134,196
Entre-Ijuís,430693,RS,Sul,PFIZER/BIONTECH,158,158,0
Envira,130150,AM,Norte,FIOCRUZ/ASTRAZENECA,1682,1446,236
Envira,130150,AM,Norte,BUTANTAN/SINOVAC,1660,1255,405
Epitaciolândia,120025,AC,Norte,FIOCRUZ/ASTRAZENECA,3241,2968,273
Epitaciolândia,120025,AC,Norte,BUTANTAN/SINOVAC,2335,1259,1076
Equador,240340,RN,Nordeste,FIOCRUZ/ASTRAZENECA,1689,1558,131
Equador,240340,RN,Nordeste,BUTANTAN/SINOVAC,1657,827,830
Equador,240340,RN,Nordeste,PFIZER/BIONTECH,79,79,0
Erebango,430697,RS,Sul,BUTANTAN/SINOVAC,1188,603,585
Erebango,430697,RS,Sul,FIOCRUZ/ASTRAZENECA,732,655,77
Erebango,430697,RS,Sul,PFIZER/BIONTECH,89,89,0
Erechim,430700,RS,Sul,FIOCRUZ/ASTRAZENECA,29502,26210,3292
Erechim,430700,RS,Sul,BUTANTAN/SINOVAC,28816,14619,14197
Erechim,430700,RS,Sul,PFIZER/BIONTECH,3634,3634,0
Ererê,230427,CE,Nordeste,BUTANTAN/SINOVAC,1549,786,763
Ererê,230427,CE,Nordeste,FIOCRUZ/ASTRAZENECA,598,459,139
Érico Cardoso,290050,BA,Nordeste,BUTANTAN/SINOVAC,2970,1704,1266
Érico Cardoso,290050,BA,Nordeste,FIOCRUZ/ASTRAZENECA,2517,2433,84
Érico Cardoso,290050,BA,Nordeste,PFIZER/BIONTECH,24,24,0
Ermo,420519,SC,Sul,BUTANTAN/SINOVAC,666,387,279
Ermo,420519,SC,Sul,FIOCRUZ/ASTRAZENECA,620,560,60
Ernestina,430705,RS,Sul,FIOCRUZ/ASTRAZENECA,1078,956,122
Ernestina,430705,RS,Sul,BUTANTAN/SINOVAC,830,415,415
Ernestina,430705,RS,Sul,PFIZER/BIONTECH,132,132,0
Erval Grande,430720,RS,Sul,BUTANTAN/SINOVAC,1593,871,722
Erval Grande,430720,RS,Sul,FIOCRUZ/ASTRAZENECA,1355,1173,182
Erval Grande,430720,RS,Sul,PFIZER/BIONTECH,119,119,0
Erval Seco,430730,RS,Sul,BUTANTAN/SINOVAC,2782,1444,1338
Erval Seco,430730,RS,Sul,FIOCRUZ/ASTRAZENECA,1635,1564,71
Erval Seco,430730,RS,Sul,PFIZER/BIONTECH,123,123,0
Erval Velho,420520,SC,Sul,BUTANTAN/SINOVAC,1403,782,621
Erval Velho,420520,SC,Sul,FIOCRUZ/ASTRAZENECA,1144,1050,94
Erval Velho,420520,SC,Sul,PFIZER/BIONTECH,114,114,0
Ervália,312400,MG,Sudeste,FIOCRUZ/ASTRAZENECA,3957,3633,324
Ervália,312400,MG,Sudeste,BUTANTAN/SINOVAC,3780,1904,1876
Ervália,312400,MG,Sudeste,PFIZER/BIONTECH,267,267,0
Escada,260520,PE,Nordeste,FIOCRUZ/ASTRAZENECA,10706,10129,577
Escada,260520,PE,Nordeste,BUTANTAN/SINOVAC,7860,4363,3497
Escada,260520,PE,Nordeste,PFIZER/BIONTECH,357,357,0
Esmeralda,430740,RS,Sul,BUTANTAN/SINOVAC,929,476,453
Esmeralda,430740,RS,Sul,FIOCRUZ/ASTRAZENECA,842,782,60
Esmeralda,430740,RS,Sul,PFIZER/BIONTECH,113,113,0
Esmeraldas,312410,MG,Sudeste,BUTANTAN/SINOVAC,8475,4879,3596
Esmeraldas,312410,MG,Sudeste,FIOCRUZ/ASTRAZENECA,4192,3745,447
Esmeraldas,312410,MG,Sudeste,PFIZER/BIONTECH,12,12,0
Espera Feliz,312420,MG,Sudeste,BUTANTAN/SINOVAC,4512,2250,2262
Espera Feliz,312420,MG,Sudeste,FIOCRUZ/ASTRAZENECA,4488,4214,274
Espera Feliz,312420,MG,Sudeste,PFIZER/BIONTECH,377,377,0
Esperança,250600,PB,Nordeste,BUTANTAN/SINOVAC,5342,2806,2536
Esperança,250600,PB,Nordeste,FIOCRUZ/ASTRAZENECA,4595,4178,417
Esperança,250600,PB,Nordeste,PFIZER/BIONTECH,189,189,0
Esperança Do Sul,430745,RS,Sul,BUTANTAN/SINOVAC,1087,558,529
Esperança Do Sul,430745,RS,Sul,FIOCRUZ/ASTRAZENECA,913,852,61
Esperança Do Sul,430745,RS,Sul,PFIZER/BIONTECH,108,108,0
Esperança Nova,410752,PR,Sul,FIOCRUZ/ASTRAZENECA,729,678,51
Esperança Nova,410752,PR,Sul,BUTANTAN/SINOVAC,622,329,293
Esperança Nova,410752,PR,Sul,PFIZER/BIONTECH,12,12,0
Esperantina,170740,TO,Norte,BUTANTAN/SINOVAC,1177,599,578
Esperantina,170740,TO,Norte,FIOCRUZ/ASTRAZENECA,1106,1046,60
Esperantina,220370,PI,Nordeste,FIOCRUZ/ASTRAZENECA,6970,6444,526
Esperantina,220370,PI,Nordeste,BUTANTAN/SINOVAC,5885,3280,2605
Esperantina,220370,PI,Nordeste,PFIZER/BIONTECH,5,5,0
Esperantinópolis,210400,MA,Nordeste,FIOCRUZ/ASTRAZENECA,4897,4698,199
Esperantinópolis,210400,MA,Nordeste,BUTANTAN/SINOVAC,2810,1493,1317
Espigão Alto Do Iguaçu,410754,PR,Sul,BUTANTAN/SINOVAC,1421,759,662
Espigão Alto Do Iguaçu,410754,PR,Sul,FIOCRUZ/ASTRAZENECA,1226,1149,77
Espigão Alto Do Iguaçu,410754,PR,Sul,PFIZER/BIONTECH,24,24,0
Espigão D'Oeste,110009,RO,Norte,BUTANTAN/SINOVAC,5581,2894,2687
Espigão D'Oeste,110009,RO,Norte,FIOCRUZ/ASTRAZENECA,3070,2889,181
Espigão D'Oeste,110009,RO,Norte,PFIZER/BIONTECH,393,393,0
Espinosa,312430,MG,Sudeste,BUTANTAN/SINOVAC,4117,2125,1992
Espinosa,312430,MG,Sudeste,FIOCRUZ/ASTRAZENECA,1630,1583,47
Espírito Santo,240350,RN,Nordeste,BUTANTAN/SINOVAC,1817,1018,799
Espírito Santo,240350,RN,Nordeste,FIOCRUZ/ASTRAZENECA,1529,1422,107
Espírito Santo,240350,RN,Nordeste,PFIZER/BIONTECH,271,271,0
Espírito Santo Do Dourado,312440,MG,Sudeste,BUTANTAN/SINOVAC,1212,612,600
Espírito Santo Do Dourado,312440,MG,Sudeste,FIOCRUZ/ASTRAZENECA,1124,1039,85
Espírito Santo Do Dourado,312440,MG,Sudeste,PFIZER/BIONTECH,62,62,0
Espírito Santo Do Pinhal,351518,SP,Sudeste,FIOCRUZ/ASTRAZENECA,11809,10593,1216
Espírito Santo Do Pinhal,351518,SP,Sudeste,BUTANTAN/SINOVAC,11012,5789,5223
Espírito Santo Do Pinhal,351518,SP,Sudeste,PFIZER/BIONTECH,833,833,0
Espírito Santo Do Turvo,351519,SP,Sudeste,FIOCRUZ/ASTRAZENECA,1071,1015,56
Espírito Santo Do Turvo,351519,SP,Sudeste,BUTANTAN/SINOVAC,804,408,396
Espírito Santo Do Turvo,351519,SP,Sudeste,PFIZER/BIONTECH,107,107,0
Esplanada,291060,BA,Nordeste,FIOCRUZ/ASTRAZENECA,3936,3667,269
Esplanada,291060,BA,Nordeste,BUTANTAN/SINOVAC,3188,2011,1177
Esplanada,291060,BA,Nordeste,PFIZER/BIONTECH,52,52,0
Espumoso,430750,RS,Sul,FIOCRUZ/ASTRAZENECA,4853,4567,286
Espumoso,430750,RS,Sul,BUTANTAN/SINOVAC,4156,2100,2056
Espumoso,430750,RS,Sul,PFIZER/BIONTECH,407,407,0
Estação,430755,RS,Sul,BUTANTAN/SINOVAC,1843,975,868
Estação,430755,RS,Sul,FIOCRUZ/ASTRAZENECA,1715,1501,214
Estação,430755,RS,Sul,PFIZER/BIONTECH,239,239,0
Estância,280210,SE,Nordeste,BUTANTAN/SINOVAC,10075,5245,4830
Estância,280210,SE,Nordeste,FIOCRUZ/ASTRAZENECA,7091,6597,494
Estância,280210,SE,Nordeste,PFIZER/BIONTECH,32,32,0
Estância Velha,430760,RS,Sul,BUTANTAN/SINOVAC,12463,6383,6080
Estância Velha,430760,RS,Sul,FIOCRUZ/ASTRAZENECA,10422,9757,665
Estância Velha,430760,RS,Sul,PFIZER/BIONTECH,1527,1523,4
Esteio,430770,RS,Sul,BUTANTAN/SINOVAC,25064,12856,12208
Esteio,430770,RS,Sul,FIOCRUZ/ASTRAZENECA,19642,18319,1323
Esteio,430770,RS,Sul,PFIZER/BIONTECH,2476,2475,1
Estiva,312450,MG,Sudeste,BUTANTAN/SINOVAC,2483,1280,1203
Estiva,312450,MG,Sudeste,FIOCRUZ/ASTRAZENECA,1528,1443,85
Estiva Gerbi,355730,SP,Sudeste,FIOCRUZ/ASTRAZENECA,2099,1939,160
Estiva Gerbi,355730,SP,Sudeste,BUTANTAN/SINOVAC,1797,981,816
Estiva Gerbi,355730,SP,Sudeste,PFIZER/BIONTECH,176,176,0
Estreito,210405,MA,Nordeste,FIOCRUZ/ASTRAZENECA,4517,4234,283
Estreito,210405,MA,Nordeste,BUTANTAN/SINOVAC,3947,2056,1891
Estrela,430780,RS,Sul,BUTANTAN/SINOVAC,9625,4858,4767
Estrela,430780,RS,Sul,FIOCRUZ/ASTRAZENECA,7951,7149,802
Estrela,430780,RS,Sul,PFIZER/BIONTECH,350,350,0
Estrela D'Oeste,351520,SP,Sudeste,FIOCRUZ/ASTRAZENECA,3926,3618,308
Estrela D'Oeste,351520,SP,Sudeste,BUTANTAN/SINOVAC,3536,1826,1710
Estrela D'Oeste,351520,SP,Sudeste,PFIZER/BIONTECH,194,194,0
Estrela Dalva,312460,MG,Sudeste,BUTANTAN/SINOVAC,847,436,411
Estrela Dalva,312460,MG,Sudeste,FIOCRUZ/ASTRAZENECA,736,675,61
Estrela Dalva,312460,MG,Sudeste,PFIZER/BIONTECH,109,109,0
Estrela De Alagoas,270255,AL,Nordeste,FIOCRUZ/ASTRAZENECA,3775,3428,347
Estrela De Alagoas,270255,AL,Nordeste,BUTANTAN/SINOVAC,3223,1657,1566
Estrela Do Indaiá,312470,MG,Sudeste,BUTANTAN/SINOVAC,1175,589,586
Estrela Do Indaiá,312470,MG,Sudeste,FIOCRUZ/ASTRAZENECA,897,809,88
Estrela Do Indaiá,312470,MG,Sudeste,PFIZER/BIONTECH,59,59,0
Estrela Do Norte,351530,SP,Sudeste,FIOCRUZ/ASTRAZENECA,837,777,60
Estrela Do Norte,351530,SP,Sudeste,BUTANTAN/SINOVAC,620,327,293
Estrela Do Norte,351530,SP,Sudeste,PFIZER/BIONTECH,67,67,0
Estrela Do Norte,520750,GO,Centro-Oeste,FIOCRUZ/ASTRAZENECA,1159,1095,64
Estrela Do Norte,520750,GO,Centro-Oeste,BUTANTAN/SINOVAC,561,307,254
Estrela Do Sul,312480,MG,Sudeste,BUTANTAN/SINOVAC,1524,774,750
Estrela Do Sul,312480,MG,Sudeste,FIOCRUZ/ASTRAZENECA,1168,1025,143
Estrela Do Sul,312480,MG,Sudeste,PFIZER/BIONTECH,112,110,2
Estrela Velha,430781,RS,Sul,FIOCRUZ/ASTRAZENECA,873,817,56
Estrela Velha,430781,RS,Sul,BUTANTAN/SINOVAC,838,432,406
Estrela Velha,430781,RS,Sul,PFIZER/BIONTECH,148,148,0
Euclides Da Cunha,291070,BA,Nordeste,BUTANTAN/SINOVAC,14054,7322,6732
Euclides Da Cunha,291070,BA,Nordeste,FIOCRUZ/ASTRAZENECA,11901,10376,1525
Euclides Da Cunha,291070,BA,Nordeste,PFIZER/BIONTECH,2013,2013,0
Euclides Da Cunha Paulista,351535,SP,Sudeste,FIOCRUZ/ASTRAZENECA,2069,1885,184
Euclides Da Cunha Paulista,351535,SP,Sudeste,BUTANTAN/SINOVAC,1787,922,865
Euclides Da Cunha Paulista,351535,SP,Sudeste,PFIZER/BIONTECH,184,184,0
Eugênio De Castro,430783,RS,Sul,BUTANTAN/SINOVAC,930,469,461
Eugênio De Castro,430783,RS,Sul,FIOCRUZ/ASTRAZENECA,697,633,64
Eugênio De Castro,430783,RS,Sul,PFIZER/BIONTECH,125,125,0
Eugenópolis,312490,MG,Sudeste,BUTANTAN/SINOVAC,2675,1407,1268
Eugenópolis,312490,MG,Sudeste,FIOCRUZ/ASTRAZENECA,2581,2396,185
Eugenópolis,312490,MG,Sudeste,PFIZER/BIONTECH,284,283,1
Eunápolis,291072,BA,Nordeste,BUTANTAN/SINOVAC,15033,7931,7102
Eunápolis,291072,BA,Nordeste,FIOCRUZ/ASTRAZENECA,13828,12895,933
Eunápolis,291072,BA,Nordeste,PFIZER/BIONTECH,186,185,1
Eusébio,230428,CE,Nordeste,FIOCRUZ/ASTRAZENECA,12739,12285,454
Eusébio,230428,CE,Nordeste,BUTANTAN/SINOVAC,8779,4614,4165
Eusébio,230428,CE,Nordeste,PFIZER/BIONTECH,1631,1628,3
Ewbank Da Câmara,312500,MG,Sudeste,FIOCRUZ/ASTRAZENECA,1168,1106,62
Ewbank Da Câmara,312500,MG,Sudeste,BUTANTAN/SINOVAC,690,363,327
Ewbank Da Câmara,312500,MG,Sudeste,PFIZER/BIONTECH,71,71,0
Extrema,312510,MG,Sudeste,BUTANTAN/SINOVAC,5276,2772,2504
Extrema,312510,MG,Sudeste,FIOCRUZ/ASTRAZENECA,2634,2495,139
Extrema,312510,MG,Sudeste,PFIZER/BIONTECH,1,1,0
Extremoz,240360,RN,Nordeste,FIOCRUZ/ASTRAZENECA,4971,4594,377
Extremoz,240360,RN,Nordeste,BUTANTAN/SINOVAC,3946,2028,1918
Extremoz,240360,RN,Nordeste,PFIZER/BIONTECH,1253,1252,1
Exu,260530,PE,Nordeste,FIOCRUZ/ASTRAZENECA,6382,5637,745
Exu,260530,PE,Nordeste,BUTANTAN/SINOVAC,5615,2859,2756
Exu,260530,PE,Nordeste,PFIZER/BIONTECH,614,613,1
Fagundes,250610,PB,Nordeste,BUTANTAN/SINOVAC,2281,1316,965
Fagundes,250610,PB,Nordeste,FIOCRUZ/ASTRAZENECA,1604,1498,106
Fagundes,250610,PB,Nordeste,PFIZER/BIONTECH,10,10,0
Fagundes Varela,430786,RS,Sul,FIOCRUZ/ASTRAZENECA,799,711,88
Fagundes Varela,430786,RS,Sul,BUTANTAN/SINOVAC,786,399,387
Fagundes Varela,430786,RS,Sul,PFIZER/BIONTECH,99,99,0
Faina,520753,GO,Centro-Oeste,FIOCRUZ/ASTRAZENECA,2196,2058,138
Faina,520753,GO,Centro-Oeste,BUTANTAN/SINOVAC,1619,876,743
Fama,312520,MG,Sudeste,BUTANTAN/SINOVAC,741,396,345
Fama,312520,MG,Sudeste,FIOCRUZ/ASTRAZENECA,717,677,40
Fama,312520,MG,Sudeste,PFIZER/BIONTECH,31,31,0
Faria Lemos,312530,MG,Sudeste,FIOCRUZ/ASTRAZENECA,900,829,71
Faria Lemos,312530,MG,Sudeste,BUTANTAN/SINOVAC,815,433,382
Faria Lemos,312530,MG,Sudeste,PFIZER/BIONTECH,50,49,1
Farias Brito,230430,CE,Nordeste,BUTANTAN/SINOVAC,4715,2444,2271
Farias Brito,230430,CE,Nordeste,FIOCRUZ/ASTRAZENECA,1862,1441,421
Faro,150300,PA,Norte,FIOCRUZ/ASTRAZENECA,3135,2399,736
Faro,150300,PA,Norte,BUTANTAN/SINOVAC,478,266,212
Farol,410755,PR,Sul,FIOCRUZ/ASTRAZENECA,1298,1227,71
Farol,410755,PR,Sul,BUTANTAN/SINOVAC,703,355,348
Farol,410755,PR,Sul,PFIZER/BIONTECH,16,16,0
Farroupilha,430790,RS,Sul,FIOCRUZ/ASTRAZENECA,19722,17534,2188
Farroupilha,430790,RS,Sul,BUTANTAN/SINOVAC,13056,6630,6426
Farroupilha,430790,RS,Sul,PFIZER/BIONTECH,1791,1791,0
Fartura,351540,SP,Sudeste,BUTANTAN/SINOVAC,4379,2207,2172
Fartura,351540,SP,Sudeste,FIOCRUZ/ASTRAZENECA,3355,3013,342
Fartura,351540,SP,Sudeste,PFIZER/BIONTECH,341,341,0
Fartura Do Piauí,220375,PI,Nordeste,FIOCRUZ/ASTRAZENECA,1695,1613,82
Fartura Do Piauí,220375,PI,Nordeste,BUTANTAN/SINOVAC,1020,533,487
Fátima,170755,TO,Norte,BUTANTAN/SINOVAC,817,425,392
Fátima,170755,TO,Norte,FIOCRUZ/ASTRAZENECA,669,634,35
Fátima,291075,BA,Nordeste,FIOCRUZ/ASTRAZENECA,4393,3804,589
Fátima,291075,BA,Nordeste,BUTANTAN/SINOVAC,4015,2028,1987
Fátima,291075,BA,Nordeste,PFIZER/BIONTECH,251,251,0
Fátima Do Sul,500380,MS,Centro-Oeste,FIOCRUZ/ASTRAZENECA,6247,5415,832
Fátima Do Sul,500380,MS,Centro-Oeste,BUTANTAN/SINOVAC,5539,2916,2623
Fátima Do Sul,500380,MS,Centro-Oeste,PFIZER/BIONTECH,716,715,1
Faxinal,410760,PR,Sul,FIOCRUZ/ASTRAZENECA,4372,4155,217
Faxinal,410760,PR,Sul,BUTANTAN/SINOVAC,3908,2029,1879
Faxinal,410760,PR,Sul,PFIZER/BIONTECH,209,209,0
Faxinal Do Soturno,430800,RS,Sul,BUTANTAN/SINOVAC,2327,1176,1151
Faxinal Do Soturno,430800,RS,Sul,FIOCRUZ/ASTRAZENECA,1986,1752,234
Faxinal Do Soturno,430800,RS,Sul,PFIZER/BIONTECH,116,116,0
Faxinal Dos Guedes,420530,SC,Sul,FIOCRUZ/ASTRAZENECA,2692,2473,219
Faxinal Dos Guedes,420530,SC,Sul,BUTANTAN/SINOVAC,2120,1117,1003
Faxinal Dos Guedes,420530,SC,Sul,PFIZER/BIONTECH,249,249,0
Faxinalzinho,430805,RS,Sul,BUTANTAN/SINOVAC,812,401,411
Faxinalzinho,430805,RS,Sul,FIOCRUZ/ASTRAZENECA,678,638,40
Faxinalzinho,430805,RS,Sul,PFIZER/BIONTECH,83,83,0
Fazenda Nova,520760,GO,Centro-Oeste,FIOCRUZ/ASTRAZENECA,1500,1389,111
Fazenda Nova,520760,GO,Centro-Oeste,BUTANTAN/SINOVAC,1404,737,667
Fazenda Rio Grande,410765,PR,Sul,FIOCRUZ/ASTRAZENECA,16040,15535,505
Fazenda Rio Grande,410765,PR,Sul,BUTANTAN/SINOVAC,11929,6206,5723
Fazenda Rio Grande,410765,PR,Sul,PFIZER/BIONTECH,3284,3283,1
Fazenda Vilanova,430807,RS,Sul,BUTANTAN/SINOVAC,945,471,474
Fazenda Vilanova,430807,RS,Sul,FIOCRUZ/ASTRAZENECA,917,862,55
Fazenda Vilanova,430807,RS,Sul,PFIZER/BIONTECH,81,81,0
Feijó,120030,AC,Norte,FIOCRUZ/ASTRAZENECA,4324,3665,659
Feijó,120030,AC,Norte,BUTANTAN/SINOVAC,4274,2596,1678
Feira Da Mata,291077,BA,Nordeste,FIOCRUZ/ASTRAZENECA,1468,1380,88
Feira Da Mata,291077,BA,Nordeste,BUTANTAN/SINOVAC,1405,729,676
Feira Da Mata,291077,BA,Nordeste,PFIZER/BIONTECH,98,98,0
Feira De Santana,291080,BA,Nordeste,FIOCRUZ/ASTRAZENECA,109630,94678,14952
Feira De Santana,291080,BA,Nordeste,BUTANTAN/SINOVAC,92917,49138,43779
Feira De Santana,291080,BA,Nordeste,PFIZER/BIONTECH,13804,13769,35
Feira Grande,270260,AL,Nordeste,BUTANTAN/SINOVAC,4539,2365,2174
Feira Grande,270260,AL,Nordeste,FIOCRUZ/ASTRAZENECA,4068,3647,421
Feira Grande,270260,AL,Nordeste,PFIZER/BIONTECH,158,158,0
Feira Nova,260540,PE,Nordeste,FIOCRUZ/ASTRAZENECA,5221,4844,377
Feira Nova,260540,PE,Nordeste,BUTANTAN/SINOVAC,3846,2021,1825
Feira Nova,260540,PE,Nordeste,PFIZER/BIONTECH,635,635,0
Feira Nova,280220,SE,Nordeste,BUTANTAN/SINOVAC,1074,545,529
Feira Nova,280220,SE,Nordeste,FIOCRUZ/ASTRAZENECA,769,769,0
Feira Nova,280220,SE,Nordeste,PFIZER/BIONTECH,138,138,0
Feira Nova Do Maranhão,210407,MA,Nordeste,BUTANTAN/SINOVAC,1166,612,554
Feira Nova Do Maranhão,210407,MA,Nordeste,FIOCRUZ/ASTRAZENECA,1053,994,59
Felício Dos Santos,312540,MG,Sudeste,BUTANTAN/SINOVAC,1662,961,701
Felício Dos Santos,312540,MG,Sudeste,FIOCRUZ/ASTRAZENECA,1179,1066,113
Felício Dos Santos,312540,MG,Sudeste,PFIZER/BIONTECH,89,89,0
Felipe Guerra,240370,RN,Nordeste,FIOCRUZ/ASTRAZENECA,1987,1907,80
Felipe Guerra,240370,RN,Nordeste,BUTANTAN/SINOVAC,1748,970,778
Felipe Guerra,240370,RN,Nordeste,PFIZER/BIONTECH,307,307,0
Felisburgo,312560,MG,Sudeste,BUTANTAN/SINOVAC,1778,905,873
Felisburgo,312560,MG,Sudeste,FIOCRUZ/ASTRAZENECA,1262,1107,155
Felisburgo,312560,MG,Sudeste,PFIZER/BIONTECH,65,65,0
Felixlândia,312570,MG,Sudeste,BUTANTAN/SINOVAC,3403,1739,1664
Felixlândia,312570,MG,Sudeste,FIOCRUZ/ASTRAZENECA,3142,2869,273
Felixlândia,312570,MG,Sudeste,PFIZER/BIONTECH,276,276,0
Feliz,430810,RS,Sul,FIOCRUZ/ASTRAZENECA,4212,3727,485
Feliz,430810,RS,Sul,BUTANTAN/SINOVAC,2947,1491,1456
Feliz,430810,RS,Sul,PFIZER/BIONTECH,349,349,0
Feliz Deserto,270270,AL,Nordeste,BUTANTAN/SINOVAC,843,455,388
Feliz Deserto,270270,AL,Nordeste,FIOCRUZ/ASTRAZENECA,813,737,76
Feliz Natal,510370,MT,Centro-Oeste,BUTANTAN/SINOVAC,1529,807,722
Feliz Natal,510370,MT,Centro-Oeste,FIOCRUZ/ASTRAZENECA,1470,1391,79
Feliz Natal,510370,MT,Centro-Oeste,PFIZER/BIONTECH,238,238,0
Fênix,410770,PR,Sul,FIOCRUZ/ASTRAZENECA,1234,1202,32
Fênix,410770,PR,Sul,BUTANTAN/SINOVAC,1198,622,576
Fernandes Pinheiro,410773,PR,Sul,FIOCRUZ/ASTRAZENECA,1312,1247,65
Fernandes Pinheiro,410773,PR,Sul,BUTANTAN/SINOVAC,961,510,451
Fernandes Pinheiro,410773,PR,Sul,PFIZER/BIONTECH,18,18,0
Fernandes Tourinho,312580,MG,Sudeste,BUTANTAN/SINOVAC,858,437,421
Fernandes Tourinho,312580,MG,Sudeste,FIOCRUZ/ASTRAZENECA,518,447,71
Fernandes Tourinho,312580,MG,Sudeste,PFIZER/BIONTECH,51,51,0
Fernando De Noronha,260545,PE,Nordeste,FIOCRUZ/ASTRAZENECA,3409,3163,246
Fernando De Noronha,260545,PE,Nordeste,BUTANTAN/SINOVAC,1040,535,505
Fernando De Noronha,260545,PE,Nordeste,PFIZER/BIONTECH,46,46,0
Fernando Falcão,210408,MA,Nordeste,FIOCRUZ/ASTRAZENECA,1771,1624,147
Fernando Falcão,210408,MA,Nordeste,BUTANTAN/SINOVAC,1318,832,486
Fernando Pedroza,240375,RN,Nordeste,FIOCRUZ/ASTRAZENECA,934,879,55
Fernando Pedroza,240375,RN,Nordeste,BUTANTAN/SINOVAC,833,448,385
Fernando Pedroza,240375,RN,Nordeste,PFIZER/BIONTECH,94,94,0
Fernando Prestes,351560,SP,Sudeste,BUTANTAN/SINOVAC,2006,1014,992
Fernando Prestes,351560,SP,Sudeste,FIOCRUZ/ASTRAZENECA,1784,1604,180
Fernando Prestes,351560,SP,Sudeste,PFIZER/BIONTECH,146,146,0
Fernandópolis,351550,SP,Sudeste,BUTANTAN/SINOVAC,21483,11509,9974
Fernandópolis,351550,SP,Sudeste,FIOCRUZ/ASTRAZENECA,21019,18668,2351
Fernandópolis,351550,SP,Sudeste,PFIZER/BIONTECH,1461,1460,1
Fernão,351565,SP,Sudeste,FIOCRUZ/ASTRAZENECA,935,806,129
Fernão,351565,SP,Sudeste,BUTANTAN/SINOVAC,845,443,402
Fernão,351565,SP,Sudeste,PFIZER/BIONTECH,48,48,0
Ferraz De Vasconcelos,351570,SP,Sudeste,FIOCRUZ/ASTRAZENECA,24876,23132,1744
Ferraz De Vasconcelos,351570,SP,Sudeste,BUTANTAN/SINOVAC,23466,12868,10598
Ferraz De Vasconcelos,351570,SP,Sudeste,PFIZER/BIONTECH,3656,3652,4
Ferreira Gomes,160023,AP,Norte,FIOCRUZ/ASTRAZENECA,1380,1330,50
Ferreira Gomes,160023,AP,Norte,BUTANTAN/SINOVAC,1022,532,490
Ferreira Gomes,160023,AP,Norte,PFIZER/BIONTECH,177,177,0
Ferreiros,260550,PE,Nordeste,FIOCRUZ/ASTRAZENECA,2746,2541,205
Ferreiros,260550,PE,Nordeste,BUTANTAN/SINOVAC,1931,974,957
Ferreiros,260550,PE,Nordeste,PFIZER/BIONTECH,159,159,0
Ferros,312590,MG,Sudeste,BUTANTAN/SINOVAC,2396,1211,1185
Ferros,312590,MG,Sudeste,FIOCRUZ/ASTRAZENECA,2006,1840,166
Ferros,312590,MG,Sudeste,PFIZER/BIONTECH,6,5,1
Fervedouro,312595,MG,Sudeste,FIOCRUZ/ASTRAZENECA,2375,2290,85
Fervedouro,312595,MG,Sudeste,BUTANTAN/SINOVAC,1632,854,778
Fervedouro,312595,MG,Sudeste,PFIZER/BIONTECH,317,317,0
Figueira,410775,PR,Sul,FIOCRUZ/ASTRAZENECA,1953,1804,149
Figueira,410775,PR,Sul,BUTANTAN/SINOVAC,1769,1053,716
Figueira,410775,PR,Sul,PFIZER/BIONTECH,57,57,0
Figueirão,500390,MS,Centro-Oeste,FIOCRUZ/ASTRAZENECA,1002,755,247
Figueirão,500390,MS,Centro-Oeste,BUTANTAN/SINOVAC,296,113,183
Figueirão,500390,MS,Centro-Oeste,PFIZER/BIONTECH,81,81,0
Figueirópolis,170765,TO,Norte,BUTANTAN/SINOVAC,1069,577,492
Figueirópolis,170765,TO,Norte,FIOCRUZ/ASTRAZENECA,758,719,39
Figueirópolis D'Oeste,510380,MT,Centro-Oeste,FIOCRUZ/ASTRAZENECA,1121,1071,50
Figueirópolis D'Oeste,510380,MT,Centro-Oeste,BUTANTAN/SINOVAC,829,416,413
Figueirópolis D'Oeste,510380,MT,Centro-Oeste,PFIZER/BIONTECH,7,7,0
Filadélfia,170770,TO,Norte,BUTANTAN/SINOVAC,1840,944,896
Filadélfia,170770,TO,Norte,FIOCRUZ/ASTRAZENECA,1269,1181,88
Filadélfia,291085,BA,Nordeste,FIOCRUZ/ASTRAZENECA,7307,6669,638
Filadélfia,291085,BA,Nordeste,BUTANTAN/SINOVAC,3147,1581,1566
Filadélfia,291085,BA,Nordeste,PFIZER/BIONTECH,71,69,2
Firmino Alves,291090,BA,Nordeste,BUTANTAN/SINOVAC,599,319,280
Firmino Alves,291090,BA,Nordeste,FIOCRUZ/ASTRAZENECA,273,231,42
Firminópolis,520780,GO,Centro-Oeste,FIOCRUZ/ASTRAZENECA,3483,3219,264
Firminópolis,520780,GO,Centro-Oeste,BUTANTAN/SINOVAC,3262,1688,1574
Flexeiras,270280,AL,Nordeste,BUTANTAN/SINOVAC,1840,1005,835
Flexeiras,270280,AL,Nordeste,FIOCRUZ/ASTRAZENECA,1495,1321,174
Flor Da Serra Do Sul,410785,PR,Sul,FIOCRUZ/ASTRAZENECA,1299,1242,57
Flor Da Serra Do Sul,410785,PR,Sul,BUTANTAN/SINOVAC,990,510,480
Flor Da Serra Do Sul,410785,PR,Sul,PFIZER/BIONTECH,30,30,0
Flor Do Sertão,420535,SC,Sul,BUTANTAN/SINOVAC,553,299,254
Flor Do Sertão,420535,SC,Sul,FIOCRUZ/ASTRAZENECA,512,469,43
Flora Rica,351580,SP,Sudeste,BUTANTAN/SINOVAC,1472,769,703
Flora Rica,351580,SP,Sudeste,FIOCRUZ/ASTRAZENECA,879,741,138
Flora Rica,351580,SP,Sudeste,PFIZER/BIONTECH,50,50,0
Floraí,410780,PR,Sul,FIOCRUZ/ASTRAZENECA,1799,1689,110
Floraí,410780,PR,Sul,BUTANTAN/SINOVAC,1480,763,717
Florânia,240380,RN,Nordeste,FIOCRUZ/ASTRAZENECA,2077,1950,127
Florânia,240380,RN,Nordeste,BUTANTAN/SINOVAC,2035,1029,1006
Florânia,240380,RN,Nordeste,PFIZER/BIONTECH,275,275,0
Floreal,351590,SP,Sudeste,BUTANTAN/SINOVAC,1057,561,496
Floreal,351590,SP,Sudeste,FIOCRUZ/ASTRAZENECA,977,867,110
Floreal,351590,SP,Sudeste,PFIZER/BIONTECH,100,100,0
Flores,260560,PE,Nordeste,FIOCRUZ/ASTRAZENECA,6767,6158,609
Flores,260560,PE,Nordeste,BUTANTAN/SINOVAC,4508,2367,2141
Flores,260560,PE,Nordeste,PFIZER/BIONTECH,711,705,6
Flores Da Cunha,430820,RS,Sul,FIOCRUZ/ASTRAZENECA,6706,6110,596
Flores Da Cunha,430820,RS,Sul,BUTANTAN/SINOVAC,6457,3316,3141
Flores Da Cunha,430820,RS,Sul,PFIZER/BIONTECH,530,529,1
Flores De Goiás,520790,GO,Centro-Oeste,FIOCRUZ/ASTRAZENECA,1995,1925,70
Flores De Goiás,520790,GO,Centro-Oeste,BUTANTAN/SINOVAC,1824,988,836
Flores Do Piauí,220380,PI,Nordeste,BUTANTAN/SINOVAC,788,399,389
Flores Do Piauí,220380,PI,Nordeste,FIOCRUZ/ASTRAZENECA,669,605,64
Floresta,260570,PE,Nordeste,FIOCRUZ/ASTRAZENECA,6848,6501,347
Floresta,260570,PE,Nordeste,BUTANTAN/SINOVAC,5169,2685,2484
Floresta,260570,PE,Nordeste,PFIZER/BIONTECH,865,862,3
Floresta,410790,PR,Sul,FIOCRUZ/ASTRAZENECA,2168,2080,88
Floresta,410790,PR,Sul,BUTANTAN/SINOVAC,1425,734,691
Floresta,410790,PR,Sul,PFIZER/BIONTECH,5,5,0
Floresta Azul,291100,BA,Nordeste,BUTANTAN/SINOVAC,2655,1388,1267
Floresta Azul,291100,BA,Nordeste,FIOCRUZ/ASTRAZENECA,2498,2290,208
Floresta Azul,291100,BA,Nordeste,PFIZER/BIONTECH,189,189,0
Floresta Do Araguaia,150304,PA,Norte,FIOCRUZ/ASTRAZENECA,2378,1708,670
Floresta Do Araguaia,150304,PA,Norte,BUTANTAN/SINOVAC,1781,1042,739
Floresta Do Araguaia,150304,PA,Norte,PFIZER/BIONTECH,2,2,0
Floresta Do Piauí,220385,PI,Nordeste,BUTANTAN/SINOVAC,806,476,330
Floresta Do Piauí,220385,PI,Nordeste,FIOCRUZ/ASTRAZENECA,470,421,49
Florestal,312600,MG,Sudeste,FIOCRUZ/ASTRAZENECA,1500,1410,90
Florestal,312600,MG,Sudeste,BUTANTAN/SINOVAC,1495,898,597
Florestal,312600,MG,Sudeste,PFIZER/BIONTECH,105,105,0
Florestópolis,410800,PR,Sul,FIOCRUZ/ASTRAZENECA,2819,2672,147
Florestópolis,410800,PR,Sul,BUTANTAN/SINOVAC,1865,1008,857
Florestópolis,410800,PR,Sul,PFIZER/BIONTECH,31,31,0
Floriano,220390,PI,Nordeste,FIOCRUZ/ASTRAZENECA,13412,11370,2042
Floriano,220390,PI,Nordeste,BUTANTAN/SINOVAC,12221,6354,5867
Floriano,220390,PI,Nordeste,PFIZER/BIONTECH,776,776,0
Floriano Peixoto,430825,RS,Sul,BUTANTAN/SINOVAC,711,373,338
Floriano Peixoto,430825,RS,Sul,FIOCRUZ/ASTRAZENECA,481,412,69
Floriano Peixoto,430825,RS,Sul,PFIZER/BIONTECH,47,47,0
Florianópolis,420540,SC,Sul,BUTANTAN/SINOVAC,94321,47635,46686
Florianópolis,420540,SC,Sul,FIOCRUZ/ASTRAZENECA,41348,39765,1583
Florianópolis,420540,SC,Sul,PFIZER/BIONTECH,6771,6770,1
Flórida,410810,PR,Sul,FIOCRUZ/ASTRAZENECA,997,937,60
Flórida,410810,PR,Sul,BUTANTAN/SINOVAC,779,405,374
Flórida,410810,PR,Sul,PFIZER/BIONTECH,6,6,0
Flórida Paulista,351600,SP,Sudeste,FIOCRUZ/ASTRAZENECA,3442,3149,293
Flórida Paulista,351600,SP,Sudeste,BUTANTAN/SINOVAC,3174,1617,1557
Flórida Paulista,351600,SP,Sudeste,PFIZER/BIONTECH,172,172,0
Florínea,351610,SP,Sudeste,BUTANTAN/SINOVAC,1112,677,435
Florínea,351610,SP,Sudeste,FIOCRUZ/ASTRAZENECA,793,732,61
Florínea,351610,SP,Sudeste,PFIZER/BIONTECH,118,118,0
Fonte Boa,130160,AM,Norte,BUTANTAN/SINOVAC,2196,1154,1042
Fonte Boa,130160,AM,Norte,FIOCRUZ/ASTRAZENECA,1774,1371,403
Fontoura Xavier,430830,RS,Sul,FIOCRUZ/ASTRAZENECA,3251,2996,255
Fontoura Xavier,430830,RS,Sul,BUTANTAN/SINOVAC,2093,1067,1026
Fontoura Xavier,430830,RS,Sul,PFIZER/BIONTECH,443,442,1
Formiga,312610,MG,Sudeste,BUTANTAN/SINOVAC,13339,7733,5606
Formiga,312610,MG,Sudeste,FIOCRUZ/ASTRAZENECA,12236,11721,515
Formiga,312610,MG,Sudeste,PFIZER/BIONTECH,1448,1448,0
Formigueiro,430840,RS,Sul,FIOCRUZ/ASTRAZENECA,2972,2774,198
Formigueiro,430840,RS,Sul,BUTANTAN/SINOVAC,2214,1116,1098
Formigueiro,430840,RS,Sul,PFIZER/BIONTECH,92,92,0
Formosa,520800,GO,Centro-Oeste,FIOCRUZ/ASTRAZENECA,23772,21360,2412
Formosa,520800,GO,Centro-Oeste,BUTANTAN/SINOVAC,13482,6914,6568
Formosa,520800,GO,Centro-Oeste,PFIZER/BIONTECH,1648,1648,0
Formosa Da Serra Negra,210409,MA,Nordeste,FIOCRUZ/ASTRAZENECA,3339,3180,159
Formosa Da Serra Negra,210409,MA,Nordeste,BUTANTAN/SINOVAC,1965,1025,940
Formosa Do Oeste,410820,PR,Sul,BUTANTAN/SINOVAC,2110,1086,1024
Formosa Do Oeste,410820,PR,Sul,FIOCRUZ/ASTRAZENECA,2078,1899,179
Formosa Do Oeste,410820,PR,Sul,PFIZER/BIONTECH,12,12,0
Formosa Do Rio Preto,291110,BA,Nordeste,BUTANTAN/SINOVAC,3364,1887,1477
Formosa Do Rio Preto,291110,BA,Nordeste,FIOCRUZ/ASTRAZENECA,2735,2533,202
Formosa Do Rio Preto,291110,BA,Nordeste,PFIZER/BIONTECH,245,245,0
Formosa Do Sul,420543,SC,Sul,FIOCRUZ/ASTRAZENECA,764,687,77
Formosa Do Sul,420543,SC,Sul,BUTANTAN/SINOVAC,751,414,337
Formosa Do Sul,420543,SC,Sul,PFIZER/BIONTECH,36,36,0
Formoso,312620,MG,Sudeste,FIOCRUZ/ASTRAZENECA,1722,1381,341
Formoso,312620,MG,Sudeste,BUTANTAN/SINOVAC,1306,679,627
Formoso,520810,GO,Centro-Oeste,FIOCRUZ/ASTRAZENECA,1308,1198,110
Formoso,520810,GO,Centro-Oeste,BUTANTAN/SINOVAC,855,452,403
Formoso Do Araguaia,170820,TO,Norte,BUTANTAN/SINOVAC,3895,2063,1832
Formoso Do Araguaia,170820,TO,Norte,FIOCRUZ/ASTRAZENECA,1919,1800,119
Forquetinha,430843,RS,Sul,BUTANTAN/SINOVAC,1041,522,519
Forquetinha,430843,RS,Sul,FIOCRUZ/ASTRAZENECA,697,599,98
Forquetinha,430843,RS,Sul,PFIZER/BIONTECH,49,49,0
Forquilha,230435,CE,Nordeste,BUTANTAN/SINOVAC,5955,3100,2855
Forquilha,230435,CE,Nordeste,FIOCRUZ/ASTRAZENECA,1620,1399,221
Forquilhinha,420545,SC,Sul,FIOCRUZ/ASTRAZENECA,5103,4780,323
Forquilhinha,420545,SC,Sul,BUTANTAN/SINOVAC,3525,1909,1616
Forquilhinha,420545,SC,Sul,PFIZER/BIONTECH,307,307,0
Fortaleza,230440,CE,Nordeste,BUTANTAN/SINOVAC,590875,300030,290845
Fortaleza,230440,CE,Nordeste,FIOCRUZ/ASTRAZENECA,583795,536308,47487
Fortaleza,230440,CE,Nordeste,PFIZER/BIONTECH,158427,158426,1
Fortaleza De Minas,312630,MG,Sudeste,FIOCRUZ/ASTRAZENECA,962,898,64
Fortaleza De Minas,312630,MG,Sudeste,BUTANTAN/SINOVAC,957,484,473
Fortaleza De Minas,312630,MG,Sudeste,PFIZER/BIONTECH,50,50,0
Fortaleza Do Tabocão,170825,TO,Norte,FIOCRUZ/ASTRAZENECA,498,465,33
Fortaleza Do Tabocão,170825,TO,Norte,BUTANTAN/SINOVAC,446,231,215
Fortaleza Dos Nogueiras,210410,MA,Nordeste,FIOCRUZ/ASTRAZENECA,2452,2337,115
Fortaleza Dos Nogueiras,210410,MA,Nordeste,BUTANTAN/SINOVAC,1888,1035,853
Fortaleza Dos Valos,430845,RS,Sul,BUTANTAN/SINOVAC,2373,1434,939
Fortaleza Dos Valos,430845,RS,Sul,FIOCRUZ/ASTRAZENECA,1743,1632,111
Fortaleza Dos Valos,430845,RS,Sul,PFIZER/BIONTECH,152,152,0
Fortim,230445,CE,Nordeste,BUTANTAN/SINOVAC,609,279,330
Fortim,230445,CE,Nordeste,FIOCRUZ/ASTRAZENECA,572,469,103
Fortuna,210420,MA,Nordeste,FIOCRUZ/ASTRAZENECA,3837,3672,165
Fortuna,210420,MA,Nordeste,BUTANTAN/SINOVAC,2493,1305,1188
Fortuna De Minas,312640,MG,Sudeste,FIOCRUZ/ASTRAZENECA,1104,1029,75
Fortuna De Minas,312640,MG,Sudeste,BUTANTAN/SINOVAC,852,449,403
Fortuna De Minas,312640,MG,Sudeste,PFIZER/BIONTECH,50,50,0
Foz Do Iguaçu,410830,PR,Sul,FIOCRUZ/ASTRAZENECA,59930,55386,4544
Foz Do Iguaçu,410830,PR,Sul,BUTANTAN/SINOVAC,43966,22635,21331
Foz Do Iguaçu,410830,PR,Sul,PFIZER/BIONTECH,17084,17084,0
Foz Do Jordão,410845,PR,Sul,FIOCRUZ/ASTRAZENECA,1603,1532,71
Foz Do Jordão,410845,PR,Sul,BUTANTAN/SINOVAC,1089,590,499
Foz Do Jordão,410845,PR,Sul,PFIZER/BIONTECH,30,30,0
Fraiburgo,420550,SC,Sul,FIOCRUZ/ASTRAZENECA,8962,8524,438
Fraiburgo,420550,SC,Sul,BUTANTAN/SINOVAC,6538,3071,3467
Fraiburgo,420550,SC,Sul,PFIZER/BIONTECH,544,544,0
Franca,351620,SP,Sudeste,FIOCRUZ/ASTRAZENECA,79607,74937,4670
Franca,351620,SP,Sudeste,BUTANTAN/SINOVAC,62537,33947,28590
Franca,351620,SP,Sudeste,PFIZER/BIONTECH,6503,6493,10
Francinópolis,220400,PI,Nordeste,FIOCRUZ/ASTRAZENECA,1216,1164,52
Francinópolis,220400,PI,Nordeste,BUTANTAN/SINOVAC,1017,559,458
Francinópolis,220400,PI,Nordeste,PFIZER/BIONTECH,1,1,0
Francisco Alves,410832,PR,Sul,BUTANTAN/SINOVAC,1588,831,757
Francisco Alves,410832,PR,Sul,FIOCRUZ/ASTRAZENECA,1364,1281,83
Francisco Ayres,220410,PI,Nordeste,BUTANTAN/SINOVAC,1159,591,568
Francisco Ayres,220410,PI,Nordeste,FIOCRUZ/ASTRAZENECA,1076,1005,71
Francisco Ayres,220410,PI,Nordeste,PFIZER/BIONTECH,63,63,0
Francisco Badaró,312650,MG,Sudeste,FIOCRUZ/ASTRAZENECA,2512,2370,142
Francisco Badaró,312650,MG,Sudeste,BUTANTAN/SINOVAC,2450,1270,1180
Francisco Badaró,312650,MG,Sudeste,PFIZER/BIONTECH,199,199,0
Francisco Beltrão,410840,PR,Sul,FIOCRUZ/ASTRAZENECA,21822,20148,1674
Francisco Beltrão,410840,PR,Sul,BUTANTAN/SINOVAC,17761,9300,8461
Francisco Beltrão,410840,PR,Sul,PFIZER/BIONTECH,4765,4765,0
Francisco Dantas,240390,RN,Nordeste,BUTANTAN/SINOVAC,710,364,346
Francisco Dantas,240390,RN,Nordeste,FIOCRUZ/ASTRAZENECA,594,558,36
Francisco Dantas,240390,RN,Nordeste,PFIZER/BIONTECH,96,96,0
Francisco Dumont,312660,MG,Sudeste,BUTANTAN/SINOVAC,1309,698,611
Francisco Dumont,312660,MG,Sudeste,FIOCRUZ/ASTRAZENECA,1140,1014,126
Francisco Dumont,312660,MG,Sudeste,PFIZER/BIONTECH,119,119,0
Francisco Macedo,220415,PI,Nordeste,BUTANTAN/SINOVAC,561,285,276
Francisco Macedo,220415,PI,Nordeste,FIOCRUZ/ASTRAZENECA,422,387,35
Francisco Morato,351630,SP,Sudeste,FIOCRUZ/ASTRAZENECA,33491,31774,1717
Francisco Morato,351630,SP,Sudeste,BUTANTAN/SINOVAC,20036,10445,9591
Francisco Morato,351630,SP,Sudeste,PFIZER/BIONTECH,1011,1008,3
Francisco Sá,312670,MG,Sudeste,BUTANTAN/SINOVAC,4401,2312,2089
Francisco Sá,312670,MG,Sudeste,FIOCRUZ/ASTRAZENECA,3823,3654,169
Francisco Santos,220420,PI,Nordeste,FIOCRUZ/ASTRAZENECA,1685,1526,159
Francisco Santos,220420,PI,Nordeste,BUTANTAN/SINOVAC,1414,761,653
Francisco Santos,220420,PI,Nordeste,PFIZER/BIONTECH,100,100,0
Franciscópolis,312675,MG,Sudeste,BUTANTAN/SINOVAC,1201,613,588
Franciscópolis,312675,MG,Sudeste,FIOCRUZ/ASTRAZENECA,1035,918,117
Franciscópolis,312675,MG,Sudeste,PFIZER/BIONTECH,45,45,0
Franco Da Rocha,351640,SP,Sudeste,FIOCRUZ/ASTRAZENECA,32429,29856,2573
Franco Da Rocha,351640,SP,Sudeste,BUTANTAN/SINOVAC,30254,16601,13653
Franco Da Rocha,351640,SP,Sudeste,PFIZER/BIONTECH,3944,3941,3
Frecheirinha,230450,CE,Nordeste,BUTANTAN/SINOVAC,2473,1259,1214
Frecheirinha,230450,CE,Nordeste,FIOCRUZ/ASTRAZENECA,1818,1599,219
Frederico Westphalen,430850,RS,Sul,BUTANTAN/SINOVAC,9566,4910,4656
Frederico Westphalen,430850,RS,Sul,FIOCRUZ/ASTRAZENECA,7715,7119,596
Frederico Westphalen,430850,RS,Sul,PFIZER/BIONTECH,797,796,1
Frei Gaspar,312680,MG,Sudeste,BUTANTAN/SINOVAC,1144,603,541
Frei Gaspar,312680,MG,Sudeste,FIOCRUZ/ASTRAZENECA,769,663,106
Frei Gaspar,312680,MG,Sudeste,PFIZER/BIONTECH,32,32,0
Frei Inocêncio,312690,MG,Sudeste,FIOCRUZ/ASTRAZENECA,1965,1674,291
Frei Inocêncio,312690,MG,Sudeste,BUTANTAN/SINOVAC,1962,1040,922
Frei Inocêncio,312690,MG,Sudeste,PFIZER/BIONTECH,37,37,0
Frei Lagonegro,312695,MG,Sudeste,FIOCRUZ/ASTRAZENECA,734,691,43
Frei Lagonegro,312695,MG,Sudeste,BUTANTAN/SINOVAC,573,332,241
Frei Lagonegro,312695,MG,Sudeste,PFIZER/BIONTECH,13,13,0
Frei Martinho,250620,PB,Nordeste,BUTANTAN/SINOVAC,1060,537,523
Frei Martinho,250620,PB,Nordeste,FIOCRUZ/ASTRAZENECA,766,680,86
Frei Martinho,250620,PB,Nordeste,PFIZER/BIONTECH,66,66,0
Frei Miguelinho,260580,PE,Nordeste,BUTANTAN/SINOVAC,3026,1646,1380
Frei Miguelinho,260580,PE,Nordeste,FIOCRUZ/ASTRAZENECA,2669,2338,331
Frei Miguelinho,260580,PE,Nordeste,PFIZER/BIONTECH,248,248,0
Frei Paulo,280230,SE,Nordeste,BUTANTAN/SINOVAC,2683,1567,1116
Frei Paulo,280230,SE,Nordeste,FIOCRUZ/ASTRAZENECA,2484,2482,2
Frei Paulo,280230,SE,Nordeste,PFIZER/BIONTECH,274,274,0
Frei Rogério,420555,SC,Sul,FIOCRUZ/ASTRAZENECA,683,597,86
Frei Rogério,420555,SC,Sul,BUTANTAN/SINOVAC,545,297,248
Frei Rogério,420555,SC,Sul,PFIZER/BIONTECH,80,80,0
Fronteira,312700,MG,Sudeste,FIOCRUZ/ASTRAZENECA,3076,2837,239
Fronteira,312700,MG,Sudeste,BUTANTAN/SINOVAC,2591,1347,1244
Fronteira,312700,MG,Sudeste,PFIZER/BIONTECH,112,112,0
Fronteira Dos Vales,312705,MG,Sudeste,BUTANTAN/SINOVAC,1125,605,520
Fronteira Dos Vales,312705,MG,Sudeste,FIOCRUZ/ASTRAZENECA,759,723,36
Fronteiras,220430,PI,Nordeste,FIOCRUZ/ASTRAZENECA,2458,2251,207
Fronteiras,220430,PI,Nordeste,BUTANTAN/SINOVAC,2098,1057,1041
Fronteiras,220430,PI,Nordeste,PFIZER/BIONTECH,104,104,0
Fruta De Leite,312707,MG,Sudeste,BUTANTAN/SINOVAC,1379,715,664
Fruta De Leite,312707,MG,Sudeste,FIOCRUZ/ASTRAZENECA,1145,1037,108
Fruta De Leite,312707,MG,Sudeste,PFIZER/BIONTECH,95,95,0
Frutal,312710,MG,Sudeste,BUTANTAN/SINOVAC,10251,5334,4917
Frutal,312710,MG,Sudeste,FIOCRUZ/ASTRAZENECA,8562,7796,766
Frutal,312710,MG,Sudeste,PFIZER/BIONTECH,462,462,0
Frutuoso Gomes,240400,RN,Nordeste,BUTANTAN/SINOVAC,1036,528,508
Frutuoso Gomes,240400,RN,Nordeste,FIOCRUZ/ASTRAZENECA,762,704,58
Frutuoso Gomes,240400,RN,Nordeste,PFIZER/BIONTECH,58,58,0
Fundão,320220,ES,Sudeste,BUTANTAN/SINOVAC,5423,2929,2494
Fundão,320220,ES,Sudeste,FIOCRUZ/ASTRAZENECA,3738,3594,144
Fundão,320220,ES,Sudeste,PFIZER/BIONTECH,302,302,0
Funilândia,312720,MG,Sudeste,BUTANTAN/SINOVAC,1024,532,492
Funilândia,312720,MG,Sudeste,FIOCRUZ/ASTRAZENECA,837,739,98
Funilândia,312720,MG,Sudeste,PFIZER/BIONTECH,63,63,0
Gabriel Monteiro,351650,SP,Sudeste,FIOCRUZ/ASTRAZENECA,989,889,100
Gabriel Monteiro,351650,SP,Sudeste,BUTANTAN/SINOVAC,910,436,474
Gabriel Monteiro,351650,SP,Sudeste,PFIZER/BIONTECH,103,103,0
Gado Bravo,250625,PB,Nordeste,BUTANTAN/SINOVAC,2411,1435,976
Gado Bravo,250625,PB,Nordeste,FIOCRUZ/ASTRAZENECA,1212,1139,73
Gália,351660,SP,Sudeste,BUTANTAN/SINOVAC,2231,1140,1091
Gália,351660,SP,Sudeste,FIOCRUZ/ASTRAZENECA,2202,1958,244
Gália,351660,SP,Sudeste,PFIZER/BIONTECH,139,139,0
Galiléia,312730,MG,Sudeste,BUTANTAN/SINOVAC,1212,688,524
Galiléia,312730,MG,Sudeste,FIOCRUZ/ASTRAZENECA,633,564,69
Galiléia,312730,MG,Sudeste,PFIZER/BIONTECH,4,4,0
Galinhos,240410,RN,Nordeste,BUTANTAN/SINOVAC,500,255,245
Galinhos,240410,RN,Nordeste,FIOCRUZ/ASTRAZENECA,310,300,10
Galinhos,240410,RN,Nordeste,PFIZER/BIONTECH,41,41,0
Galvão,420560,SC,Sul,FIOCRUZ/ASTRAZENECA,944,837,107
Galvão,420560,SC,Sul,BUTANTAN/SINOVAC,772,410,362
Galvão,420560,SC,Sul,PFIZER/BIONTECH,60,60,0
Gameleira,260590,PE,Nordeste,FIOCRUZ/ASTRAZENECA,3239,2921,318
Gameleira,260590,PE,Nordeste,BUTANTAN/SINOVAC,2766,1624,1142
Gameleira,260590,PE,Nordeste,PFIZER/BIONTECH,103,103,0
Gameleira De Goiás,520815,GO,Centro-Oeste,FIOCRUZ/ASTRAZENECA,863,844,19
Gameleira De Goiás,520815,GO,Centro-Oeste,BUTANTAN/SINOVAC,674,397,277
Gameleira De Goiás,520815,GO,Centro-Oeste,PFIZER/BIONTECH,33,33,0
Gameleiras,312733,MG,Sudeste,BUTANTAN/SINOVAC,928,554,374
Gameleiras,312733,MG,Sudeste,FIOCRUZ/ASTRAZENECA,626,582,44
Gandu,291120,BA,Nordeste,BUTANTAN/SINOVAC,5205,2715,2490
Gandu,291120,BA,Nordeste,FIOCRUZ/ASTRAZENECA,5014,4602,412
Gandu,291120,BA,Nordeste,PFIZER/BIONTECH,195,145,50
Garanhuns,260600,PE,Nordeste,FIOCRUZ/ASTRAZENECA,32524,30407,2117
Garanhuns,260600,PE,Nordeste,BUTANTAN/SINOVAC,25393,13002,12391
Garanhuns,260600,PE,Nordeste,PFIZER/BIONTECH,3275,3274,1
Gararu,280240,SE,Nordeste,BUTANTAN/SINOVAC,2390,1180,1210
Gararu,280240,SE,Nordeste,FIOCRUZ/ASTRAZENECA,1696,1694,2
Gararu,280240,SE,Nordeste,PFIZER/BIONTECH,269,269,0
Garça,351670,SP,Sudeste,BUTANTAN/SINOVAC,10364,5639,4725
Garça,351670,SP,Sudeste,FIOCRUZ/ASTRAZENECA,9421,8105,1316
Garça,351670,SP,Sudeste,PFIZER/BIONTECH,541,541,0
Garibaldi,430860,RS,Sul,FIOCRUZ/ASTRAZENECA,8774,8137,637
Garibaldi,430860,RS,Sul,BUTANTAN/SINOVAC,8176,4175,4001
Garibaldi,430860,RS,Sul,PFIZER/BIONTECH,1226,1225,1
Garopaba,420570,SC,Sul,FIOCRUZ/ASTRAZENECA,7238,6857,381
Garopaba,420570,SC,Sul,BUTANTAN/SINOVAC,4498,2304,2194
Garopaba,420570,SC,Sul,PFIZER/BIONTECH,30,30,0
Garrafão Do Norte,150307,PA,Norte,BUTANTAN/SINOVAC,4122,2208,1914
Garrafão Do Norte,150307,PA,Norte,FIOCRUZ/ASTRAZENECA,3627,3282,345
Garruchos,430865,RS,Sul,BUTANTAN/SINOVAC,821,417,404
Garruchos,430865,RS,Sul,FIOCRUZ/ASTRAZENECA,815,720,95
Garruchos,430865,RS,Sul,PFIZER/BIONTECH,120,120,0
Garuva,420580,SC,Sul,FIOCRUZ/ASTRAZENECA,3932,3563,369
Garuva,420580,SC,Sul,BUTANTAN/SINOVAC,2130,1150,980
Garuva,420580,SC,Sul,PFIZER/BIONTECH,382,382,0
Gaspar,420590,SC,Sul,FIOCRUZ/ASTRAZENECA,11731,11426,305
Gaspar,420590,SC,Sul,BUTANTAN/SINOVAC,10718,5862,4856
Gaspar,420590,SC,Sul,PFIZER/BIONTECH,1568,1568,0
Gastão Vidigal,351680,SP,Sudeste,FIOCRUZ/ASTRAZENECA,878,812,66
Gastão Vidigal,351680,SP,Sudeste,BUTANTAN/SINOVAC,858,476,382
Gastão Vidigal,351680,SP,Sudeste,PFIZER/BIONTECH,112,112,0
Gaúcha Do Norte,510385,MT,Centro-Oeste,BUTANTAN/SINOVAC,3491,2027,1464
Gaúcha Do Norte,510385,MT,Centro-Oeste,FIOCRUZ/ASTRAZENECA,1134,842,292
Gaúcha Do Norte,510385,MT,Centro-Oeste,PFIZER/BIONTECH,139,139,0
Gaurama,430870,RS,Sul,BUTANTAN/SINOVAC,2139,1091,1048
Gaurama,430870,RS,Sul,FIOCRUZ/ASTRAZENECA,1666,1418,248
Gaurama,430870,RS,Sul,PFIZER/BIONTECH,209,209,0
Gavião,291125,BA,Nordeste,BUTANTAN/SINOVAC,1257,649,608
Gavião,291125,BA,Nordeste,FIOCRUZ/ASTRAZENECA,1166,947,219
Gavião,291125,BA,Nordeste,PFIZER/BIONTECH,125,123,2
Gavião Peixoto,351685,SP,Sudeste,BUTANTAN/SINOVAC,1154,624,530
Gavião Peixoto,351685,SP,Sudeste,FIOCRUZ/ASTRAZENECA,1021,940,81
Gavião Peixoto,351685,SP,Sudeste,PFIZER/BIONTECH,107,106,1
Geminiano,220435,PI,Nordeste,FIOCRUZ/ASTRAZENECA,932,864,68
Geminiano,220435,PI,Nordeste,BUTANTAN/SINOVAC,847,438,409
General Câmara,430880,RS,Sul,BUTANTAN/SINOVAC,2646,1371,1275
General Câmara,430880,RS,Sul,FIOCRUZ/ASTRAZENECA,1837,1629,208
General Câmara,430880,RS,Sul,PFIZER/BIONTECH,143,143,0
General Carneiro,410850,PR,Sul,FIOCRUZ/ASTRAZENECA,2618,2506,112
General Carneiro,410850,PR,Sul,BUTANTAN/SINOVAC,2018,1038,980
General Carneiro,410850,PR,Sul,PFIZER/BIONTECH,156,156,0
General Carneiro,510390,MT,Centro-Oeste,BUTANTAN/SINOVAC,3120,1600,1520
General Carneiro,510390,MT,Centro-Oeste,FIOCRUZ/ASTRAZENECA,1246,1128,118
General Carneiro,510390,MT,Centro-Oeste,PFIZER/BIONTECH,75,75,0
General Maynard,280250,SE,Nordeste,BUTANTAN/SINOVAC,712,360,352
General Maynard,280250,SE,Nordeste,FIOCRUZ/ASTRAZENECA,605,576,29
General Maynard,280250,SE,Nordeste,PFIZER/BIONTECH,83,83,0
General Salgado,351690,SP,Sudeste,BUTANTAN/SINOVAC,3031,1548,1483
General Salgado,351690,SP,Sudeste,FIOCRUZ/ASTRAZENECA,2766,2479,287
General Salgado,351690,SP,Sudeste,PFIZER/BIONTECH,145,145,0
General Sampaio,230460,CE,Nordeste,BUTANTAN/SINOVAC,1297,656,641
General Sampaio,230460,CE,Nordeste,FIOCRUZ/ASTRAZENECA,587,455,132
Gentil,430885,RS,Sul,BUTANTAN/SINOVAC,538,274,264
Gentil,430885,RS,Sul,FIOCRUZ/ASTRAZENECA,421,404,17
Gentil,430885,RS,Sul,PFIZER/BIONTECH,56,56,0
Gentio Do Ouro,291130,BA,Nordeste,FIOCRUZ/ASTRAZENECA,2856,2579,277
Gentio Do Ouro,291130,BA,Nordeste,BUTANTAN/SINOVAC,2496,1297,1199
Gentio Do Ouro,291130,BA,Nordeste,PFIZER/BIONTECH,68,68,0
Getulina,351700,SP,Sudeste,BUTANTAN/SINOVAC,2561,1397,1164
Getulina,351700,SP,Sudeste,FIOCRUZ/ASTRAZENECA,2304,2146,158
Getulina,351700,SP,Sudeste,PFIZER/BIONTECH,161,161,0
Getúlio Vargas,430890,RS,Sul,BUTANTAN/SINOVAC,5166,2596,2570
Getúlio Vargas,430890,RS,Sul,FIOCRUZ/ASTRAZENECA,4540,4069,471
Getúlio Vargas,430890,RS,Sul,PFIZER/BIONTECH,606,606,0
Gilbués,220440,PI,Nordeste,BUTANTAN/SINOVAC,1618,860,758
Gilbués,220440,PI,Nordeste,FIOCRUZ/ASTRAZENECA,1027,972,55
Girau Do Ponciano,270290,AL,Nordeste,FIOCRUZ/ASTRAZENECA,7184,6697,487
Girau Do Ponciano,270290,AL,Nordeste,BUTANTAN/SINOVAC,6107,3210,2897
Giruá,430900,RS,Sul,BUTANTAN/SINOVAC,4617,2317,2300
Giruá,430900,RS,Sul,FIOCRUZ/ASTRAZENECA,4307,3903,404
Giruá,430900,RS,Sul,PFIZER/BIONTECH,522,522,0
Glaucilândia,312735,MG,Sudeste,BUTANTAN/SINOVAC,959,504,455
Glaucilândia,312735,MG,Sudeste,FIOCRUZ/ASTRAZENECA,659,589,70
Glaucilândia,312735,MG,Sudeste,PFIZER/BIONTECH,39,39,0
Glicério,351710,SP,Sudeste,FIOCRUZ/ASTRAZENECA,1067,984,83
Glicério,351710,SP,Sudeste,BUTANTAN/SINOVAC,1021,525,496
Glicério,351710,SP,Sudeste,PFIZER/BIONTECH,61,60,1
Glória,291140,BA,Nordeste,BUTANTAN/SINOVAC,4506,2299,2207
Glória,291140,BA,Nordeste,FIOCRUZ/ASTRAZENECA,3219,2940,279
Glória,291140,BA,Nordeste,PFIZER/BIONTECH,109,109,0
Glória D'Oeste,510395,MT,Centro-Oeste,FIOCRUZ/ASTRAZENECA,1038,963,75
Glória D'Oeste,510395,MT,Centro-Oeste,BUTANTAN/SINOVAC,975,509,466
Glória D'Oeste,510395,MT,Centro-Oeste,PFIZER/BIONTECH,9,9,0
Glória De Dourados,500400,MS,Centro-Oeste,FIOCRUZ/ASTRAZENECA,2810,2315,495
Glória De Dourados,500400,MS,Centro-Oeste,BUTANTAN/SINOVAC,2688,1421,1267
Glória De Dourados,500400,MS,Centro-Oeste,PFIZER/BIONTECH,480,480,0
Glória Do Goitá,260610,PE,Nordeste,FIOCRUZ/ASTRAZENECA,6368,5856,512
Glória Do Goitá,260610,PE,Nordeste,BUTANTAN/SINOVAC,4957,2545,2412
Glória Do Goitá,260610,PE,Nordeste,PFIZER/BIONTECH,726,726,0
Glorinha,430905,RS,Sul,BUTANTAN/SINOVAC,2244,1162,1082
Glorinha,430905,RS,Sul,FIOCRUZ/ASTRAZENECA,1701,1632,69
Glorinha,430905,RS,Sul,PFIZER/BIONTECH,84,84,0
Godofredo Viana,210430,MA,Nordeste,FIOCRUZ/ASTRAZENECA,1303,1246,57
Godofredo Viana,210430,MA,Nordeste,BUTANTAN/SINOVAC,1014,533,481
Godoy Moreira,410855,PR,Sul,FIOCRUZ/ASTRAZENECA,911,856,55
Godoy Moreira,410855,PR,Sul,BUTANTAN/SINOVAC,909,482,427
Godoy Moreira,410855,PR,Sul,PFIZER/BIONTECH,6,6,0
Goiabeira,312737,MG,Sudeste,BUTANTAN/SINOVAC,812,413,399
Goiabeira,312737,MG,Sudeste,FIOCRUZ/ASTRAZENECA,710,639,71
Goiabeira,312737,MG,Sudeste,PFIZER/BIONTECH,44,44,0
Goiana,260620,PE,Nordeste,FIOCRUZ/ASTRAZENECA,13953,12998,955
Goiana,260620,PE,Nordeste,BUTANTAN/SINOVAC,11809,6224,5585
Goiana,260620,PE,Nordeste,PFIZER/BIONTECH,613,613,0
Goianá,312738,MG,Sudeste,BUTANTAN/SINOVAC,997,507,490
Goianá,312738,MG,Sudeste,FIOCRUZ/ASTRAZENECA,765,744,21
Goianápolis,520840,GO,Centro-Oeste,FIOCRUZ/ASTRAZENECA,2574,2442,132
Goianápolis,520840,GO,Centro-Oeste,BUTANTAN/SINOVAC,1800,937,863
Goianápolis,520840,GO,Centro-Oeste,PFIZER/BIONTECH,12,12,0
Goiandira,520850,GO,Centro-Oeste,FIOCRUZ/ASTRAZENECA,1853,1714,139
Goiandira,520850,GO,Centro-Oeste,BUTANTAN/SINOVAC,1117,573,544
Goianésia,520860,GO,Centro-Oeste,FIOCRUZ/ASTRAZENECA,23116,21644,1472
Goianésia,520860,GO,Centro-Oeste,BUTANTAN/SINOVAC,9979,5393,4586
Goianésia,520860,GO,Centro-Oeste,PFIZER/BIONTECH,265,265,0
Goianésia Do Pará,150309,PA,Norte,FIOCRUZ/ASTRAZENECA,4499,3997,502
Goianésia Do Pará,150309,PA,Norte,BUTANTAN/SINOVAC,1027,585,442
Goiânia,520870,GO,Centro-Oeste,BUTANTAN/SINOVAC,345546,176962,168584
Goiânia,520870,GO,Centro-Oeste,FIOCRUZ/ASTRAZENECA,220493,190883,29610
Goiânia,520870,GO,Centro-Oeste,PFIZER/BIONTECH,117818,117745,73
Goianinha,240420,RN,Nordeste,FIOCRUZ/ASTRAZENECA,5059,4410,649
Goianinha,240420,RN,Nordeste,BUTANTAN/SINOVAC,3718,1970,1748
Goianinha,240420,RN,Nordeste,PFIZER/BIONTECH,1207,1205,2
Goianira,520880,GO,Centro-Oeste,FIOCRUZ/ASTRAZENECA,8358,7763,595
Goianira,520880,GO,Centro-Oeste,BUTANTAN/SINOVAC,6452,3645,2807
Goianira,520880,GO,Centro-Oeste,PFIZER/BIONTECH,1087,1086,1
Goianorte,170830,TO,Norte,BUTANTAN/SINOVAC,949,484,465
Goianorte,170830,TO,Norte,FIOCRUZ/ASTRAZENECA,811,770,41
Goiás,520890,GO,Centro-Oeste,FIOCRUZ/ASTRAZENECA,7026,6539,487
Goiás,520890,GO,Centro-Oeste,BUTANTAN/SINOVAC,5197,2694,2503
Goiás,520890,GO,Centro-Oeste,PFIZER/BIONTECH,673,673,0
Goiatins,170900,TO,Norte,BUTANTAN/SINOVAC,3743,2005,1738
Goiatins,170900,TO,Norte,FIOCRUZ/ASTRAZENECA,670,604,66
Goiatuba,520910,GO,Centro-Oeste,FIOCRUZ/ASTRAZENECA,10246,9554,692
Goiatuba,520910,GO,Centro-Oeste,BUTANTAN/SINOVAC,7261,3703,3558
Goiatuba,520910,GO,Centro-Oeste,PFIZER/BIONTECH,324,324,0
Goioerê,410860,PR,Sul,FIOCRUZ/ASTRAZENECA,7419,7002,417
Goioerê,410860,PR,Sul,BUTANTAN/SINOVAC,6444,3393,3051
Goioerê,410860,PR,Sul,PFIZER/BIONTECH,801,801,0
Goioxim,410865,PR,Sul,FIOCRUZ/ASTRAZENECA,1658,1583,75
Goioxim,410865,PR,Sul,BUTANTAN/SINOVAC,1273,658,615
Goioxim,410865,PR,Sul,PFIZER/BIONTECH,2,2,0
Gonçalves,312740,MG,Sudeste,BUTANTAN/SINOVAC,1013,514,499
Gonçalves,312740,MG,Sudeste,FIOCRUZ/ASTRAZENECA,959,917,42
Gonçalves,312740,MG,Sudeste,PFIZER/BIONTECH,30,30,0
Gonçalves Dias,210440,MA,Nordeste,FIOCRUZ/ASTRAZENECA,4203,3863,340
Gonçalves Dias,210440,MA,Nordeste,BUTANTAN/SINOVAC,2762,1489,1273
Gongogi,291150,BA,Nordeste,BUTANTAN/SINOVAC,268,156,112
Gongogi,291150,BA,Nordeste,FIOCRUZ/ASTRAZENECA,95,93,2
Gongogi,291150,BA,Nordeste,PFIZER/BIONTECH,2,2,0
Gonzaga,312750,MG,Sudeste,BUTANTAN/SINOVAC,1088,565,523
Gonzaga,312750,MG,Sudeste,FIOCRUZ/ASTRAZENECA,710,668,42
Gouveia,312760,MG,Sudeste,FIOCRUZ/ASTRAZENECA,2565,2369,196
Gouveia,312760,MG,Sudeste,BUTANTAN/SINOVAC,2525,1328,1197
Gouveia,312760,MG,Sudeste,PFIZER/BIONTECH,198,198,0
Gouvelândia,520915,GO,Centro-Oeste,FIOCRUZ/ASTRAZENECA,1331,1251,80
Gouvelândia,520915,GO,Centro-Oeste,BUTANTAN/SINOVAC,1013,514,499
Gouvelândia,520915,GO,Centro-Oeste,PFIZER/BIONTECH,2,2,0
Governador Archer,210450,MA,Nordeste,FIOCRUZ/ASTRAZENECA,2738,2576,162
Governador Archer,210450,MA,Nordeste,BUTANTAN/SINOVAC,1951,1080,871
Governador Celso Ramos,420600,SC,Sul,FIOCRUZ/ASTRAZENECA,4232,4044,188
Governador Celso Ramos,420600,SC,Sul,BUTANTAN/SINOVAC,2343,1242,1101
Governador Celso Ramos,420600,SC,Sul,PFIZER/BIONTECH,210,209,1
Governador Dix-Sept Rosado,240430,RN,Nordeste,BUTANTAN/SINOVAC,2322,1167,1155
Governador Dix-Sept Rosado,240430,RN,Nordeste,FIOCRUZ/ASTRAZENECA,1909,1836,73
Governador Dix-Sept Rosado,240430,RN,Nordeste,PFIZER/BIONTECH,281,280,1
Governador Edison Lobão,210455,MA,Nordeste,FIOCRUZ/ASTRAZENECA,2421,2264,157
Governador Edison Lobão,210455,MA,Nordeste,BUTANTAN/SINOVAC,2123,1146,977
Governador Eugênio Barros,210460,MA,Nordeste,FIOCRUZ/ASTRAZENECA,3602,2788,814
Governador Eugênio Barros,210460,MA,Nordeste,BUTANTAN/SINOVAC,3120,1615,1505
Governador Jorge Teixeira,110100,RO,Norte,FIOCRUZ/ASTRAZENECA,2144,2080,64
Governador Jorge Teixeira,110100,RO,Norte,BUTANTAN/SINOVAC,1693,868,825
Governador Jorge Teixeira,110100,RO,Norte,PFIZER/BIONTECH,170,169,1
Governador Lindenberg,320225,ES,Sudeste,BUTANTAN/SINOVAC,3171,1803,1368
Governador Lindenberg,320225,ES,Sudeste,FIOCRUZ/ASTRAZENECA,2308,2211,97
Governador Lindenberg,320225,ES,Sudeste,PFIZER/BIONTECH,268,268,0
Governador Luiz Rocha,210462,MA,Nordeste,FIOCRUZ/ASTRAZENECA,1801,1681,120
Governador Luiz Rocha,210462,MA,Nordeste,BUTANTAN/SINOVAC,1351,726,625
Governador Mangabeira,291160,BA,Nordeste,BUTANTAN/SINOVAC,4865,2763,2102
Governador Mangabeira,291160,BA,Nordeste,FIOCRUZ/ASTRAZENECA,4681,4116,565
Governador Mangabeira,291160,BA,Nordeste,PFIZER/BIONTECH,565,565,0
Governador Newton Bello,210465,MA,Nordeste,FIOCRUZ/ASTRAZENECA,1345,1245,100
Governador Newton Bello,210465,MA,Nordeste,BUTANTAN/SINOVAC,1244,658,586
Governador Nunes Freire,210467,MA,Nordeste,FIOCRUZ/ASTRAZENECA,4837,4539,298
Governador Nunes Freire,210467,MA,Nordeste,BUTANTAN/SINOVAC,3036,1820,1216
Governador Valadares,312770,MG,Sudeste,BUTANTAN/SINOVAC,56923,31705,25218
Governador Valadares,312770,MG,Sudeste,FIOCRUZ/ASTRAZENECA,28926,26290,2636
Governador Valadares,312770,MG,Sudeste,PFIZER/BIONTECH,1213,1212,1
Graça,230465,CE,Nordeste,BUTANTAN/SINOVAC,2214,1340,874
Graça,230465,CE,Nordeste,FIOCRUZ/ASTRAZENECA,1290,1119,171
Graça Aranha,210470,MA,Nordeste,FIOCRUZ/ASTRAZENECA,1121,1071,50
Graça Aranha,210470,MA,Nordeste,BUTANTAN/SINOVAC,1046,547,499
Gracho Cardoso,280260,SE,Nordeste,BUTANTAN/SINOVAC,1216,667,549
Gracho Cardoso,280260,SE,Nordeste,FIOCRUZ/ASTRAZENECA,891,891,0
Gracho Cardoso,280260,SE,Nordeste,PFIZER/BIONTECH,12,12,0
Grajaú,210480,MA,Nordeste,BUTANTAN/SINOVAC,12637,6852,5785
Grajaú,210480,MA,Nordeste,FIOCRUZ/ASTRAZENECA,11509,10809,700
Gramado,430910,RS,Sul,FIOCRUZ/ASTRAZENECA,9634,8204,1430
Gramado,430910,RS,Sul,BUTANTAN/SINOVAC,8073,4049,4024
Gramado,430910,RS,Sul,PFIZER/BIONTECH,1154,1151,3
Gramado Dos Loureiros,430912,RS,Sul,BUTANTAN/SINOVAC,1187,641,546
Gramado Dos Loureiros,430912,RS,Sul,FIOCRUZ/ASTRAZENECA,721,670,51
Gramado Dos Loureiros,430912,RS,Sul,PFIZER/BIONTECH,47,47,0
Gramado Xavier,430915,RS,Sul,BUTANTAN/SINOVAC,609,337,272
Gramado Xavier,430915,RS,Sul,FIOCRUZ/ASTRAZENECA,440,410,30
Gramado Xavier,430915,RS,Sul,PFIZER/BIONTECH,52,52,0
Grandes Rios,410870,PR,Sul,FIOCRUZ/ASTRAZENECA,1629,1546,83
Grandes Rios,410870,PR,Sul,BUTANTAN/SINOVAC,1333,716,617
Grandes Rios,410870,PR,Sul,PFIZER/BIONTECH,26,26,0
Granito,260630,PE,Nordeste,BUTANTAN/SINOVAC,1763,933,830
Granito,260630,PE,Nordeste,FIOCRUZ/ASTRAZENECA,1398,1288,110
Granito,260630,PE,Nordeste,PFIZER/BIONTECH,114,114,0
Granja,230470,CE,Nordeste,BUTANTAN/SINOVAC,7595,3979,3616
Granja,230470,CE,Nordeste,FIOCRUZ/ASTRAZENECA,4010,3367,643
Granjeiro,230480,CE,Nordeste,BUTANTAN/SINOVAC,104,104,0
Granjeiro,230480,CE,Nordeste,FIOCRUZ/ASTRAZENECA,80,80,0
Grão Mogol,312780,MG,Sudeste,FIOCRUZ/ASTRAZENECA,2521,2336,185
Grão Mogol,312780,MG,Sudeste,BUTANTAN/SINOVAC,2475,1251,1224
Grão Mogol,312780,MG,Sudeste,PFIZER/BIONTECH,40,40,0
Grão Pará,420610,SC,Sul,FIOCRUZ/ASTRAZENECA,1923,1788,135
Grão Pará,420610,SC,Sul,BUTANTAN/SINOVAC,1320,740,580
Grão Pará,420610,SC,Sul,PFIZER/BIONTECH,89,89,0
Gravatá,260640,PE,Nordeste,FIOCRUZ/ASTRAZENECA,14845,13568,1277
Gravatá,260640,PE,Nordeste,BUTANTAN/SINOVAC,12813,6535,6278
Gravatá,260640,PE,Nordeste,PFIZER/BIONTECH,596,596,0
Gravataí,430920,RS,Sul,BUTANTAN/SINOVAC,69870,36782,33088
Gravataí,430920,RS,Sul,FIOCRUZ/ASTRAZENECA,61387,58936,2451
Gravataí,430920,RS,Sul,PFIZER/BIONTECH,9090,9080,10
Gravatal,420620,SC,Sul,FIOCRUZ/ASTRAZENECA,2939,2663,276
Gravatal,420620,SC,Sul,BUTANTAN/SINOVAC,2201,1258,943
Gravatal,420620,SC,Sul,PFIZER/BIONTECH,345,345,0
Groaíras,230490,CE,Nordeste,BUTANTAN/SINOVAC,2436,1260,1176
Groaíras,230490,CE,Nordeste,FIOCRUZ/ASTRAZENECA,1316,1102,214
Grossos,240440,RN,Nordeste,BUTANTAN/SINOVAC,1916,978,938
Grossos,240440,RN,Nordeste,FIOCRUZ/ASTRAZENECA,1909,1829,80
Grossos,240440,RN,Nordeste,PFIZER/BIONTECH,264,263,1
Grupiara,312790,MG,Sudeste,FIOCRUZ/ASTRAZENECA,543,491,52
Grupiara,312790,MG,Sudeste,BUTANTAN/SINOVAC,413,197,216
Grupiara,312790,MG,Sudeste,PFIZER/BIONTECH,35,35,0
Guabiju,430925,RS,Sul,BUTANTAN/SINOVAC,882,519,363
Guabiju,430925,RS,Sul,FIOCRUZ/ASTRAZENECA,599,544,55
Guabiju,430925,RS,Sul,PFIZER/BIONTECH,54,54,0
Guabiruba,420630,SC,Sul,BUTANTAN/SINOVAC,4200,1949,2251
Guabiruba,420630,SC,Sul,FIOCRUZ/ASTRAZENECA,4199,4120,79
Guabiruba,420630,SC,Sul,PFIZER/BIONTECH,368,367,1
Guaçuí,320230,ES,Sudeste,BUTANTAN/SINOVAC,8380,4273,4107
Guaçuí,320230,ES,Sudeste,FIOCRUZ/ASTRAZENECA,6043,5706,337
Guaçuí,320230,ES,Sudeste,PFIZER/BIONTECH,1426,1426,0
Guadalupe,220450,PI,Nordeste,FIOCRUZ/ASTRAZENECA,1700,1536,164
Guadalupe,220450,PI,Nordeste,BUTANTAN/SINOVAC,1600,878,722
Guadalupe,220450,PI,Nordeste,PFIZER/BIONTECH,127,127,0
Guaíba,430930,RS,Sul,FIOCRUZ/ASTRAZENECA,21713,20579,1134
Guaíba,430930,RS,Sul,BUTANTAN/SINOVAC,20729,10835,9894
Guaíba,430930,RS,Sul,PFIZER/BIONTECH,1241,1240,1
Guaiçara,351720,SP,Sudeste,FIOCRUZ/ASTRAZENECA,2514,2358,156
Guaiçara,351720,SP,Sudeste,BUTANTAN/SINOVAC,2179,1105,1074
Guaiçara,351720,SP,Sudeste,PFIZER/BIONTECH,269,269,0
Guaimbê,351730,SP,Sudeste,FIOCRUZ/ASTRAZENECA,1528,1344,184
Guaimbê,351730,SP,Sudeste,BUTANTAN/SINOVAC,1424,722,702
Guaimbê,351730,SP,Sudeste,PFIZER/BIONTECH,94,94,0
Guaíra,351740,SP,Sudeste,FIOCRUZ/ASTRAZENECA,9111,8490,621
Guaíra,351740,SP,Sudeste,BUTANTAN/SINOVAC,8593,4321,4272
Guaíra,351740,SP,Sudeste,PFIZER/BIONTECH,720,708,12
Guaíra,410880,PR,Sul,BUTANTAN/SINOVAC,7648,3951,3697
Guaíra,410880,PR,Sul,FIOCRUZ/ASTRAZENECA,5859,5450,409
Guaíra,410880,PR,Sul,PFIZER/BIONTECH,249,249,0
Guairaçá,410890,PR,Sul,FIOCRUZ/ASTRAZENECA,2193,2061,132
Guairaçá,410890,PR,Sul,BUTANTAN/SINOVAC,1496,791,705
Guairaçá,410890,PR,Sul,PFIZER/BIONTECH,12,12,0
Guaiúba,230495,CE,Nordeste,BUTANTAN/SINOVAC,3366,1898,1468
Guaiúba,230495,CE,Nordeste,FIOCRUZ/ASTRAZENECA,1034,909,125
Guajará,130165,AM,Norte,FIOCRUZ/ASTRAZENECA,1913,1562,351
Guajará,130165,AM,Norte,BUTANTAN/SINOVAC,1871,989,882
Guajará-Mirim,110010,RO,Norte,BUTANTAN/SINOVAC,11009,6022,4987
Guajará-Mirim,110010,RO,Norte,FIOCRUZ/ASTRAZENECA,8888,8022,866
Guajará-Mirim,110010,RO,Norte,PFIZER/BIONTECH,110,108,2
Guajeru,291165,BA,Nordeste,BUTANTAN/SINOVAC,2128,1137,991
Guajeru,291165,BA,Nordeste,FIOCRUZ/ASTRAZENECA,2124,1843,281
Guajeru,291165,BA,Nordeste,PFIZER/BIONTECH,148,148,0
Guamaré,240450,RN,Nordeste,FIOCRUZ/ASTRAZENECA,5193,4865,328
Guamaré,240450,RN,Nordeste,BUTANTAN/SINOVAC,4220,2631,1589
Guamaré,240450,RN,Nordeste,PFIZER/BIONTECH,1005,1003,2
Guamiranga,410895,PR,Sul,FIOCRUZ/ASTRAZENECA,1900,1807,93
Guamiranga,410895,PR,Sul,BUTANTAN/SINOVAC,1212,628,584
Guanambi,291170,BA,Nordeste,BUTANTAN/SINOVAC,13129,7070,6059
Guanambi,291170,BA,Nordeste,FIOCRUZ/ASTRAZENECA,9888,8871,1017
Guanambi,291170,BA,Nordeste,PFIZER/BIONTECH,169,169,0
Guanhães,312800,MG,Sudeste,BUTANTAN/SINOVAC,6558,3332,3226
Guanhães,312800,MG,Sudeste,FIOCRUZ/ASTRAZENECA,5459,4982,477
Guanhães,312800,MG,Sudeste,PFIZER/BIONTECH,486,486,0
Guapé,312810,MG,Sudeste,FIOCRUZ/ASTRAZENECA,2983,2754,229
Guapé,312810,MG,Sudeste,BUTANTAN/SINOVAC,2954,1494,1460
Guapé,312810,MG,Sudeste,PFIZER/BIONTECH,99,99,0
Guapiaçu,351750,SP,Sudeste,BUTANTAN/SINOVAC,4688,2698,1990
Guapiaçu,351750,SP,Sudeste,FIOCRUZ/ASTRAZENECA,3599,3300,299
Guapiaçu,351750,SP,Sudeste,PFIZER/BIONTECH,157,157,0
Guapiara,351760,SP,Sudeste,FIOCRUZ/ASTRAZENECA,3824,3610,214
Guapiara,351760,SP,Sudeste,BUTANTAN/SINOVAC,3787,1888,1899
Guapiara,351760,SP,Sudeste,PFIZER/BIONTECH,325,325,0
Guapimirim,330185,RJ,Sudeste,FIOCRUZ/ASTRAZENECA,13315,12227,1088
Guapimirim,330185,RJ,Sudeste,BUTANTAN/SINOVAC,12918,6745,6173
Guapimirim,330185,RJ,Sudeste,PFIZER/BIONTECH,1693,1692,1
Guapirama,410900,PR,Sul,FIOCRUZ/ASTRAZENECA,1295,1238,57
Guapirama,410900,PR,Sul,BUTANTAN/SINOVAC,838,444,394
Guapirama,410900,PR,Sul,PFIZER/BIONTECH,24,24,0
Guapó,520920,GO,Centro-Oeste,FIOCRUZ/ASTRAZENECA,3621,3376,245
Guapó,520920,GO,Centro-Oeste,BUTANTAN/SINOVAC,2739,1395,1344
Guapó,520920,GO,Centro-Oeste,PFIZER/BIONTECH,194,194,0
Guaporé,430940,RS,Sul,FIOCRUZ/ASTRAZENECA,6331,5862,469
Guaporé,430940,RS,Sul,BUTANTAN/SINOVAC,5701,2869,2832
Guaporé,430940,RS,Sul,PFIZER/BIONTECH,309,309,0
Guaporema,410910,PR,Sul,FIOCRUZ/ASTRAZENECA,751,690,61
Guaporema,410910,PR,Sul,BUTANTAN/SINOVAC,596,320,276
Guaporema,410910,PR,Sul,PFIZER/BIONTECH,12,12,0
Guará,351770,SP,Sudeste,FIOCRUZ/ASTRAZENECA,4819,4291,528
Guará,351770,SP,Sudeste,BUTANTAN/SINOVAC,4317,2238,2079
Guará,351770,SP,Sudeste,PFIZER/BIONTECH,234,234,0
Guarabira,250630,PB,Nordeste,BUTANTAN/SINOVAC,12467,6413,6054
Guarabira,250630,PB,Nordeste,FIOCRUZ/ASTRAZENECA,9427,8574,853
Guarabira,250630,PB,Nordeste,PFIZER/BIONTECH,940,940,0
Guaraçaí,351780,SP,Sudeste,FIOCRUZ/ASTRAZENECA,2049,1833,216
Guaraçaí,351780,SP,Sudeste,BUTANTAN/SINOVAC,1973,1079,894
Guaraçaí,351780,SP,Sudeste,PFIZER/BIONTECH,205,205,0
Guaraci,351790,SP,Sudeste,BUTANTAN/SINOVAC,2242,1127,1115
Guaraci,351790,SP,Sudeste,FIOCRUZ/ASTRAZENECA,2012,1782,230
Guaraci,351790,SP,Sudeste,PFIZER/BIONTECH,191,191,0
Guaraci,410920,PR,Sul,FIOCRUZ/ASTRAZENECA,1642,1396,246
Guaraci,410920,PR,Sul,BUTANTAN/SINOVAC,1215,623,592
Guaraciaba,312820,MG,Sudeste,BUTANTAN/SINOVAC,2788,1457,1331
Guaraciaba,312820,MG,Sudeste,FIOCRUZ/ASTRAZENECA,2166,1914,252
Guaraciaba,312820,MG,Sudeste,PFIZER/BIONTECH,1,1,0
Guaraciaba,420640,SC,Sul,FIOCRUZ/ASTRAZENECA,3294,3000,294
Guaraciaba,420640,SC,Sul,BUTANTAN/SINOVAC,3006,1574,1432
Guaraciaba,420640,SC,Sul,PFIZER/BIONTECH,113,113,0
Guaraciaba Do Norte,230500,CE,Nordeste,BUTANTAN/SINOVAC,2086,1222,864
Guaraciaba Do Norte,230500,CE,Nordeste,FIOCRUZ/ASTRAZENECA,1164,1020,144
Guaraciama,312825,MG,Sudeste,FIOCRUZ/ASTRAZENECA,1083,1014,69
Guaraciama,312825,MG,Sudeste,BUTANTAN/SINOVAC,976,505,471
Guaraciama,312825,MG,Sudeste,PFIZER/BIONTECH,78,78,0
Guaraí,170930,TO,Norte,BUTANTAN/SINOVAC,4790,2446,2344
Guaraí,170930,TO,Norte,FIOCRUZ/ASTRAZENECA,4018,3717,301
Guaraíta,520929,GO,Centro-Oeste,FIOCRUZ/ASTRAZENECA,660,608,52
Guaraíta,520929,GO,Centro-Oeste,BUTANTAN/SINOVAC,481,255,226
Guaramiranga,230510,CE,Nordeste,FIOCRUZ/ASTRAZENECA,1014,948,66
Guaramiranga,230510,CE,Nordeste,BUTANTAN/SINOVAC,818,487,331
Guaramiranga,230510,CE,Nordeste,PFIZER/BIONTECH,22,22,0
Guaramirim,420650,SC,Sul,FIOCRUZ/ASTRAZENECA,5312,4729,583
Guaramirim,420650,SC,Sul,BUTANTAN/SINOVAC,4227,2337,1890
Guaramirim,420650,SC,Sul,PFIZER/BIONTECH,346,346,0
Guaranésia,312830,MG,Sudeste,BUTANTAN/SINOVAC,4452,2373,2079
Guaranésia,312830,MG,Sudeste,FIOCRUZ/ASTRAZENECA,3686,3366,320
Guaranésia,312830,MG,Sudeste,PFIZER/BIONTECH,60,60,0
Guarani,312840,MG,Sudeste,BUTANTAN/SINOVAC,2264,1123,1141
Guarani,312840,MG,Sudeste,FIOCRUZ/ASTRAZENECA,1982,1783,199
Guarani,312840,MG,Sudeste,PFIZER/BIONTECH,161,161,0
Guarani D'Oeste,351800,SP,Sudeste,BUTANTAN/SINOVAC,702,429,273
Guarani D'Oeste,351800,SP,Sudeste,FIOCRUZ/ASTRAZENECA,635,559,76
Guarani D'Oeste,351800,SP,Sudeste,PFIZER/BIONTECH,60,60,0
Guarani Das Missões,430950,RS,Sul,BUTANTAN/SINOVAC,2495,1354,1141
Guarani Das Missões,430950,RS,Sul,FIOCRUZ/ASTRAZENECA,2134,1921,213
Guarani Das Missões,430950,RS,Sul,PFIZER/BIONTECH,132,131,1
Guarani De Goiás,520940,GO,Centro-Oeste,FIOCRUZ/ASTRAZENECA,2013,1904,109
Guarani De Goiás,520940,GO,Centro-Oeste,BUTANTAN/SINOVAC,458,234,224
Guaraniaçu,410930,PR,Sul,BUTANTAN/SINOVAC,2777,1458,1319
Guaraniaçu,410930,PR,Sul,FIOCRUZ/ASTRAZENECA,2743,2590,153
Guarantã,351810,SP,Sudeste,BUTANTAN/SINOVAC,2348,1184,1164
Guarantã,351810,SP,Sudeste,FIOCRUZ/ASTRAZENECA,2063,1844,219
Guarantã,351810,SP,Sudeste,PFIZER/BIONTECH,59,59,0
Guarantã Do Norte,510410,MT,Centro-Oeste,BUTANTAN/SINOVAC,4819,2458,2361
Guarantã Do Norte,510410,MT,Centro-Oeste,FIOCRUZ/ASTRAZENECA,3679,3354,325
Guarantã Do Norte,510410,MT,Centro-Oeste,PFIZER/BIONTECH,259,258,1
Guarapari,320240,ES,Sudeste,FIOCRUZ/ASTRAZENECA,31012,29059,1953
Guarapari,320240,ES,Sudeste,BUTANTAN/SINOVAC,23866,12774,11092
Guarapari,320240,ES,Sudeste,PFIZER/BIONTECH,1194,1194,0
Guarapuava,410940,PR,Sul,FIOCRUZ/ASTRAZENECA,41974,39881,2093
Guarapuava,410940,PR,Sul,BUTANTAN/SINOVAC,26949,13559,13390
Guarapuava,410940,PR,Sul,PFIZER/BIONTECH,7067,7064,3
Guaraqueçaba,410950,PR,Sul,FIOCRUZ/ASTRAZENECA,3911,3775,136
Guaraqueçaba,410950,PR,Sul,BUTANTAN/SINOVAC,2119,1176,943
Guarará,312850,MG,Sudeste,FIOCRUZ/ASTRAZENECA,1074,988,86
Guarará,312850,MG,Sudeste,BUTANTAN/SINOVAC,1054,549,505
Guarará,312850,MG,Sudeste,PFIZER/BIONTECH,48,48,0
Guararapes,351820,SP,Sudeste,FIOCRUZ/ASTRAZENECA,7354,6791,563
Guararapes,351820,SP,Sudeste,BUTANTAN/SINOVAC,7124,3739,3385
Guararapes,351820,SP,Sudeste,PFIZER/BIONTECH,420,420,0
Guararema,351830,SP,Sudeste,BUTANTAN/SINOVAC,6199,3222,2977
Guararema,351830,SP,Sudeste,FIOCRUZ/ASTRAZENECA,5907,5558,349
Guararema,351830,SP,Sudeste,PFIZER/BIONTECH,282,282,0
Guaratinga,291180,BA,Nordeste,BUTANTAN/SINOVAC,1588,1078,510
Guaratinga,291180,BA,Nordeste,FIOCRUZ/ASTRAZENECA,512,486,26
Guaratinguetá,351840,SP,Sudeste,FIOCRUZ/ASTRAZENECA,28865,26171,2694
Guaratinguetá,351840,SP,Sudeste,BUTANTAN/SINOVAC,28804,14215,14589
Guaratinguetá,351840,SP,Sudeste,PFIZER/BIONTECH,882,870,12
Guaratuba,410960,PR,Sul,FIOCRUZ/ASTRAZENECA,7914,7452,462
Guaratuba,410960,PR,Sul,BUTANTAN/SINOVAC,7354,4054,3300
Guaratuba,410960,PR,Sul,PFIZER/BIONTECH,1082,1082,0
Guarda-Mor,312860,MG,Sudeste,FIOCRUZ/ASTRAZENECA,3148,2179,969
Guarda-Mor,312860,MG,Sudeste,BUTANTAN/SINOVAC,1401,708,693
Guarda-Mor,312860,MG,Sudeste,PFIZER/BIONTECH,112,112,0
Guareí,351850,SP,Sudeste,BUTANTAN/SINOVAC,3149,1675,1474
Guareí,351850,SP,Sudeste,FIOCRUZ/ASTRAZENECA,2316,2124,192
Guareí,351850,SP,Sudeste,PFIZER/BIONTECH,94,94,0
Guariba,351860,SP,Sudeste,FIOCRUZ/ASTRAZENECA,7579,7123,456
Guariba,351860,SP,Sudeste,BUTANTAN/SINOVAC,5882,3077,2805
Guariba,351860,SP,Sudeste,PFIZER/BIONTECH,543,543,0
Guaribas,220455,PI,Nordeste,FIOCRUZ/ASTRAZENECA,661,612,49
Guaribas,220455,PI,Nordeste,BUTANTAN/SINOVAC,512,259,253
Guaribas,220455,PI,Nordeste,PFIZER/BIONTECH,78,78,0
Guarinos,520945,GO,Centro-Oeste,FIOCRUZ/ASTRAZENECA,701,657,44
Guarinos,520945,GO,Centro-Oeste,BUTANTAN/SINOVAC,430,219,211
Guarujá,351870,SP,Sudeste,FIOCRUZ/ASTRAZENECA,55632,50069,5563
Guarujá,351870,SP,Sudeste,BUTANTAN/SINOVAC,51382,28126,23256
Guarujá,351870,SP,Sudeste,PFIZER/BIONTECH,1117,1111,6
Guarujá Do Sul,420660,SC,Sul,FIOCRUZ/ASTRAZENECA,1992,1850,142
Guarujá Do Sul,420660,SC,Sul,BUTANTAN/SINOVAC,1490,771,719
Guarulhos,351880,SP,Sudeste,FIOCRUZ/ASTRAZENECA,318253,296871,21382
Guarulhos,351880,SP,Sudeste,BUTANTAN/SINOVAC,203611,101522,102089
Guarulhos,351880,SP,Sudeste,PFIZER/BIONTECH,19222,19157,65
Guatambú,420665,SC,Sul,BUTANTAN/SINOVAC,1145,586,559
Guatambú,420665,SC,Sul,FIOCRUZ/ASTRAZENECA,1115,1005,110
Guatambú,420665,SC,Sul,PFIZER/BIONTECH,96,96,0
Guatapará,351885,SP,Sudeste,FIOCRUZ/ASTRAZENECA,1594,1427,167
Guatapará,351885,SP,Sudeste,BUTANTAN/SINOVAC,1587,731,856
Guatapará,351885,SP,Sudeste,PFIZER/BIONTECH,88,88,0
Guaxupé,312870,MG,Sudeste,BUTANTAN/SINOVAC,10297,5502,4795
Guaxupé,312870,MG,Sudeste,FIOCRUZ/ASTRAZENECA,7881,7362,519
Guaxupé,312870,MG,Sudeste,PFIZER/BIONTECH,1458,1458,0
Guia Lopes Da Laguna,500410,MS,Centro-Oeste,BUTANTAN/SINOVAC,2895,1677,1218
Guia Lopes Da Laguna,500410,MS,Centro-Oeste,FIOCRUZ/ASTRAZENECA,2872,2526,346
Guia Lopes Da Laguna,500410,MS,Centro-Oeste,PFIZER/BIONTECH,340,337,3
Guidoval,312880,MG,Sudeste,BUTANTAN/SINOVAC,2012,1052,960
Guidoval,312880,MG,Sudeste,FIOCRUZ/ASTRAZENECA,1665,1535,130
Guidoval,312880,MG,Sudeste,PFIZER/BIONTECH,56,56,0
Guimarães,210490,MA,Nordeste,FIOCRUZ/ASTRAZENECA,4425,4224,201
Guimarães,210490,MA,Nordeste,BUTANTAN/SINOVAC,2279,1176,1103
Guimarânia,312890,MG,Sudeste,FIOCRUZ/ASTRAZENECA,2240,2022,218
Guimarânia,312890,MG,Sudeste,BUTANTAN/SINOVAC,1840,928,912
Guimarânia,312890,MG,Sudeste,PFIZER/BIONTECH,175,175,0
Guiratinga,510420,MT,Centro-Oeste,BUTANTAN/SINOVAC,3672,2002,1670
Guiratinga,510420,MT,Centro-Oeste,FIOCRUZ/ASTRAZENECA,1991,1787,204
Guiratinga,510420,MT,Centro-Oeste,PFIZER/BIONTECH,85,84,1
Guiricema,312900,MG,Sudeste,BUTANTAN/SINOVAC,2552,1280,1272
Guiricema,312900,MG,Sudeste,FIOCRUZ/ASTRAZENECA,2011,1847,164
Guiricema,312900,MG,Sudeste,PFIZER/BIONTECH,78,78,0
Gurinhatã,312910,MG,Sudeste,BUTANTAN/SINOVAC,1927,996,931
Gurinhatã,312910,MG,Sudeste,FIOCRUZ/ASTRAZENECA,1214,1103,111
Gurinhatã,312910,MG,Sudeste,PFIZER/BIONTECH,12,12,0
Gurinhém,250640,PB,Nordeste,BUTANTAN/SINOVAC,2809,1430,1379
Gurinhém,250640,PB,Nordeste,FIOCRUZ/ASTRAZENECA,2144,2003,141
Gurinhém,250640,PB,Nordeste,PFIZER/BIONTECH,113,113,0
Gurjão,250650,PB,Nordeste,BUTANTAN/SINOVAC,822,474,348
Gurjão,250650,PB,Nordeste,FIOCRUZ/ASTRAZENECA,615,552,63
Gurjão,250650,PB,Nordeste,PFIZER/BIONTECH,60,60,0
Gurupá,150310,PA,Norte,FIOCRUZ/ASTRAZENECA,8328,6827,1501
Gurupá,150310,PA,Norte,BUTANTAN/SINOVAC,1406,763,643
Gurupi,170950,TO,Norte,FIOCRUZ/ASTRAZENECA,16435,15408,1027
Gurupi,170950,TO,Norte,BUTANTAN/SINOVAC,13534,6878,6656
Gurupi,170950,TO,Norte,PFIZER/BIONTECH,2971,2966,5
Guzolândia,351890,SP,Sudeste,FIOCRUZ/ASTRAZENECA,1104,1024,80
Guzolândia,351890,SP,Sudeste,BUTANTAN/SINOVAC,1029,530,499
Guzolândia,351890,SP,Sudeste,PFIZER/BIONTECH,77,77,0
Harmonia,430955,RS,Sul,BUTANTAN/SINOVAC,2328,1424,904
Harmonia,430955,RS,Sul,FIOCRUZ/ASTRAZENECA,1014,928,86
Harmonia,430955,RS,Sul,PFIZER/BIONTECH,101,101,0
Heitoraí,520960,GO,Centro-Oeste,FIOCRUZ/ASTRAZENECA,1096,1012,84
Heitoraí,520960,GO,Centro-Oeste,BUTANTAN/SINOVAC,859,453,406
Heliodora,312920,MG,Sudeste,BUTANTAN/SINOVAC,1454,746,708
Heliodora,312920,MG,Sudeste,FIOCRUZ/ASTRAZENECA,1431,1356,75
Heliodora,312920,MG,Sudeste,PFIZER/BIONTECH,89,89,0
Heliópolis,291185,BA,Nordeste,FIOCRUZ/ASTRAZENECA,2943,2794,149
Heliópolis,291185,BA,Nordeste,BUTANTAN/SINOVAC,2677,1348,1329
Heliópolis,291185,BA,Nordeste,PFIZER/BIONTECH,46,46,0
Herculândia,351900,SP,Sudeste,FIOCRUZ/ASTRAZENECA,3708,3282,426
Herculândia,351900,SP,Sudeste,BUTANTAN/SINOVAC,3351,1729,1622
Herculândia,351900,SP,Sudeste,PFIZER/BIONTECH,345,345,0
Herval,430710,RS,Sul,BUTANTAN/SINOVAC,2041,1051,990
Herval,430710,RS,Sul,FIOCRUZ/ASTRAZENECA,1719,1567,152
Herval,430710,RS,Sul,PFIZER/BIONTECH,242,242,0
Herval D'Oeste,420670,SC,Sul,FIOCRUZ/ASTRAZENECA,4880,4601,279
Herval D'Oeste,420670,SC,Sul,BUTANTAN/SINOVAC,4663,2421,2242
Herval D'Oeste,420670,SC,Sul,PFIZER/BIONTECH,241,241,0
Herveiras,430957,RS,Sul,FIOCRUZ/ASTRAZENECA,626,567,59
Herveiras,430957,RS,Sul,BUTANTAN/SINOVAC,606,309,297
Herveiras,430957,RS,Sul,PFIZER/BIONTECH,60,60,0
Hidrolândia,230520,CE,Nordeste,BUTANTAN/SINOVAC,3653,1904,1749
Hidrolândia,230520,CE,Nordeste,FIOCRUZ/ASTRAZENECA,2038,1572,466
Hidrolândia,520970,GO,Centro-Oeste,FIOCRUZ/ASTRAZENECA,5063,4745,318
Hidrolândia,520970,GO,Centro-Oeste,BUTANTAN/SINOVAC,3400,1800,1600
Hidrolândia,520970,GO,Centro-Oeste,PFIZER/BIONTECH,356,356,0
Hidrolina,520980,GO,Centro-Oeste,FIOCRUZ/ASTRAZENECA,1343,1241,102
Hidrolina,520980,GO,Centro-Oeste,BUTANTAN/SINOVAC,789,410,379
Holambra,351905,SP,Sudeste,BUTANTAN/SINOVAC,2649,1628,1021
Holambra,351905,SP,Sudeste,FIOCRUZ/ASTRAZENECA,2040,1925,115
Holambra,351905,SP,Sudeste,PFIZER/BIONTECH,123,120,3
Honório Serpa,410965,PR,Sul,FIOCRUZ/ASTRAZENECA,1275,1203,72
Honório Serpa,410965,PR,Sul,BUTANTAN/SINOVAC,1047,533,514
Horizonte,230523,CE,Nordeste,BUTANTAN/SINOVAC,4967,2815,2152
Horizonte,230523,CE,Nordeste,FIOCRUZ/ASTRAZENECA,2574,2493,81
Horizonte,230523,CE,Nordeste,PFIZER/BIONTECH,6,6,0
Horizontina,430960,RS,Sul,BUTANTAN/SINOVAC,5288,2724,2564
Horizontina,430960,RS,Sul,FIOCRUZ/ASTRAZENECA,4075,3626,449
Horizontina,430960,RS,Sul,PFIZER/BIONTECH,421,421,0
Hortolândia,351907,SP,Sudeste,FIOCRUZ/ASTRAZENECA,44415,40149,4266
Hortolândia,351907,SP,Sudeste,BUTANTAN/SINOVAC,43501,20093,23408
Hortolândia,351907,SP,Sudeste,PFIZER/BIONTECH,2459,2455,4
Hugo Napoleão,220460,PI,Nordeste,BUTANTAN/SINOVAC,1213,647,566
Hugo Napoleão,220460,PI,Nordeste,FIOCRUZ/ASTRAZENECA,769,722,47
Hulha Negra,430965,RS,Sul,FIOCRUZ/ASTRAZENECA,1537,1451,86
Hulha Negra,430965,RS,Sul,BUTANTAN/SINOVAC,1081,562,519
Hulha Negra,430965,RS,Sul,PFIZER/BIONTECH,163,163,0
Humaitá,130170,AM,Norte,FIOCRUZ/ASTRAZENECA,10423,8060,2363
Humaitá,130170,AM,Norte,BUTANTAN/SINOVAC,9058,4829,4229
Humaitá,430970,RS,Sul,BUTANTAN/SINOVAC,1433,724,709
Humaitá,430970,RS,Sul,FIOCRUZ/ASTRAZENECA,1370,1265,105
Humaitá,430970,RS,Sul,PFIZER/BIONTECH,46,46,0
Humberto De Campos,210500,MA,Nordeste,FIOCRUZ/ASTRAZENECA,3200,2924,276
Humberto De Campos,210500,MA,Nordeste,BUTANTAN/SINOVAC,3089,1632,1457
Iacanga,351910,SP,Sudeste,FIOCRUZ/ASTRAZENECA,2661,2398,263
Iacanga,351910,SP,Sudeste,BUTANTAN/SINOVAC,2533,1280,1253
Iacanga,351910,SP,Sudeste,PFIZER/BIONTECH,112,112,0
Iaciara,520990,GO,Centro-Oeste,FIOCRUZ/ASTRAZENECA,3669,3374,295
Iaciara,520990,GO,Centro-Oeste,BUTANTAN/SINOVAC,1102,585,517
Iacri,351920,SP,Sudeste,BUTANTAN/SINOVAC,1609,860,749
Iacri,351920,SP,Sudeste,FIOCRUZ/ASTRAZENECA,1452,1302,150
Iacri,351920,SP,Sudeste,PFIZER/BIONTECH,149,149,0
Iaçu,291190,BA,Nordeste,BUTANTAN/SINOVAC,4113,2114,1999
Iaçu,291190,BA,Nordeste,FIOCRUZ/ASTRAZENECA,4000,3788,212
Iaçu,291190,BA,Nordeste,PFIZER/BIONTECH,303,303,0
Iapu,312930,MG,Sudeste,FIOCRUZ/ASTRAZENECA,2538,2367,171
Iapu,312930,MG,Sudeste,BUTANTAN/SINOVAC,2215,1123,1092
Iapu,312930,MG,Sudeste,PFIZER/BIONTECH,139,139,0
Iaras,351925,SP,Sudeste,BUTANTAN/SINOVAC,1501,827,674
Iaras,351925,SP,Sudeste,FIOCRUZ/ASTRAZENECA,1482,1403,79
Iaras,351925,SP,Sudeste,PFIZER/BIONTECH,252,249,3
Iati,260650,PE,Nordeste,FIOCRUZ/ASTRAZENECA,4885,4222,663
Iati,260650,PE,Nordeste,BUTANTAN/SINOVAC,3234,1646,1588
Iati,260650,PE,Nordeste,PFIZER/BIONTECH,627,627,0
Ibaiti,410970,PR,Sul,BUTANTAN/SINOVAC,8193,4829,3364
Ibaiti,410970,PR,Sul,FIOCRUZ/ASTRAZENECA,7283,6812,471
Ibaiti,410970,PR,Sul,PFIZER/BIONTECH,580,580,0
Ibarama,430975,RS,Sul,BUTANTAN/SINOVAC,956,482,474
Ibarama,430975,RS,Sul,FIOCRUZ/ASTRAZENECA,863,794,69
Ibarama,430975,RS,Sul,PFIZER/BIONTECH,161,161,0
Ibaretama,230526,CE,Nordeste,BUTANTAN/SINOVAC,2368,1253,1115
Ibaretama,230526,CE,Nordeste,FIOCRUZ/ASTRAZENECA,1439,1278,161
Ibaté,351930,SP,Sudeste,FIOCRUZ/ASTRAZENECA,5852,5490,362
Ibaté,351930,SP,Sudeste,BUTANTAN/SINOVAC,5389,2783,2606
Ibaté,351930,SP,Sudeste,PFIZER/BIONTECH,610,610,0
Ibateguara,270300,AL,Nordeste,FIOCRUZ/ASTRAZENECA,2505,2278,227
Ibateguara,270300,AL,Nordeste,BUTANTAN/SINOVAC,2378,1230,1148
Ibatiba,320245,ES,Sudeste,BUTANTAN/SINOVAC,5705,2863,2842
Ibatiba,320245,ES,Sudeste,FIOCRUZ/ASTRAZENECA,5051,4852,199
Ibatiba,320245,ES,Sudeste,PFIZER/BIONTECH,915,913,2
Ibema,410975,PR,Sul,FIOCRUZ/ASTRAZENECA,1363,1288,75
Ibema,410975,PR,Sul,BUTANTAN/SINOVAC,1301,696,605
Ibertioga,312940,MG,Sudeste,BUTANTAN/SINOVAC,931,587,344
Ibertioga,312940,MG,Sudeste,FIOCRUZ/ASTRAZENECA,457,442,15
Ibertioga,312940,MG,Sudeste,PFIZER/BIONTECH,32,32,0
Ibiá,312950,MG,Sudeste,FIOCRUZ/ASTRAZENECA,4551,4183,368
Ibiá,312950,MG,Sudeste,BUTANTAN/SINOVAC,4476,2255,2221
Ibiá,312950,MG,Sudeste,PFIZER/BIONTECH,61,61,0
Ibiaçá,430980,RS,Sul,BUTANTAN/SINOVAC,1683,845,838
Ibiaçá,430980,RS,Sul,FIOCRUZ/ASTRAZENECA,1619,1496,123
Ibiaçá,430980,RS,Sul,PFIZER/BIONTECH,132,132,0
Ibiaí,312960,MG,Sudeste,BUTANTAN/SINOVAC,763,417,346
Ibiaí,312960,MG,Sudeste,FIOCRUZ/ASTRAZENECA,52,50,2
Ibiam,420675,SC,Sul,FIOCRUZ/ASTRAZENECA,580,543,37
Ibiam,420675,SC,Sul,BUTANTAN/SINOVAC,558,289,269
Ibiam,420675,SC,Sul,PFIZER/BIONTECH,67,67,0
Ibiapina,230530,CE,Nordeste,BUTANTAN/SINOVAC,4679,2350,2329
Ibiapina,230530,CE,Nordeste,FIOCRUZ/ASTRAZENECA,2700,2237,463
Ibiara,250660,PB,Nordeste,BUTANTAN/SINOVAC,1975,1012,963
Ibiara,250660,PB,Nordeste,FIOCRUZ/ASTRAZENECA,1067,961,106
Ibiara,250660,PB,Nordeste,PFIZER/BIONTECH,111,111,0
Ibiassucê,291200,BA,Nordeste,BUTANTAN/SINOVAC,2541,1297,1244
Ibiassucê,291200,BA,Nordeste,FIOCRUZ/ASTRAZENECA,2273,2063,210
Ibiassucê,291200,BA,Nordeste,PFIZER/BIONTECH,47,47,0
Ibicaraí,291210,BA,Nordeste,BUTANTAN/SINOVAC,5824,3069,2755
Ibicaraí,291210,BA,Nordeste,FIOCRUZ/ASTRAZENECA,5726,5286,440
Ibicaraí,291210,BA,Nordeste,PFIZER/BIONTECH,429,429,0
Ibicaré,420680,SC,Sul,BUTANTAN/SINOVAC,1043,562,481
Ibicaré,420680,SC,Sul,FIOCRUZ/ASTRAZENECA,957,883,74
Ibicaré,420680,SC,Sul,PFIZER/BIONTECH,116,115,1
Ibicoara,291220,BA,Nordeste,FIOCRUZ/ASTRAZENECA,2970,2729,241
Ibicoara,291220,BA,Nordeste,BUTANTAN/SINOVAC,1985,1083,902
Ibicoara,291220,BA,Nordeste,PFIZER/BIONTECH,252,252,0
Ibicuí,291230,BA,Nordeste,FIOCRUZ/ASTRAZENECA,6664,6187,477
Ibicuí,291230,BA,Nordeste,BUTANTAN/SINOVAC,3997,2047,1950
Ibicuí,291230,BA,Nordeste,PFIZER/BIONTECH,123,123,0
Ibicuitinga,230533,CE,Nordeste,BUTANTAN/SINOVAC,2548,1353,1195
Ibicuitinga,230533,CE,Nordeste,FIOCRUZ/ASTRAZENECA,1469,1219,250
Ibimirim,260660,PE,Nordeste,BUTANTAN/SINOVAC,7130,3606,3524
Ibimirim,260660,PE,Nordeste,FIOCRUZ/ASTRAZENECA,4020,3711,309
Ibimirim,260660,PE,Nordeste,PFIZER/BIONTECH,336,336,0
Ibipeba,291240,BA,Nordeste,FIOCRUZ/ASTRAZENECA,5750,5367,383
Ibipeba,291240,BA,Nordeste,BUTANTAN/SINOVAC,3443,1763,1680
Ibipeba,291240,BA,Nordeste,PFIZER/BIONTECH,22,22,0
Ibipitanga,291250,BA,Nordeste,BUTANTAN/SINOVAC,3256,1759,1497
Ibipitanga,291250,BA,Nordeste,FIOCRUZ/ASTRAZENECA,3183,2894,289
Ibipitanga,291250,BA,Nordeste,PFIZER/BIONTECH,212,212,0
Ibiporã,410980,PR,Sul,FIOCRUZ/ASTRAZENECA,13713,12834,879
Ibiporã,410980,PR,Sul,BUTANTAN/SINOVAC,9638,4941,4697
Ibiporã,410980,PR,Sul,PFIZER/BIONTECH,446,446,0
Ibiquera,291260,BA,Nordeste,BUTANTAN/SINOVAC,953,502,451
Ibiquera,291260,BA,Nordeste,FIOCRUZ/ASTRAZENECA,810,765,45
Ibirá,351940,SP,Sudeste,BUTANTAN/SINOVAC,4517,2534,1983
Ibirá,351940,SP,Sudeste,FIOCRUZ/ASTRAZENECA,2511,2254,257
Ibirá,351940,SP,Sudeste,PFIZER/BIONTECH,170,170,0
Ibiracatu,312965,MG,Sudeste,BUTANTAN/SINOVAC,1084,563,521
Ibiracatu,312965,MG,Sudeste,FIOCRUZ/ASTRAZENECA,855,775,80
Ibiracatu,312965,MG,Sudeste,PFIZER/BIONTECH,8,8,0
Ibiraci,312970,MG,Sudeste,FIOCRUZ/ASTRAZENECA,2436,2262,174
Ibiraci,312970,MG,Sudeste,BUTANTAN/SINOVAC,2324,1181,1143
Ibiraci,312970,MG,Sudeste,PFIZER/BIONTECH,305,305,0
Ibiraçu,320250,ES,Sudeste,BUTANTAN/SINOVAC,3322,1832,1490
Ibiraçu,320250,ES,Sudeste,FIOCRUZ/ASTRAZENECA,2744,2607,137
Ibiraçu,320250,ES,Sudeste,PFIZER/BIONTECH,314,314,0
Ibiraiaras,430990,RS,Sul,BUTANTAN/SINOVAC,2573,1327,1246
Ibiraiaras,430990,RS,Sul,FIOCRUZ/ASTRAZENECA,2094,1778,316
Ibiraiaras,430990,RS,Sul,PFIZER/BIONTECH,99,99,0
Ibirajuba,260670,PE,Nordeste,FIOCRUZ/ASTRAZENECA,1717,1509,208
Ibirajuba,260670,PE,Nordeste,BUTANTAN/SINOVAC,1584,873,711
Ibirajuba,260670,PE,Nordeste,PFIZER/BIONTECH,129,129,0
Ibirama,420690,SC,Sul,FIOCRUZ/ASTRAZENECA,4533,4106,427
Ibirama,420690,SC,Sul,BUTANTAN/SINOVAC,3621,1880,1741
Ibirapitanga,291270,BA,Nordeste,BUTANTAN/SINOVAC,4057,2121,1936
Ibirapitanga,291270,BA,Nordeste,FIOCRUZ/ASTRAZENECA,3085,2876,209
Ibirapitanga,291270,BA,Nordeste,PFIZER/BIONTECH,27,27,0
Ibirapuã,291280,BA,Nordeste,FIOCRUZ/ASTRAZENECA,1891,1773,118
Ibirapuã,291280,BA,Nordeste,BUTANTAN/SINOVAC,1647,853,794
Ibirapuã,291280,BA,Nordeste,PFIZER/BIONTECH,113,113,0
Ibirapuitã,430995,RS,Sul,BUTANTAN/SINOVAC,1056,540,516
Ibirapuitã,430995,RS,Sul,FIOCRUZ/ASTRAZENECA,1049,916,133
Ibirapuitã,430995,RS,Sul,PFIZER/BIONTECH,172,171,1
Ibirarema,351950,SP,Sudeste,BUTANTAN/SINOVAC,1893,1002,891
Ibirarema,351950,SP,Sudeste,FIOCRUZ/ASTRAZENECA,1631,1501,130
Ibirarema,351950,SP,Sudeste,PFIZER/BIONTECH,125,125,0
Ibirataia,291290,BA,Nordeste,FIOCRUZ/ASTRAZENECA,4110,3640,470
Ibirataia,291290,BA,Nordeste,BUTANTAN/SINOVAC,3379,1783,1596
Ibirataia,291290,BA,Nordeste,PFIZER/BIONTECH,223,223,0
Ibirité,312980,MG,Sudeste,FIOCRUZ/ASTRAZENECA,26590,24556,2034
Ibirité,312980,MG,Sudeste,BUTANTAN/SINOVAC,23100,12012,11088
Ibirité,312980,MG,Sudeste,PFIZER/BIONTECH,1973,1972,1
Ibirubá,431000,RS,Sul,BUTANTAN/SINOVAC,5514,2795,2719
Ibirubá,431000,RS,Sul,FIOCRUZ/ASTRAZENECA,5406,4968,438
Ibirubá,431000,RS,Sul,PFIZER/BIONTECH,254,254,0
Ibitiara,291300,BA,Nordeste,BUTANTAN/SINOVAC,3597,1942,1655
Ibitiara,291300,BA,Nordeste,FIOCRUZ/ASTRAZENECA,2922,2688,234
Ibitiara,291300,BA,Nordeste,PFIZER/BIONTECH,18,18,0
Ibitinga,351960,SP,Sudeste,BUTANTAN/SINOVAC,12621,6909,5712
Ibitinga,351960,SP,Sudeste,FIOCRUZ/ASTRAZENECA,11428,10423,1005
Ibitinga,351960,SP,Sudeste,PFIZER/BIONTECH,298,292,6
Ibitirama,320255,ES,Sudeste,BUTANTAN/SINOVAC,1824,967,857
Ibitirama,320255,ES,Sudeste,FIOCRUZ/ASTRAZENECA,1524,1438,86
Ibitirama,320255,ES,Sudeste,PFIZER/BIONTECH,76,76,0
Ibititá,291310,BA,Nordeste,FIOCRUZ/ASTRAZENECA,7064,6333,731
Ibititá,291310,BA,Nordeste,BUTANTAN/SINOVAC,4011,2202,1809
Ibititá,291310,BA,Nordeste,PFIZER/BIONTECH,46,46,0
Ibitiúra De Minas,312990,MG,Sudeste,BUTANTAN/SINOVAC,232,164,68
Ibitiúra De Minas,312990,MG,Sudeste,FIOCRUZ/ASTRAZENECA,75,75,0
Ibitiúra De Minas,312990,MG,Sudeste,PFIZER/BIONTECH,32,32,0
Ibituruna,313000,MG,Sudeste,BUTANTAN/SINOVAC,812,430,382
Ibituruna,313000,MG,Sudeste,FIOCRUZ/ASTRAZENECA,638,576,62
Ibituruna,313000,MG,Sudeste,PFIZER/BIONTECH,49,49,0
Ibiúna,351970,SP,Sudeste,BUTANTAN/SINOVAC,14360,7799,6561
Ibiúna,351970,SP,Sudeste,FIOCRUZ/ASTRAZENECA,13742,12110,1632
Ibiúna,351970,SP,Sudeste,PFIZER/BIONTECH,529,529,0
Ibotirama,291320,BA,Nordeste,FIOCRUZ/ASTRAZENECA,5921,5591,330
Ibotirama,291320,BA,Nordeste,BUTANTAN/SINOVAC,5725,2991,2734
Ibotirama,291320,BA,Nordeste,PFIZER/BIONTECH,211,211,0
Icapuí,230535,CE,Nordeste,FIOCRUZ/ASTRAZENECA,4577,4294,283
Icapuí,230535,CE,Nordeste,BUTANTAN/SINOVAC,3668,1903,1765
Icapuí,230535,CE,Nordeste,PFIZER/BIONTECH,331,331,0
Içara,420700,SC,Sul,FIOCRUZ/ASTRAZENECA,11418,10580,838
Içara,420700,SC,Sul,BUTANTAN/SINOVAC,8265,4541,3724
Içara,420700,SC,Sul,PFIZER/BIONTECH,1071,1071,0
Icaraí De Minas,313005,MG,Sudeste,FIOCRUZ/ASTRAZENECA,1766,1618,148
Icaraí De Minas,313005,MG,Sudeste,BUTANTAN/SINOVAC,1626,824,802
Icaraí De Minas,313005,MG,Sudeste,PFIZER/BIONTECH,114,114,0
Icaraíma,410990,PR,Sul,FIOCRUZ/ASTRAZENECA,2563,2413,150
Icaraíma,410990,PR,Sul,BUTANTAN/SINOVAC,2041,1040,1001
Icaraíma,410990,PR,Sul,PFIZER/BIONTECH,107,107,0
Icatu,210510,MA,Nordeste,FIOCRUZ/ASTRAZENECA,5656,5334,322
Icatu,210510,MA,Nordeste,BUTANTAN/SINOVAC,3277,1751,1526
Icém,351980,SP,Sudeste,FIOCRUZ/ASTRAZENECA,2330,2089,241
Icém,351980,SP,Sudeste,BUTANTAN/SINOVAC,2158,1120,1038
Icém,351980,SP,Sudeste,PFIZER/BIONTECH,131,131,0
Ichu,291330,BA,Nordeste,BUTANTAN/SINOVAC,1391,744,647
Ichu,291330,BA,Nordeste,FIOCRUZ/ASTRAZENECA,1365,1189,176
Ichu,291330,BA,Nordeste,PFIZER/BIONTECH,339,339,0
Icó,230540,CE,Nordeste,BUTANTAN/SINOVAC,8387,4971,3416
Icó,230540,CE,Nordeste,FIOCRUZ/ASTRAZENECA,3724,3238,486
Icó,230540,CE,Nordeste,PFIZER/BIONTECH,1,1,0
Iconha,320260,ES,Sudeste,BUTANTAN/SINOVAC,4184,2150,2034
Iconha,320260,ES,Sudeste,FIOCRUZ/ASTRAZENECA,2990,2852,138
Iconha,320260,ES,Sudeste,PFIZER/BIONTECH,490,490,0
Ielmo Marinho,240460,RN,Nordeste,FIOCRUZ/ASTRAZENECA,2679,2599,80
Ielmo Marinho,240460,RN,Nordeste,BUTANTAN/SINOVAC,2150,1137,1013
Ielmo Marinho,240460,RN,Nordeste,PFIZER/BIONTECH,110,110,0
Iepê,351990,SP,Sudeste,FIOCRUZ/ASTRAZENECA,2185,1997,188
Iepê,351990,SP,Sudeste,BUTANTAN/SINOVAC,1995,1043,952
Iepê,351990,SP,Sudeste,PFIZER/BIONTECH,191,191,0
Igaci,270310,AL,Nordeste,FIOCRUZ/ASTRAZENECA,5348,4771,577
Igaci,270310,AL,Nordeste,BUTANTAN/SINOVAC,4834,2574,2260
Igaporã,291340,BA,Nordeste,BUTANTAN/SINOVAC,3699,1912,1787
Igaporã,291340,BA,Nordeste,FIOCRUZ/ASTRAZENECA,2758,2531,227
Igaraçu Do Tietê,352000,SP,Sudeste,FIOCRUZ/ASTRAZENECA,4874,4587,287
Igaraçu Do Tietê,352000,SP,Sudeste,BUTANTAN/SINOVAC,3668,1865,1803
Igaraçu Do Tietê,352000,SP,Sudeste,PFIZER/BIONTECH,511,511,0
Igaracy,250260,PB,Nordeste,BUTANTAN/SINOVAC,1600,818,782
Igaracy,250260,PB,Nordeste,FIOCRUZ/ASTRAZENECA,762,738,24
Igarapava,352010,SP,Sudeste,FIOCRUZ/ASTRAZENECA,6926,6393,533
Igarapava,352010,SP,Sudeste,BUTANTAN/SINOVAC,6163,3067,3096
Igarapava,352010,SP,Sudeste,PFIZER/BIONTECH,457,451,6
Igarapé,313010,MG,Sudeste,FIOCRUZ/ASTRAZENECA,6847,6369,478
Igarapé,313010,MG,Sudeste,BUTANTAN/SINOVAC,5919,3108,2811
Igarapé,313010,MG,Sudeste,PFIZER/BIONTECH,885,884,1
Igarapé Do Meio,210515,MA,Nordeste,BUTANTAN/SINOVAC,2484,1507,977
Igarapé Do Meio,210515,MA,Nordeste,FIOCRUZ/ASTRAZENECA,2464,2337,127
Igarapé Grande,210520,MA,Nordeste,FIOCRUZ/ASTRAZENECA,3288,2840,448
Igarapé Grande,210520,MA,Nordeste,BUTANTAN/SINOVAC,2158,1231,927
Igarapé-Açu,150320,PA,Norte,BUTANTAN/SINOVAC,7473,3974,3499
Igarapé-Açu,150320,PA,Norte,FIOCRUZ/ASTRAZENECA,6030,4581,1449
Igarapé-Miri,150330,PA,Norte,FIOCRUZ/ASTRAZENECA,17787,15744,2043
Igarapé-Miri,150330,PA,Norte,BUTANTAN/SINOVAC,6423,3485,2938
Igarassu,260680,PE,Nordeste,BUTANTAN/SINOVAC,22167,13370,8797
Igarassu,260680,PE,Nordeste,FIOCRUZ/ASTRAZENECA,9079,7771,1308
Igarassu,260680,PE,Nordeste,PFIZER/BIONTECH,515,514,1
Igaratá,352020,SP,Sudeste,FIOCRUZ/ASTRAZENECA,2573,2342,231
Igaratá,352020,SP,Sudeste,BUTANTAN/SINOVAC,2243,1172,1071
Igaratá,352020,SP,Sudeste,PFIZER/BIONTECH,90,90,0
Igaratinga,313020,MG,Sudeste,FIOCRUZ/ASTRAZENECA,2061,1880,181
Igaratinga,313020,MG,Sudeste,BUTANTAN/SINOVAC,1822,967,855
Igaratinga,313020,MG,Sudeste,PFIZER/BIONTECH,93,93,0
Igrapiúna,291345,BA,Nordeste,FIOCRUZ/ASTRAZENECA,2325,2227,98
Igrapiúna,291345,BA,Nordeste,BUTANTAN/SINOVAC,1833,1001,832
Igrapiúna,291345,BA,Nordeste,PFIZER/BIONTECH,36,36,0
Igreja Nova,270320,AL,Nordeste,FIOCRUZ/ASTRAZENECA,6437,5904,533
Igreja Nova,270320,AL,Nordeste,BUTANTAN/SINOVAC,3667,1996,1671
Igrejinha,431010,RS,Sul,FIOCRUZ/ASTRAZENECA,8478,8021,457
Igrejinha,431010,RS,Sul,BUTANTAN/SINOVAC,7688,3845,3843
Igrejinha,431010,RS,Sul,PFIZER/BIONTECH,854,853,1
Iguaba Grande,330187,RJ,Sudeste,FIOCRUZ/ASTRAZENECA,10327,9739,588
Iguaba Grande,330187,RJ,Sudeste,BUTANTAN/SINOVAC,6905,3748,3157
Iguaba Grande,330187,RJ,Sudeste,PFIZER/BIONTECH,1352,1352,0
Iguaí,291350,BA,Nordeste,BUTANTAN/SINOVAC,3817,2514,1303
Iguaí,291350,BA,Nordeste,FIOCRUZ/ASTRAZENECA,1771,1749,22
Iguape,352030,SP,Sudeste,FIOCRUZ/ASTRAZENECA,8049,7525,524
Iguape,352030,SP,Sudeste,BUTANTAN/SINOVAC,7307,3857,3450
Iguape,352030,SP,Sudeste,PFIZER/BIONTECH,513,513,0
Iguaraçu,411000,PR,Sul,FIOCRUZ/ASTRAZENECA,1513,1446,67
Iguaraçu,411000,PR,Sul,BUTANTAN/SINOVAC,878,452,426
Iguaracy,260690,PE,Nordeste,FIOCRUZ/ASTRAZENECA,3521,3243,278
Iguaracy,260690,PE,Nordeste,BUTANTAN/SINOVAC,2465,1254,1211
Iguaracy,260690,PE,Nordeste,PFIZER/BIONTECH,139,139,0
Iguatama,313030,MG,Sudeste,BUTANTAN/SINOVAC,2261,1220,1041
Iguatama,313030,MG,Sudeste,FIOCRUZ/ASTRAZENECA,1829,1664,165
Iguatama,313030,MG,Sudeste,PFIZER/BIONTECH,41,41,0
Iguatemi,500430,MS,Centro-Oeste,FIOCRUZ/ASTRAZENECA,4323,4139,184
Iguatemi,500430,MS,Centro-Oeste,BUTANTAN/SINOVAC,3793,2057,1736
Iguatemi,500430,MS,Centro-Oeste,PFIZER/BIONTECH,374,374,0
Iguatu,230550,CE,Nordeste,BUTANTAN/SINOVAC,12529,8285,4244
Iguatu,230550,CE,Nordeste,FIOCRUZ/ASTRAZENECA,4182,3857,325
Iguatu,230550,CE,Nordeste,PFIZER/BIONTECH,1,1,0
Iguatu,411005,PR,Sul,FIOCRUZ/ASTRAZENECA,661,618,43
Iguatu,411005,PR,Sul,BUTANTAN/SINOVAC,571,292,279
Iguatu,411005,PR,Sul,PFIZER/BIONTECH,12,12,0
Ijaci,313040,MG,Sudeste,FIOCRUZ/ASTRAZENECA,1406,1300,106
Ijaci,313040,MG,Sudeste,BUTANTAN/SINOVAC,1185,633,552
Ijaci,313040,MG,Sudeste,PFIZER/BIONTECH,70,70,0
Ijuí,431020,RS,Sul,BUTANTAN/SINOVAC,25107,12899,12208
Ijuí,431020,RS,Sul,FIOCRUZ/ASTRAZENECA,21223,18968,2255
Ijuí,431020,RS,Sul,PFIZER/BIONTECH,1376,1372,4
Ilha Comprida,352042,SP,Sudeste,FIOCRUZ/ASTRAZENECA,4013,3836,177
Ilha Comprida,352042,SP,Sudeste,BUTANTAN/SINOVAC,3342,1739,1603
Ilha Comprida,352042,SP,Sudeste,PFIZER/BIONTECH,278,273,5
Ilha Das Flores,280270,SE,Nordeste,FIOCRUZ/ASTRAZENECA,1677,1582,95
Ilha Das Flores,280270,SE,Nordeste,BUTANTAN/SINOVAC,1320,670,650
Ilha Das Flores,280270,SE,Nordeste,PFIZER/BIONTECH,92,92,0
Ilha De Itamaracá,260760,PE,Nordeste,BUTANTAN/SINOVAC,3591,1814,1777
Ilha De Itamaracá,260760,PE,Nordeste,FIOCRUZ/ASTRAZENECA,2401,2254,147
Ilha De Itamaracá,260760,PE,Nordeste,PFIZER/BIONTECH,59,59,0
Ilha Grande,220465,PI,Nordeste,BUTANTAN/SINOVAC,1274,673,601
Ilha Grande,220465,PI,Nordeste,FIOCRUZ/ASTRAZENECA,1261,1161,100
Ilha Solteira,352044,SP,Sudeste,BUTANTAN/SINOVAC,8659,4385,4274
Ilha Solteira,352044,SP,Sudeste,FIOCRUZ/ASTRAZENECA,7998,7427,571
Ilha Solteira,352044,SP,Sudeste,PFIZER/BIONTECH,148,148,0
Ilhabela,352040,SP,Sudeste,FIOCRUZ/ASTRAZENECA,7186,6703,483
Ilhabela,352040,SP,Sudeste,BUTANTAN/SINOVAC,6932,3666,3266
Ilhabela,352040,SP,Sudeste,PFIZER/BIONTECH,583,583,0
Ilhéus,291360,BA,Nordeste,BUTANTAN/SINOVAC,32905,18616,14289
Ilhéus,291360,BA,Nordeste,FIOCRUZ/ASTRAZENECA,17389,16312,1077
Ilhéus,291360,BA,Nordeste,PFIZER/BIONTECH,50,50,0
Ilhota,420710,SC,Sul,BUTANTAN/SINOVAC,2021,1091,930
Ilhota,420710,SC,Sul,FIOCRUZ/ASTRAZENECA,1609,1563,46
Ilicínea,313050,MG,Sudeste,FIOCRUZ/ASTRAZENECA,2254,2062,192
Ilicínea,313050,MG,Sudeste,BUTANTAN/SINOVAC,2214,1159,1055
Ilicínea,313050,MG,Sudeste,PFIZER/BIONTECH,51,51,0
Ilópolis,431030,RS,Sul,BUTANTAN/SINOVAC,1715,880,835
Ilópolis,431030,RS,Sul,FIOCRUZ/ASTRAZENECA,1250,1102,148
Ilópolis,431030,RS,Sul,PFIZER/BIONTECH,80,78,2
Imaculada,250670,PB,Nordeste,BUTANTAN/SINOVAC,2346,1277,1069
Imaculada,250670,PB,Nordeste,FIOCRUZ/ASTRAZENECA,1160,1051,109
Imaculada,250670,PB,Nordeste,PFIZER/BIONTECH,56,56,0
Imaruí,420720,SC,Sul,FIOCRUZ/ASTRAZENECA,3738,3251,487
Imaruí,420720,SC,Sul,BUTANTAN/SINOVAC,2885,1575,1310
Imaruí,420720,SC,Sul,PFIZER/BIONTECH,212,212,0
Imbaú,411007,PR,Sul,FIOCRUZ/ASTRAZENECA,2262,2182,80
Imbaú,411007,PR,Sul,BUTANTAN/SINOVAC,2144,1156,988
Imbé,431033,RS,Sul,BUTANTAN/SINOVAC,7740,5053,2687
Imbé,431033,RS,Sul,FIOCRUZ/ASTRAZENECA,5840,5595,245
Imbé,431033,RS,Sul,PFIZER/BIONTECH,690,689,1
Imbé De Minas,313055,MG,Sudeste,BUTANTAN/SINOVAC,256,132,124
Imbé De Minas,313055,MG,Sudeste,FIOCRUZ/ASTRAZENECA,159,106,53
Imbituba,420730,SC,Sul,BUTANTAN/SINOVAC,9082,4892,4190
Imbituba,420730,SC,Sul,FIOCRUZ/ASTRAZENECA,5555,5348,207
Imbituva,411010,PR,Sul,FIOCRUZ/ASTRAZENECA,4863,4648,215
Imbituva,411010,PR,Sul,BUTANTAN/SINOVAC,4589,2420,2169
Imbituva,411010,PR,Sul,PFIZER/BIONTECH,82,82,0
Imbuia,420740,SC,Sul,FIOCRUZ/ASTRAZENECA,1462,1322,140
Imbuia,420740,SC,Sul,BUTANTAN/SINOVAC,1046,565,481
Imbuia,420740,SC,Sul,PFIZER/BIONTECH,183,183,0
Imigrante,431036,RS,Sul,BUTANTAN/SINOVAC,988,539,449
Imigrante,431036,RS,Sul,FIOCRUZ/ASTRAZENECA,718,642,76
Imigrante,431036,RS,Sul,PFIZER/BIONTECH,65,65,0
Imperatriz,210530,MA,Nordeste,FIOCRUZ/ASTRAZENECA,53559,48959,4600
Imperatriz,210530,MA,Nordeste,BUTANTAN/SINOVAC,37145,20280,16865
Imperatriz,210530,MA,Nordeste,PFIZER/BIONTECH,1655,1653,2
Inácio Martins,411020,PR,Sul,FIOCRUZ/ASTRAZENECA,2522,2400,122
Inácio Martins,411020,PR,Sul,BUTANTAN/SINOVAC,1912,1037,875
Inácio Martins,411020,PR,Sul,PFIZER/BIONTECH,21,21,0
Inaciolândia,520993,GO,Centro-Oeste,FIOCRUZ/ASTRAZENECA,1726,1617,109
Inaciolândia,520993,GO,Centro-Oeste,BUTANTAN/SINOVAC,1108,570,538
Inaciolândia,520993,GO,Centro-Oeste,PFIZER/BIONTECH,86,86,0
Inajá,260700,PE,Nordeste,BUTANTAN/SINOVAC,3564,1848,1716
Inajá,260700,PE,Nordeste,FIOCRUZ/ASTRAZENECA,2981,2736,245
Inajá,260700,PE,Nordeste,PFIZER/BIONTECH,201,201,0
Inajá,411030,PR,Sul,FIOCRUZ/ASTRAZENECA,849,786,63
Inajá,411030,PR,Sul,BUTANTAN/SINOVAC,774,409,365
Inajá,411030,PR,Sul,PFIZER/BIONTECH,18,18,0
Inconfidentes,313060,MG,Sudeste,BUTANTAN/SINOVAC,1528,765,763
Inconfidentes,313060,MG,Sudeste,FIOCRUZ/ASTRAZENECA,515,474,41
Indaiabira,313065,MG,Sudeste,BUTANTAN/SINOVAC,1594,811,783
Indaiabira,313065,MG,Sudeste,FIOCRUZ/ASTRAZENECA,1226,1134,92
Indaiabira,313065,MG,Sudeste,PFIZER/BIONTECH,13,13,0
Indaial,420750,SC,Sul,BUTANTAN/SINOVAC,16856,9648,7208
Indaial,420750,SC,Sul,FIOCRUZ/ASTRAZENECA,12265,11923,342
Indaial,420750,SC,Sul,PFIZER/BIONTECH,873,867,6
Indaiatuba,352050,SP,Sudeste,FIOCRUZ/ASTRAZENECA,52480,49126,3354
Indaiatuba,352050,SP,Sudeste,BUTANTAN/SINOVAC,45814,23942,21872
Indaiatuba,352050,SP,Sudeste,PFIZER/BIONTECH,5062,5062,0
Independência,230560,CE,Nordeste,BUTANTAN/SINOVAC,4722,2825,1897
Independência,230560,CE,Nordeste,FIOCRUZ/ASTRAZENECA,1789,1625,164
Independência,431040,RS,Sul,BUTANTAN/SINOVAC,1934,982,952
Independência,431040,RS,Sul,FIOCRUZ/ASTRAZENECA,1865,1717,148
Independência,431040,RS,Sul,PFIZER/BIONTECH,195,195,0
Indiana,352060,SP,Sudeste,BUTANTAN/SINOVAC,1520,844,676
Indiana,352060,SP,Sudeste,FIOCRUZ/ASTRAZENECA,1298,1169,129
Indiana,352060,SP,Sudeste,PFIZER/BIONTECH,83,83,0
Indianópolis,313070,MG,Sudeste,FIOCRUZ/ASTRAZENECA,1193,1093,100
Indianópolis,313070,MG,Sudeste,BUTANTAN/SINOVAC,1094,569,525
Indianópolis,313070,MG,Sudeste,PFIZER/BIONTECH,79,79,0
Indianópolis,411040,PR,Sul,FIOCRUZ/ASTRAZENECA,1542,1466,76
Indianópolis,411040,PR,Sul,BUTANTAN/SINOVAC,1227,635,592
Indianópolis,411040,PR,Sul,PFIZER/BIONTECH,20,20,0
Indiaporã,352070,SP,Sudeste,BUTANTAN/SINOVAC,1380,709,671
Indiaporã,352070,SP,Sudeste,FIOCRUZ/ASTRAZENECA,1097,953,144
Indiaporã,352070,SP,Sudeste,PFIZER/BIONTECH,238,238,0
Indiara,520995,GO,Centro-Oeste,FIOCRUZ/ASTRAZENECA,3468,3279,189
Indiara,520995,GO,Centro-Oeste,BUTANTAN/SINOVAC,2237,1149,1088
Indiara,520995,GO,Centro-Oeste,PFIZER/BIONTECH,138,138,0
Indiaroba,280280,SE,Nordeste,BUTANTAN/SINOVAC,2445,1243,1202
Indiaroba,280280,SE,Nordeste,FIOCRUZ/ASTRAZENECA,2098,1978,120
Indiaroba,280280,SE,Nordeste,PFIZER/BIONTECH,67,67,0
Indiavaí,510450,MT,Centro-Oeste,FIOCRUZ/ASTRAZENECA,703,672,31
Indiavaí,510450,MT,Centro-Oeste,BUTANTAN/SINOVAC,627,330,297
Indiavaí,510450,MT,Centro-Oeste,PFIZER/BIONTECH,9,9,0
Ingá,250680,PB,Nordeste,BUTANTAN/SINOVAC,4993,2543,2450
Ingá,250680,PB,Nordeste,FIOCRUZ/ASTRAZENECA,4499,4208,291
Ingá,250680,PB,Nordeste,PFIZER/BIONTECH,506,506,0
Ingaí,313080,MG,Sudeste,BUTANTAN/SINOVAC,694,361,333
Ingaí,313080,MG,Sudeste,FIOCRUZ/ASTRAZENECA,653,593,60
Ingaí,313080,MG,Sudeste,PFIZER/BIONTECH,39,39,0
Ingazeira,260710,PE,Nordeste,FIOCRUZ/ASTRAZENECA,1227,1118,109
Ingazeira,260710,PE,Nordeste,BUTANTAN/SINOVAC,1103,574,529
Ingazeira,260710,PE,Nordeste,PFIZER/BIONTECH,157,157,0
Inhacorá,431041,RS,Sul,FIOCRUZ/ASTRAZENECA,556,502,54
Inhacorá,431041,RS,Sul,BUTANTAN/SINOVAC,538,297,241
Inhacorá,431041,RS,Sul,PFIZER/BIONTECH,125,125,0
Inhambupe,291370,BA,Nordeste,FIOCRUZ/ASTRAZENECA,5755,5281,474
Inhambupe,291370,BA,Nordeste,BUTANTAN/SINOVAC,5543,3008,2535
Inhambupe,291370,BA,Nordeste,PFIZER/BIONTECH,326,326,0
Inhangapi,150340,PA,Norte,BUTANTAN/SINOVAC,4300,2219,2081
Inhangapi,150340,PA,Norte,FIOCRUZ/ASTRAZENECA,1847,1630,217
Inhapi,270330,AL,Nordeste,BUTANTAN/SINOVAC,3224,1654,1570
Inhapi,270330,AL,Nordeste,FIOCRUZ/ASTRAZENECA,3159,2861,298
Inhapim,313090,MG,Sudeste,BUTANTAN/SINOVAC,4652,2408,2244
Inhapim,313090,MG,Sudeste,FIOCRUZ/ASTRAZENECA,3109,2864,245
Inhapim,313090,MG,Sudeste,PFIZER/BIONTECH,181,181,0
Inhaúma,313100,MG,Sudeste,BUTANTAN/SINOVAC,1249,676,573
Inhaúma,313100,MG,Sudeste,FIOCRUZ/ASTRAZENECA,839,759,80
Inhuma,220470,PI,Nordeste,FIOCRUZ/ASTRAZENECA,2982,2676,306
Inhuma,220470,PI,Nordeste,BUTANTAN/SINOVAC,2540,1303,1237
Inhuma,220470,PI,Nordeste,PFIZER/BIONTECH,114,114,0
Inhumas,521000,GO,Centro-Oeste,FIOCRUZ/ASTRAZENECA,13978,12864,1114
Inhumas,521000,GO,Centro-Oeste,BUTANTAN/SINOVAC,10562,5560,5002
Inhumas,521000,GO,Centro-Oeste,PFIZER/BIONTECH,462,461,1
Inimutaba,313110,MG,Sudeste,BUTANTAN/SINOVAC,1581,805,776
Inimutaba,313110,MG,Sudeste,FIOCRUZ/ASTRAZENECA,1354,1230,124
Inimutaba,313110,MG,Sudeste,PFIZER/BIONTECH,87,87,0
Inocência,500440,MS,Centro-Oeste,BUTANTAN/SINOVAC,2258,1197,1061
Inocência,500440,MS,Centro-Oeste,FIOCRUZ/ASTRAZENECA,1852,1628,224
Inocência,500440,MS,Centro-Oeste,PFIZER/BIONTECH,297,297,0
Inúbia Paulista,352080,SP,Sudeste,BUTANTAN/SINOVAC,962,510,452
Inúbia Paulista,352080,SP,Sudeste,FIOCRUZ/ASTRAZENECA,833,729,104
Inúbia Paulista,352080,SP,Sudeste,PFIZER/BIONTECH,120,120,0
Iomerê,420757,SC,Sul,BUTANTAN/SINOVAC,892,462,430
Iomerê,420757,SC,Sul,FIOCRUZ/ASTRAZENECA,750,658,92
Iomerê,420757,SC,Sul,PFIZER/BIONTECH,79,79,0
Ipaba,313115,MG,Sudeste,BUTANTAN/SINOVAC,2417,1249,1168
Ipaba,313115,MG,Sudeste,FIOCRUZ/ASTRAZENECA,1445,1243,202
Ipaba,313115,MG,Sudeste,PFIZER/BIONTECH,1,1,0
Ipameri,521010,GO,Centro-Oeste,FIOCRUZ/ASTRAZENECA,8005,7327,678
Ipameri,521010,GO,Centro-Oeste,BUTANTAN/SINOVAC,4175,2248,1927
Ipanema,313120,MG,Sudeste,BUTANTAN/SINOVAC,4947,2604,2343
Ipanema,313120,MG,Sudeste,FIOCRUZ/ASTRAZENECA,3473,3242,231
Ipanema,313120,MG,Sudeste,PFIZER/BIONTECH,362,362,0
Ipanguaçu,240470,RN,Nordeste,FIOCRUZ/ASTRAZENECA,2884,2508,376
Ipanguaçu,240470,RN,Nordeste,BUTANTAN/SINOVAC,1930,1044,886
Ipanguaçu,240470,RN,Nordeste,PFIZER/BIONTECH,149,149,0
Ipaporanga,230565,CE,Nordeste,BUTANTAN/SINOVAC,2631,1353,1278
Ipaporanga,230565,CE,Nordeste,FIOCRUZ/ASTRAZENECA,1345,1056,289
Ipatinga,313130,MG,Sudeste,BUTANTAN/SINOVAC,50299,25471,24828
Ipatinga,313130,MG,Sudeste,FIOCRUZ/ASTRAZENECA,37710,34685,3025
Ipatinga,313130,MG,Sudeste,PFIZER/BIONTECH,926,926,0
Ipaumirim,230570,CE,Nordeste,BUTANTAN/SINOVAC,1595,856,739
Ipaumirim,230570,CE,Nordeste,FIOCRUZ/ASTRAZENECA,827,717,110
Ipaussu,352090,SP,Sudeste,FIOCRUZ/ASTRAZENECA,3231,2986,245
Ipaussu,352090,SP,Sudeste,BUTANTAN/SINOVAC,2902,1494,1408
Ipaussu,352090,SP,Sudeste,PFIZER/BIONTECH,176,176,0
Ipê,431043,RS,Sul,BUTANTAN/SINOVAC,1917,994,923
Ipê,431043,RS,Sul,FIOCRUZ/ASTRAZENECA,1897,1748,149
Ipê,431043,RS,Sul,PFIZER/BIONTECH,182,182,0
Ipecaetá,291380,BA,Nordeste,BUTANTAN/SINOVAC,3257,1677,1580
Ipecaetá,291380,BA,Nordeste,FIOCRUZ/ASTRAZENECA,2458,2257,201
Ipecaetá,291380,BA,Nordeste,PFIZER/BIONTECH,282,282,0
Iperó,352100,SP,Sudeste,FIOCRUZ/ASTRAZENECA,5412,5108,304
Iperó,352100,SP,Sudeste,BUTANTAN/SINOVAC,4869,2501,2368
Iperó,352100,SP,Sudeste,PFIZER/BIONTECH,211,210,1
Ipeúna,352110,SP,Sudeste,FIOCRUZ/ASTRAZENECA,1618,1531,87
Ipeúna,352110,SP,Sudeste,BUTANTAN/SINOVAC,994,558,436
Ipeúna,352110,SP,Sudeste,PFIZER/BIONTECH,88,88,0
Ipiaçu,313140,MG,Sudeste,BUTANTAN/SINOVAC,1647,898,749
Ipiaçu,313140,MG,Sudeste,FIOCRUZ/ASTRAZENECA,343,257,86
Ipiaú,291390,BA,Nordeste,BUTANTAN/SINOVAC,8684,4678,4006
Ipiaú,291390,BA,Nordeste,FIOCRUZ/ASTRAZENECA,6191,5484,707
Ipiaú,291390,BA,Nordeste,PFIZER/BIONTECH,115,115,0
Ipiguá,352115,SP,Sudeste,FIOCRUZ/ASTRAZENECA,1358,1249,109
Ipiguá,352115,SP,Sudeste,BUTANTAN/SINOVAC,1340,701,639
Ipiguá,352115,SP,Sudeste,PFIZER/BIONTECH,145,145,0
Ipira,420760,SC,Sul,BUTANTAN/SINOVAC,1285,650,635
Ipira,420760,SC,Sul,FIOCRUZ/ASTRAZENECA,1088,933,155
Ipira,420760,SC,Sul,PFIZER/BIONTECH,60,60,0
Ipirá,291400,BA,Nordeste,BUTANTAN/SINOVAC,11590,6578,5012
Ipirá,291400,BA,Nordeste,FIOCRUZ/ASTRAZENECA,6408,5945,463
Ipirá,291400,BA,Nordeste,PFIZER/BIONTECH,523,519,4
Ipiranga,411050,PR,Sul,FIOCRUZ/ASTRAZENECA,3991,3846,145
Ipiranga,411050,PR,Sul,BUTANTAN/SINOVAC,1827,853,974
Ipiranga,411050,PR,Sul,PFIZER/BIONTECH,642,609,33
Ipiranga De Goiás,521015,GO,Centro-Oeste,FIOCRUZ/ASTRAZENECA,963,901,62
Ipiranga De Goiás,521015,GO,Centro-Oeste,BUTANTAN/SINOVAC,571,312,259
Ipiranga Do Norte,510452,MT,Centro-Oeste,FIOCRUZ/ASTRAZENECA,738,679,59
Ipiranga Do Norte,510452,MT,Centro-Oeste,BUTANTAN/SINOVAC,688,355,333
Ipiranga Do Norte,510452,MT,Centro-Oeste,PFIZER/BIONTECH,83,83,0
Ipiranga Do Piauí,220480,PI,Nordeste,FIOCRUZ/ASTRAZENECA,2124,1906,218
Ipiranga Do Piauí,220480,PI,Nordeste,BUTANTAN/SINOVAC,1656,853,803
Ipiranga Do Piauí,220480,PI,Nordeste,PFIZER/BIONTECH,81,81,0
Ipiranga Do Sul,431046,RS,Sul,BUTANTAN/SINOVAC,751,394,357
Ipiranga Do Sul,431046,RS,Sul,FIOCRUZ/ASTRAZENECA,633,586,47
Ipiranga Do Sul,431046,RS,Sul,PFIZER/BIONTECH,73,72,1
Ipixuna,130180,AM,Norte,FIOCRUZ/ASTRAZENECA,2351,1960,391
Ipixuna,130180,AM,Norte,BUTANTAN/SINOVAC,1446,820,626
Ipixuna Do Pará,150345,PA,Norte,FIOCRUZ/ASTRAZENECA,4129,3010,1119
Ipixuna Do Pará,150345,PA,Norte,BUTANTAN/SINOVAC,3349,1810,1539
Ipojuca,260720,PE,Nordeste,FIOCRUZ/ASTRAZENECA,14966,14601,365
Ipojuca,260720,PE,Nordeste,BUTANTAN/SINOVAC,10669,6396,4273
Ipojuca,260720,PE,Nordeste,PFIZER/BIONTECH,1789,1787,2
Iporá,521020,GO,Centro-Oeste,FIOCRUZ/ASTRAZENECA,10413,9354,1059
Iporá,521020,GO,Centro-Oeste,BUTANTAN/SINOVAC,8764,4504,4260
Iporá,521020,GO,Centro-Oeste,PFIZER/BIONTECH,1327,1327,0
Iporã,411060,PR,Sul,FIOCRUZ/ASTRAZENECA,3441,3246,195
Iporã,411060,PR,Sul,BUTANTAN/SINOVAC,3365,1846,1519
Iporã,411060,PR,Sul,PFIZER/BIONTECH,439,439,0
Iporã Do Oeste,420765,SC,Sul,FIOCRUZ/ASTRAZENECA,2873,2670,203
Iporã Do Oeste,420765,SC,Sul,BUTANTAN/SINOVAC,2239,1191,1048
Iporã Do Oeste,420765,SC,Sul,PFIZER/BIONTECH,120,120,0
Iporanga,352120,SP,Sudeste,BUTANTAN/SINOVAC,1577,775,802
Iporanga,352120,SP,Sudeste,FIOCRUZ/ASTRAZENECA,1148,1095,53
Iporanga,352120,SP,Sudeste,PFIZER/BIONTECH,94,94,0
Ipu,230580,CE,Nordeste,BUTANTAN/SINOVAC,7237,3878,3359
Ipu,230580,CE,Nordeste,FIOCRUZ/ASTRAZENECA,6009,5378,631
Ipuã,352130,SP,Sudeste,FIOCRUZ/ASTRAZENECA,3303,3071,232
Ipuã,352130,SP,Sudeste,BUTANTAN/SINOVAC,2893,1476,1417
Ipuã,352130,SP,Sudeste,PFIZER/BIONTECH,151,151,0
Ipuaçu,420768,SC,Sul,BUTANTAN/SINOVAC,1126,572,554
Ipuaçu,420768,SC,Sul,FIOCRUZ/ASTRAZENECA,1075,944,131
Ipuaçu,420768,SC,Sul,PFIZER/BIONTECH,84,84,0
Ipubi,260730,PE,Nordeste,FIOCRUZ/ASTRAZENECA,4604,4265,339
Ipubi,260730,PE,Nordeste,BUTANTAN/SINOVAC,4136,2151,1985
Ipubi,260730,PE,Nordeste,PFIZER/BIONTECH,432,432,0
Ipueira,240480,RN,Nordeste,BUTANTAN/SINOVAC,747,420,327
Ipueira,240480,RN,Nordeste,FIOCRUZ/ASTRAZENECA,610,579,31
Ipueira,240480,RN,Nordeste,PFIZER/BIONTECH,84,84,0
Ipueiras,170980,TO,Norte,BUTANTAN/SINOVAC,441,227,214
Ipueiras,170980,TO,Norte,FIOCRUZ/ASTRAZENECA,284,275,9
Ipueiras,230590,CE,Nordeste,BUTANTAN/SINOVAC,5515,2928,2587
Ipueiras,230590,CE,Nordeste,FIOCRUZ/ASTRAZENECA,4672,3496,1176
Ipuiúna,313150,MG,Sudeste,BUTANTAN/SINOVAC,1519,988,531
Ipuiúna,313150,MG,Sudeste,FIOCRUZ/ASTRAZENECA,531,516,15
Ipuiúna,313150,MG,Sudeste,PFIZER/BIONTECH,9,9,0
Ipumirim,420770,SC,Sul,BUTANTAN/SINOVAC,1850,979,871
Ipumirim,420770,SC,Sul,FIOCRUZ/ASTRAZENECA,1829,1654,175
Ipumirim,420770,SC,Sul,PFIZER/BIONTECH,192,192,0
Ipupiara,291410,BA,Nordeste,BUTANTAN/SINOVAC,2340,1230,1110
Ipupiara,291410,BA,Nordeste,FIOCRUZ/ASTRAZENECA,2071,1999,72
Iracema,140028,RR,Norte,BUTANTAN/SINOVAC,1729,922,807
Iracema,140028,RR,Norte,FIOCRUZ/ASTRAZENECA,797,796,1
Iracema,230600,CE,Nordeste,BUTANTAN/SINOVAC,3585,1869,1716
Iracema,230600,CE,Nordeste,FIOCRUZ/ASTRAZENECA,1849,1628,221
Iracema Do Oeste,411065,PR,Sul,FIOCRUZ/ASTRAZENECA,779,728,51
Iracema Do Oeste,411065,PR,Sul,BUTANTAN/SINOVAC,631,341,290
Iracema Do Oeste,411065,PR,Sul,PFIZER/BIONTECH,11,11,0
Iracemápolis,352140,SP,Sudeste,FIOCRUZ/ASTRAZENECA,4560,4252,308
Iracemápolis,352140,SP,Sudeste,BUTANTAN/SINOVAC,4414,2169,2245
Iracemápolis,352140,SP,Sudeste,PFIZER/BIONTECH,252,252,0
Iraceminha,420775,SC,Sul,BUTANTAN/SINOVAC,1203,616,587
Iraceminha,420775,SC,Sul,FIOCRUZ/ASTRAZENECA,1199,1093,106
Iraí,431050,RS,Sul,BUTANTAN/SINOVAC,2577,1331,1246
Iraí,431050,RS,Sul,FIOCRUZ/ASTRAZENECA,1804,1633,171
Iraí,431050,RS,Sul,PFIZER/BIONTECH,184,184,0
Iraí De Minas,313160,MG,Sudeste,BUTANTAN/SINOVAC,1253,632,621
Iraí De Minas,313160,MG,Sudeste,FIOCRUZ/ASTRAZENECA,1070,948,122
Iraí De Minas,313160,MG,Sudeste,PFIZER/BIONTECH,136,136,0
Irajuba,291420,BA,Nordeste,FIOCRUZ/ASTRAZENECA,1247,1189,58
Irajuba,291420,BA,Nordeste,BUTANTAN/SINOVAC,1227,653,574
Irajuba,291420,BA,Nordeste,PFIZER/BIONTECH,10,10,0
Iramaia,291430,BA,Nordeste,FIOCRUZ/ASTRAZENECA,1880,1770,110
Iramaia,291430,BA,Nordeste,BUTANTAN/SINOVAC,1507,819,688
Iramaia,291430,BA,Nordeste,PFIZER/BIONTECH,51,51,0
Iranduba,130185,AM,Norte,FIOCRUZ/ASTRAZENECA,20989,19161,1828
Iranduba,130185,AM,Norte,BUTANTAN/SINOVAC,4847,2696,2151
Irani,420780,SC,Sul,FIOCRUZ/ASTRAZENECA,2526,2347,179
Irani,420780,SC,Sul,BUTANTAN/SINOVAC,2021,1094,927
Irani,420780,SC,Sul,PFIZER/BIONTECH,187,187,0
Irapuã,352150,SP,Sudeste,FIOCRUZ/ASTRAZENECA,3005,2799,206
Irapuã,352150,SP,Sudeste,BUTANTAN/SINOVAC,2866,1456,1410
Irapuã,352150,SP,Sudeste,PFIZER/BIONTECH,75,74,1
Irapuru,352160,SP,Sudeste,BUTANTAN/SINOVAC,2001,1119,882
Irapuru,352160,SP,Sudeste,FIOCRUZ/ASTRAZENECA,1930,1735,195
Irapuru,352160,SP,Sudeste,PFIZER/BIONTECH,133,133,0
Iraquara,291440,BA,Nordeste,FIOCRUZ/ASTRAZENECA,4501,4083,418
Iraquara,291440,BA,Nordeste,BUTANTAN/SINOVAC,3697,1920,1777
Iraquara,291440,BA,Nordeste,PFIZER/BIONTECH,54,54,0
Irará,291450,BA,Nordeste,FIOCRUZ/ASTRAZENECA,6254,5781,473
Irará,291450,BA,Nordeste,BUTANTAN/SINOVAC,5751,3004,2747
Irará,291450,BA,Nordeste,PFIZER/BIONTECH,620,620,0
Irati,411070,PR,Sul,FIOCRUZ/ASTRAZENECA,13665,12886,779
Irati,411070,PR,Sul,BUTANTAN/SINOVAC,11857,6077,5780
Irati,411070,PR,Sul,PFIZER/BIONTECH,1683,1683,0
Irati,420785,SC,Sul,BUTANTAN/SINOVAC,1124,582,542
Irati,420785,SC,Sul,FIOCRUZ/ASTRAZENECA,862,784,78
Irati,420785,SC,Sul,PFIZER/BIONTECH,72,72,0
Irauçuba,230610,CE,Nordeste,BUTANTAN/SINOVAC,5828,3215,2613
Irauçuba,230610,CE,Nordeste,FIOCRUZ/ASTRAZENECA,1531,1193,338
Irauçuba,230610,CE,Nordeste,PFIZER/BIONTECH,6,6,0
Irecê,291460,BA,Nordeste,BUTANTAN/SINOVAC,12759,6698,6061
Irecê,291460,BA,Nordeste,FIOCRUZ/ASTRAZENECA,9681,9065,616
Iretama,411080,PR,Sul,FIOCRUZ/ASTRAZENECA,2703,2516,187
Iretama,411080,PR,Sul,BUTANTAN/SINOVAC,2476,1260,1216
Irineópolis,420790,SC,Sul,FIOCRUZ/ASTRAZENECA,2184,2012,172
Irineópolis,420790,SC,Sul,BUTANTAN/SINOVAC,1836,960,876
Irineópolis,420790,SC,Sul,PFIZER/BIONTECH,120,120,0
Irituia,150350,PA,Norte,BUTANTAN/SINOVAC,7847,4360,3487
Irituia,150350,PA,Norte,FIOCRUZ/ASTRAZENECA,6867,6305,562
Irupi,320265,ES,Sudeste,BUTANTAN/SINOVAC,3684,2036,1648
Irupi,320265,ES,Sudeste,FIOCRUZ/ASTRAZENECA,2092,2017,75
Irupi,320265,ES,Sudeste,PFIZER/BIONTECH,126,126,0
Isaías Coelho,220490,PI,Nordeste,FIOCRUZ/ASTRAZENECA,2218,2114,104
Isaías Coelho,220490,PI,Nordeste,BUTANTAN/SINOVAC,1469,740,729
Israelândia,521030,GO,Centro-Oeste,FIOCRUZ/ASTRAZENECA,600,555,45
Israelândia,521030,GO,Centro-Oeste,BUTANTAN/SINOVAC,542,311,231
Itá,420800,SC,Sul,BUTANTAN/SINOVAC,1618,863,755
Itá,420800,SC,Sul,FIOCRUZ/ASTRAZENECA,1584,1428,156
Itá,420800,SC,Sul,PFIZER/BIONTECH,150,150,0
Itaara,431053,RS,Sul,FIOCRUZ/ASTRAZENECA,1462,1338,124
Itaara,431053,RS,Sul,BUTANTAN/SINOVAC,1277,661,616
Itaara,431053,RS,Sul,PFIZER/BIONTECH,160,160,0
Itabaiana,250690,PB,Nordeste,BUTANTAN/SINOVAC,6513,3335,3178
Itabaiana,250690,PB,Nordeste,FIOCRUZ/ASTRAZENECA,5185,4671,514
Itabaiana,250690,PB,Nordeste,PFIZER/BIONTECH,903,902,1
Itabaiana,280290,SE,Nordeste,FIOCRUZ/ASTRAZENECA,19353,18481,872
Itabaiana,280290,SE,Nordeste,BUTANTAN/SINOVAC,14015,7354,6661
Itabaiana,280290,SE,Nordeste,PFIZER/BIONTECH,2766,2764,2
Itabaianinha,280300,SE,Nordeste,FIOCRUZ/ASTRAZENECA,7451,6817,634
Itabaianinha,280300,SE,Nordeste,BUTANTAN/SINOVAC,6010,3144,2866
Itabaianinha,280300,SE,Nordeste,PFIZER/BIONTECH,833,833,0
Itabela,291465,BA,Nordeste,BUTANTAN/SINOVAC,3686,1954,1732
Itabela,291465,BA,Nordeste,FIOCRUZ/ASTRAZENECA,3558,2973,585
Itabela,291465,BA,Nordeste,PFIZER/BIONTECH,140,139,1
Itaberá,352170,SP,Sudeste,FIOCRUZ/ASTRAZENECA,4239,3876,363
Itaberá,352170,SP,Sudeste,BUTANTAN/SINOVAC,4157,2101,2056
Itaberá,352170,SP,Sudeste,PFIZER/BIONTECH,522,521,1
Itaberaba,291470,BA,Nordeste,BUTANTAN/SINOVAC,11354,5738,5616
Itaberaba,291470,BA,Nordeste,FIOCRUZ/ASTRAZENECA,11209,10352,857
Itaberaba,291470,BA,Nordeste,PFIZER/BIONTECH,121,121,0
Itaberaí,521040,GO,Centro-Oeste,FIOCRUZ/ASTRAZENECA,9154,8514,640
Itaberaí,521040,GO,Centro-Oeste,BUTANTAN/SINOVAC,7369,4056,3313
Itaberaí,521040,GO,Centro-Oeste,PFIZER/BIONTECH,627,627,0
Itabi,280310,SE,Nordeste,BUTANTAN/SINOVAC,1336,679,657
Itabi,280310,SE,Nordeste,FIOCRUZ/ASTRAZENECA,878,878,0
Itabi,280310,SE,Nordeste,PFIZER/BIONTECH,129,128,1
Itabira,313170,MG,Sudeste,BUTANTAN/SINOVAC,22035,11236,10799
Itabira,313170,MG,Sudeste,FIOCRUZ/ASTRAZENECA,15579,14132,1447
Itabira,313170,MG,Sudeste,PFIZER/BIONTECH,1029,1029,0
Itabirinha,313180,MG,Sudeste,FIOCRUZ/ASTRAZENECA,2686,2495,191
Itabirinha,313180,MG,Sudeste,BUTANTAN/SINOVAC,2420,1278,1142
Itabirinha,313180,MG,Sudeste,PFIZER/BIONTECH,261,261,0
Itabirito,313190,MG,Sudeste,BUTANTAN/SINOVAC,9549,4936,4613
Itabirito,313190,MG,Sudeste,FIOCRUZ/ASTRAZENECA,9355,8498,857
Itabirito,313190,MG,Sudeste,PFIZER/BIONTECH,2036,2036,0
Itaboraí,330190,RJ,Sudeste,BUTANTAN/SINOVAC,45015,23801,21214
Itaboraí,330190,RJ,Sudeste,FIOCRUZ/ASTRAZENECA,24736,22814,1922
Itaboraí,330190,RJ,Sudeste,PFIZER/BIONTECH,25,25,0
Itabuna,291480,BA,Nordeste,BUTANTAN/SINOVAC,35295,21011,14284
Itabuna,291480,BA,Nordeste,FIOCRUZ/ASTRAZENECA,31200,27430,3770
Itacajá,171050,TO,Norte,BUTANTAN/SINOVAC,2101,1122,979
Itacajá,171050,TO,Norte,FIOCRUZ/ASTRAZENECA,917,837,80
Itacambira,313200,MG,Sudeste,BUTANTAN/SINOVAC,966,481,485
Itacambira,313200,MG,Sudeste,FIOCRUZ/ASTRAZENECA,820,769,51
Itacambira,313200,MG,Sudeste,PFIZER/BIONTECH,57,57,0
Itacarambi,313210,MG,Sudeste,BUTANTAN/SINOVAC,2860,1456,1404
Itacarambi,313210,MG,Sudeste,FIOCRUZ/ASTRAZENECA,2188,1918,270
Itacarambi,313210,MG,Sudeste,PFIZER/BIONTECH,59,59,0
Itacaré,291490,BA,Nordeste,FIOCRUZ/ASTRAZENECA,2660,2506,154
Itacaré,291490,BA,Nordeste,BUTANTAN/SINOVAC,2392,1408,984
Itacaré,291490,BA,Nordeste,PFIZER/BIONTECH,38,38,0
Itacoatiara,130190,AM,Norte,FIOCRUZ/ASTRAZENECA,19165,15975,3190
Itacoatiara,130190,AM,Norte,BUTANTAN/SINOVAC,10994,6120,4874
Itacuruba,260740,PE,Nordeste,FIOCRUZ/ASTRAZENECA,1931,1846,85
Itacuruba,260740,PE,Nordeste,BUTANTAN/SINOVAC,1039,534,505
Itacuruba,260740,PE,Nordeste,PFIZER/BIONTECH,185,185,0
Itacurubi,431055,RS,Sul,BUTANTAN/SINOVAC,986,501,485
Itacurubi,431055,RS,Sul,FIOCRUZ/ASTRAZENECA,858,793,65
Itacurubi,431055,RS,Sul,PFIZER/BIONTECH,90,90,0
Itaeté,291500,BA,Nordeste,BUTANTAN/SINOVAC,576,531,45
Itaeté,291500,BA,Nordeste,FIOCRUZ/ASTRAZENECA,167,166,1
Itagi,291510,BA,Nordeste,BUTANTAN/SINOVAC,3074,1595,1479
Itagi,291510,BA,Nordeste,FIOCRUZ/ASTRAZENECA,2908,2500,408
Itagi,291510,BA,Nordeste,PFIZER/BIONTECH,326,326,0
Itagibá,291520,BA,Nordeste,FIOCRUZ/ASTRAZENECA,2878,2731,147
Itagibá,291520,BA,Nordeste,BUTANTAN/SINOVAC,2324,1384,940
Itagibá,291520,BA,Nordeste,PFIZER/BIONTECH,86,86,0
Itagimirim,291530,BA,Nordeste,FIOCRUZ/ASTRAZENECA,1526,1289,237
Itagimirim,291530,BA,Nordeste,BUTANTAN/SINOVAC,1507,786,721
Itagimirim,291530,BA,Nordeste,PFIZER/BIONTECH,12,12,0
Itaguaçu,320270,ES,Sudeste,BUTANTAN/SINOVAC,4750,2434,2316
Itaguaçu,320270,ES,Sudeste,FIOCRUZ/ASTRAZENECA,2847,2645,202
Itaguaçu,320270,ES,Sudeste,PFIZER/BIONTECH,451,451,0
Itaguaçu Da Bahia,291535,BA,Nordeste,FIOCRUZ/ASTRAZENECA,3975,3778,197
Itaguaçu Da Bahia,291535,BA,Nordeste,BUTANTAN/SINOVAC,1963,1044,919
Itaguaçu Da Bahia,291535,BA,Nordeste,PFIZER/BIONTECH,136,136,0
Itaguaí,330200,RJ,Sudeste,FIOCRUZ/ASTRAZENECA,23165,21429,1736
Itaguaí,330200,RJ,Sudeste,BUTANTAN/SINOVAC,20630,11453,9177
Itaguaí,330200,RJ,Sudeste,PFIZER/BIONTECH,1926,1924,2
Itaguajé,411090,PR,Sul,FIOCRUZ/ASTRAZENECA,1051,1002,49
Itaguajé,411090,PR,Sul,BUTANTAN/SINOVAC,996,518,478
Itaguara,313220,MG,Sudeste,FIOCRUZ/ASTRAZENECA,3192,2929,263
Itaguara,313220,MG,Sudeste,BUTANTAN/SINOVAC,2994,1562,1432
Itaguara,313220,MG,Sudeste,PFIZER/BIONTECH,154,154,0
Itaguari,521056,GO,Centro-Oeste,FIOCRUZ/ASTRAZENECA,1393,1315,78
Itaguari,521056,GO,Centro-Oeste,BUTANTAN/SINOVAC,982,500,482
Itaguari,521056,GO,Centro-Oeste,PFIZER/BIONTECH,55,55,0
Itaguaru,521060,GO,Centro-Oeste,FIOCRUZ/ASTRAZENECA,1764,1628,136
Itaguaru,521060,GO,Centro-Oeste,BUTANTAN/SINOVAC,1142,578,564
Itaguatins,171070,TO,Norte,BUTANTAN/SINOVAC,1111,595,516
Itaguatins,171070,TO,Norte,FIOCRUZ/ASTRAZENECA,818,789,29
Itaguatins,171070,TO,Norte,PFIZER/BIONTECH,6,6,0
Itaí,352180,SP,Sudeste,FIOCRUZ/ASTRAZENECA,5831,5488,343
Itaí,352180,SP,Sudeste,BUTANTAN/SINOVAC,5021,2900,2121
Itaí,352180,SP,Sudeste,PFIZER/BIONTECH,659,659,0
Itaíba,260750,PE,Nordeste,FIOCRUZ/ASTRAZENECA,9011,7964,1047
Itaíba,260750,PE,Nordeste,BUTANTAN/SINOVAC,4204,2178,2026
Itaíba,260750,PE,Nordeste,PFIZER/BIONTECH,851,851,0
Itaiçaba,230620,CE,Nordeste,BUTANTAN/SINOVAC,1859,954,905
Itaiçaba,230620,CE,Nordeste,FIOCRUZ/ASTRAZENECA,1699,1508,191
Itaiçaba,230620,CE,Nordeste,PFIZER/BIONTECH,96,96,0
Itainópolis,220500,PI,Nordeste,BUTANTAN/SINOVAC,2248,1182,1066
Itainópolis,220500,PI,Nordeste,FIOCRUZ/ASTRAZENECA,2086,1903,183
Itaiópolis,420810,SC,Sul,FIOCRUZ/ASTRAZENECA,4458,4073,385
Itaiópolis,420810,SC,Sul,BUTANTAN/SINOVAC,3569,1928,1641
Itaiópolis,420810,SC,Sul,PFIZER/BIONTECH,353,353,0
Itaipava Do Grajaú,210535,MA,Nordeste,FIOCRUZ/ASTRAZENECA,1823,1603,220
Itaipava Do Grajaú,210535,MA,Nordeste,BUTANTAN/SINOVAC,1657,876,781
Itaipé,313230,MG,Sudeste,BUTANTAN/SINOVAC,1890,969,921
Itaipé,313230,MG,Sudeste,FIOCRUZ/ASTRAZENECA,1548,1437,111
Itaipé,313230,MG,Sudeste,PFIZER/BIONTECH,67,67,0
Itaipulândia,411095,PR,Sul,BUTANTAN/SINOVAC,2850,1499,1351
Itaipulândia,411095,PR,Sul,FIOCRUZ/ASTRAZENECA,2130,1961,169
Itaipulândia,411095,PR,Sul,PFIZER/BIONTECH,143,143,0
Itaitinga,230625,CE,Nordeste,FIOCRUZ/ASTRAZENECA,8354,8026,328
Itaitinga,230625,CE,Nordeste,BUTANTAN/SINOVAC,4713,2579,2134
Itaitinga,230625,CE,Nordeste,PFIZER/BIONTECH,10,10,0
Itaituba,150360,PA,Norte,FIOCRUZ/ASTRAZENECA,17960,14482,3478
Itaituba,150360,PA,Norte,BUTANTAN/SINOVAC,5685,3206,2479
Itajá,240485,RN,Nordeste,BUTANTAN/SINOVAC,1512,821,691
Itajá,240485,RN,Nordeste,FIOCRUZ/ASTRAZENECA,1407,1358,49
Itajá,240485,RN,Nordeste,PFIZER/BIONTECH,231,231,0
Itajá,521080,GO,Centro-Oeste,FIOCRUZ/ASTRAZENECA,1591,1505,86
Itajá,521080,GO,Centro-Oeste,BUTANTAN/SINOVAC,1112,576,536
Itajaí,420820,SC,Sul,BUTANTAN/SINOVAC,34412,17520,16892
Itajaí,420820,SC,Sul,FIOCRUZ/ASTRAZENECA,25557,24168,1389
Itajaí,420820,SC,Sul,PFIZER/BIONTECH,3832,3832,0
Itajobi,352190,SP,Sudeste,BUTANTAN/SINOVAC,4420,2446,1974
Itajobi,352190,SP,Sudeste,FIOCRUZ/ASTRAZENECA,3975,3575,400
Itajobi,352190,SP,Sudeste,PFIZER/BIONTECH,329,329,0
Itaju,352200,SP,Sudeste,BUTANTAN/SINOVAC,1288,705,583
Itaju,352200,SP,Sudeste,FIOCRUZ/ASTRAZENECA,1046,951,95
Itaju,352200,SP,Sudeste,PFIZER/BIONTECH,38,38,0
Itaju Do Colônia,291540,BA,Nordeste,BUTANTAN/SINOVAC,2227,1259,968
Itaju Do Colônia,291540,BA,Nordeste,FIOCRUZ/ASTRAZENECA,1083,994,89
Itaju Do Colônia,291540,BA,Nordeste,PFIZER/BIONTECH,1,1,0
Itajubá,313240,MG,Sudeste,BUTANTAN/SINOVAC,20859,10878,9981
Itajubá,313240,MG,Sudeste,FIOCRUZ/ASTRAZENECA,15677,13956,1721
Itajubá,313240,MG,Sudeste,PFIZER/BIONTECH,1167,1163,4
Itajuípe,291550,BA,Nordeste,BUTANTAN/SINOVAC,4273,2249,2024
Itajuípe,291550,BA,Nordeste,FIOCRUZ/ASTRAZENECA,3921,3673,248
Itajuípe,291550,BA,Nordeste,PFIZER/BIONTECH,8,8,0
Italva,330205,RJ,Sudeste,BUTANTAN/SINOVAC,2899,1627,1272
Italva,330205,RJ,Sudeste,FIOCRUZ/ASTRAZENECA,2661,2390,271
Itamaraju,291560,BA,Nordeste,BUTANTAN/SINOVAC,7723,5681,2042
Itamaraju,291560,BA,Nordeste,FIOCRUZ/ASTRAZENECA,5647,5406,241
Itamaraju,291560,BA,Nordeste,PFIZER/BIONTECH,40,40,0
Itamarandiba,313250,MG,Sudeste,BUTANTAN/SINOVAC,5802,3191,2611
Itamarandiba,313250,MG,Sudeste,FIOCRUZ/ASTRAZENECA,5290,4875,415
Itamarandiba,313250,MG,Sudeste,PFIZER/BIONTECH,840,840,0
Itamarati,130195,AM,Norte,FIOCRUZ/ASTRAZENECA,1222,1142,80
Itamarati,130195,AM,Norte,BUTANTAN/SINOVAC,636,322,314
Itamarati De Minas,313260,MG,Sudeste,BUTANTAN/SINOVAC,1055,543,512
Itamarati De Minas,313260,MG,Sudeste,FIOCRUZ/ASTRAZENECA,867,809,58
Itamarati De Minas,313260,MG,Sudeste,PFIZER/BIONTECH,36,36,0
Itamari,291570,BA,Nordeste,BUTANTAN/SINOVAC,1073,687,386
Itamari,291570,BA,Nordeste,FIOCRUZ/ASTRAZENECA,570,532,38
Itambacuri,313270,MG,Sudeste,BUTANTAN/SINOVAC,5181,2619,2562
Itambacuri,313270,MG,Sudeste,FIOCRUZ/ASTRAZENECA,3823,3437,386
Itambacuri,313270,MG,Sudeste,PFIZER/BIONTECH,256,256,0
Itambaracá,411100,PR,Sul,FIOCRUZ/ASTRAZENECA,2175,2060,115
Itambaracá,411100,PR,Sul,BUTANTAN/SINOVAC,1774,904,870
Itambaracá,411100,PR,Sul,PFIZER/BIONTECH,31,31,0
Itambé,260765,PE,Nordeste,FIOCRUZ/ASTRAZENECA,5884,5472,412
Itambé,260765,PE,Nordeste,BUTANTAN/SINOVAC,5295,2763,2532
Itambé,260765,PE,Nordeste,PFIZER/BIONTECH,207,207,0
Itambé,291580,BA,Nordeste,BUTANTAN/SINOVAC,5632,2902,2730
Itambé,291580,BA,Nordeste,FIOCRUZ/ASTRAZENECA,4721,4340,381
Itambé,291580,BA,Nordeste,PFIZER/BIONTECH,87,86,1
Itambé,411110,PR,Sul,FIOCRUZ/ASTRAZENECA,1578,1488,90
Itambé,411110,PR,Sul,BUTANTAN/SINOVAC,1413,717,696
Itambé,411110,PR,Sul,PFIZER/BIONTECH,15,15,0
Itambé Do Mato Dentro,313280,MG,Sudeste,BUTANTAN/SINOVAC,641,337,304
Itambé Do Mato Dentro,313280,MG,Sudeste,FIOCRUZ/ASTRAZENECA,554,510,44
Itambé Do Mato Dentro,313280,MG,Sudeste,PFIZER/BIONTECH,48,48,0
Itamogi,313290,MG,Sudeste,BUTANTAN/SINOVAC,2580,1316,1264
Itamogi,313290,MG,Sudeste,FIOCRUZ/ASTRAZENECA,2501,2301,200
Itamogi,313290,MG,Sudeste,PFIZER/BIONTECH,58,58,0
Itamonte,313300,MG,Sudeste,FIOCRUZ/ASTRAZENECA,1366,1350,16
Itamonte,313300,MG,Sudeste,BUTANTAN/SINOVAC,803,485,318
Itamonte,313300,MG,Sudeste,PFIZER/BIONTECH,77,77,0
Itanagra,291590,BA,Nordeste,BUTANTAN/SINOVAC,859,439,420
Itanagra,291590,BA,Nordeste,FIOCRUZ/ASTRAZENECA,834,822,12
Itanhaém,352210,SP,Sudeste,BUTANTAN/SINOVAC,25255,14302,10953
Itanhaém,352210,SP,Sudeste,FIOCRUZ/ASTRAZENECA,19384,17755,1629
Itanhaém,352210,SP,Sudeste,PFIZER/BIONTECH,1018,1018,0
Itanhandu,313310,MG,Sudeste,BUTANTAN/SINOVAC,3188,1592,1596
Itanhandu,313310,MG,Sudeste,FIOCRUZ/ASTRAZENECA,2871,2627,244
Itanhandu,313310,MG,Sudeste,PFIZER/BIONTECH,203,203,0
Itanhangá,510454,MT,Centro-Oeste,BUTANTAN/SINOVAC,1188,611,577
Itanhangá,510454,MT,Centro-Oeste,FIOCRUZ/ASTRAZENECA,886,867,19
Itanhangá,510454,MT,Centro-Oeste,PFIZER/BIONTECH,62,62,0
Itanhém,291600,BA,Nordeste,BUTANTAN/SINOVAC,4350,2423,1927
Itanhém,291600,BA,Nordeste,FIOCRUZ/ASTRAZENECA,3985,3570,415
Itanhém,291600,BA,Nordeste,PFIZER/BIONTECH,50,50,0
Itanhomi,313320,MG,Sudeste,FIOCRUZ/ASTRAZENECA,2785,2587,198
Itanhomi,313320,MG,Sudeste,BUTANTAN/SINOVAC,2780,1411,1369
Itanhomi,313320,MG,Sudeste,PFIZER/BIONTECH,113,113,0
Itaobim,313330,MG,Sudeste,BUTANTAN/SINOVAC,4750,2486,2264
Itaobim,313330,MG,Sudeste,FIOCRUZ/ASTRAZENECA,2855,2694,161
Itaobim,313330,MG,Sudeste,PFIZER/BIONTECH,29,29,0
Itaoca,352215,SP,Sudeste,BUTANTAN/SINOVAC,1292,623,669
Itaoca,352215,SP,Sudeste,FIOCRUZ/ASTRAZENECA,790,697,93
Itaoca,352215,SP,Sudeste,PFIZER/BIONTECH,48,47,1
Itaocara,330210,RJ,Sudeste,BUTANTAN/SINOVAC,6140,3260,2880
Itaocara,330210,RJ,Sudeste,FIOCRUZ/ASTRAZENECA,4707,4337,370
Itaocara,330210,RJ,Sudeste,PFIZER/BIONTECH,339,339,0
Itapaci,521090,GO,Centro-Oeste,FIOCRUZ/ASTRAZENECA,6366,6188,178
Itapaci,521090,GO,Centro-Oeste,BUTANTAN/SINOVAC,3608,1938,1670
Itapagé,230630,CE,Nordeste,BUTANTAN/SINOVAC,4490,3114,1376
Itapagé,230630,CE,Nordeste,FIOCRUZ/ASTRAZENECA,2146,2062,84
Itapagipe,313340,MG,Sudeste,FIOCRUZ/ASTRAZENECA,3160,2888,272
Itapagipe,313340,MG,Sudeste,BUTANTAN/SINOVAC,2906,1472,1434
Itapagipe,313340,MG,Sudeste,PFIZER/BIONTECH,463,463,0
Itaparica,291610,BA,Nordeste,FIOCRUZ/ASTRAZENECA,3907,3466,441
Itaparica,291610,BA,Nordeste,BUTANTAN/SINOVAC,3294,1872,1422
Itaparica,291610,BA,Nordeste,PFIZER/BIONTECH,1153,1152,1
Itapé,291620,BA,Nordeste,BUTANTAN/SINOVAC,2073,1119,954
Itapé,291620,BA,Nordeste,FIOCRUZ/ASTRAZENECA,2035,1879,156
Itapé,291620,BA,Nordeste,PFIZER/BIONTECH,6,6,0
Itapebi,291630,BA,Nordeste,BUTANTAN/SINOVAC,1918,1026,892
Itapebi,291630,BA,Nordeste,FIOCRUZ/ASTRAZENECA,1773,1653,120
Itapebi,291630,BA,Nordeste,PFIZER/BIONTECH,125,125,0
Itapecerica,313350,MG,Sudeste,BUTANTAN/SINOVAC,5698,2941,2757
Itapecerica,313350,MG,Sudeste,FIOCRUZ/ASTRAZENECA,5556,5101,455
Itapecerica,313350,MG,Sudeste,PFIZER/BIONTECH,219,218,1
Itapecerica Da Serra,352220,SP,Sudeste,FIOCRUZ/ASTRAZENECA,31300,29178,2122
Itapecerica Da Serra,352220,SP,Sudeste,BUTANTAN/SINOVAC,22954,11721,11233
Itapecerica Da Serra,352220,SP,Sudeste,PFIZER/BIONTECH,768,767,1
Itapecuru Mirim,210540,MA,Nordeste,FIOCRUZ/ASTRAZENECA,17695,15274,2421
Itapecuru Mirim,210540,MA,Nordeste,BUTANTAN/SINOVAC,7853,4389,3464
Itapecuru Mirim,210540,MA,Nordeste,PFIZER/BIONTECH,176,168,8
Itapejara D'Oeste,411120,PR,Sul,FIOCRUZ/ASTRAZENECA,3643,3466,177
Itapejara D'Oeste,411120,PR,Sul,BUTANTAN/SINOVAC,2609,1322,1287
Itapejara D'Oeste,411120,PR,Sul,PFIZER/BIONTECH,86,86,0
Itapema,420830,SC,Sul,FIOCRUZ/ASTRAZENECA,15730,15128,602
Itapema,420830,SC,Sul,BUTANTAN/SINOVAC,14072,8222,5850
Itapema,420830,SC,Sul,PFIZER/BIONTECH,1634,1634,0
Itapemirim,320280,ES,Sudeste,BUTANTAN/SINOVAC,9330,5128,4202
Itapemirim,320280,ES,Sudeste,FIOCRUZ/ASTRAZENECA,7939,7685,254
Itapemirim,320280,ES,Sudeste,PFIZER/BIONTECH,714,714,0
Itaperuçu,411125,PR,Sul,FIOCRUZ/ASTRAZENECA,4662,4493,169
Itaperuçu,411125,PR,Sul,BUTANTAN/SINOVAC,3707,2008,1699
Itaperuçu,411125,PR,Sul,PFIZER/BIONTECH,301,299,2
Itaperuna,330220,RJ,Sudeste,FIOCRUZ/ASTRAZENECA,15844,14873,971
Itaperuna,330220,RJ,Sudeste,BUTANTAN/SINOVAC,12236,8795,3441
Itaperuna,330220,RJ,Sudeste,PFIZER/BIONTECH,1414,1414,0
Itapetim,260770,PE,Nordeste,FIOCRUZ/ASTRAZENECA,3824,3436,388
Itapetim,260770,PE,Nordeste,BUTANTAN/SINOVAC,2989,1519,1470
Itapetim,260770,PE,Nordeste,PFIZER/BIONTECH,456,456,0
Itapetinga,291640,BA,Nordeste,FIOCRUZ/ASTRAZENECA,12210,11301,909
Itapetinga,291640,BA,Nordeste,BUTANTAN/SINOVAC,10383,5204,5179
Itapetinga,291640,BA,Nordeste,PFIZER/BIONTECH,501,501,0
Itapetininga,352230,SP,Sudeste,BUTANTAN/SINOVAC,53480,28088,25392
Itapetininga,352230,SP,Sudeste,FIOCRUZ/ASTRAZENECA,50313,46543,3770
Itapetininga,352230,SP,Sudeste,PFIZER/BIONTECH,3508,3502,6
Itapeva,313360,MG,Sudeste,BUTANTAN/SINOVAC,1822,966,856
Itapeva,313360,MG,Sudeste,FIOCRUZ/ASTRAZENECA,1323,1211,112
Itapeva,313360,MG,Sudeste,PFIZER/BIONTECH,66,66,0
Itapeva,352240,SP,Sudeste,FIOCRUZ/ASTRAZENECA,21957,20513,1444
Itapeva,352240,SP,Sudeste,BUTANTAN/SINOVAC,19507,10550,8957
Itapeva,352240,SP,Sudeste,PFIZER/BIONTECH,1523,1523,0
Itapevi,352250,SP,Sudeste,FIOCRUZ/ASTRAZENECA,31087,29112,1975
Itapevi,352250,SP,Sudeste,BUTANTAN/SINOVAC,27603,14525,13078
Itapevi,352250,SP,Sudeste,PFIZER/BIONTECH,411,410,1
Itapicuru,291650,BA,Nordeste,BUTANTAN/SINOVAC,3979,2698,1281
Itapicuru,291650,BA,Nordeste,FIOCRUZ/ASTRAZENECA,2929,2814,115
Itapipoca,230640,CE,Nordeste,BUTANTAN/SINOVAC,12675,7089,5586
Itapipoca,230640,CE,Nordeste,FIOCRUZ/ASTRAZENECA,7522,6686,836
Itapipoca,230640,CE,Nordeste,PFIZER/BIONTECH,31,29,2
Itapira,352260,SP,Sudeste,BUTANTAN/SINOVAC,19128,10162,8966
Itapira,352260,SP,Sudeste,FIOCRUZ/ASTRAZENECA,16048,14091,1957
Itapira,352260,SP,Sudeste,PFIZER/BIONTECH,1917,1917,0
Itapiranga,130200,AM,Norte,BUTANTAN/SINOVAC,1579,826,753
Itapiranga,130200,AM,Norte,FIOCRUZ/ASTRAZENECA,1113,800,313
Itapiranga,420840,SC,Sul,FIOCRUZ/ASTRAZENECA,3746,3530,216
Itapiranga,420840,SC,Sul,BUTANTAN/SINOVAC,2975,1614,1361
Itapiranga,420840,SC,Sul,PFIZER/BIONTECH,225,225,0
Itapirapuã,521100,GO,Centro-Oeste,FIOCRUZ/ASTRAZENECA,1898,1795,103
Itapirapuã,521100,GO,Centro-Oeste,BUTANTAN/SINOVAC,1220,664,556
Itapirapuã Paulista,352265,SP,Sudeste,BUTANTAN/SINOVAC,717,336,381
Itapirapuã Paulista,352265,SP,Sudeste,FIOCRUZ/ASTRAZENECA,707,658,49
Itapirapuã Paulista,352265,SP,Sudeste,PFIZER/BIONTECH,87,87,0
Itapiratins,171090,TO,Norte,BUTANTAN/SINOVAC,816,430,386
Itapiratins,171090,TO,Norte,FIOCRUZ/ASTRAZENECA,756,724,32
Itapissuma,260775,PE,Nordeste,FIOCRUZ/ASTRAZENECA,3850,3649,201
Itapissuma,260775,PE,Nordeste,BUTANTAN/SINOVAC,3390,1904,1486
Itapissuma,260775,PE,Nordeste,PFIZER/BIONTECH,143,143,0
Itapitanga,291660,BA,Nordeste,FIOCRUZ/ASTRAZENECA,2076,1852,224
Itapitanga,291660,BA,Nordeste,BUTANTAN/SINOVAC,2028,1100,928
Itapitanga,291660,BA,Nordeste,PFIZER/BIONTECH,178,178,0
Itapiúna,230650,CE,Nordeste,BUTANTAN/SINOVAC,2891,1972,919
Itapiúna,230650,CE,Nordeste,FIOCRUZ/ASTRAZENECA,607,555,52
Itapiúna,230650,CE,Nordeste,PFIZER/BIONTECH,8,8,0
Itapoá,420845,SC,Sul,FIOCRUZ/ASTRAZENECA,7848,6901,947
Itapoá,420845,SC,Sul,BUTANTAN/SINOVAC,4362,2202,2160
Itapoá,420845,SC,Sul,PFIZER/BIONTECH,496,496,0
Itápolis,352270,SP,Sudeste,FIOCRUZ/ASTRAZENECA,10406,9553,853
Itápolis,352270,SP,Sudeste,BUTANTAN/SINOVAC,10144,5568,4576
Itápolis,352270,SP,Sudeste,PFIZER/BIONTECH,578,578,0
Itaporã,500450,MS,Centro-Oeste,FIOCRUZ/ASTRAZENECA,5685,4366,1319
Itaporã,500450,MS,Centro-Oeste,BUTANTAN/SINOVAC,5115,2720,2395
Itaporã,500450,MS,Centro-Oeste,PFIZER/BIONTECH,743,741,2
Itaporã Do Tocantins,171110,TO,Norte,BUTANTAN/SINOVAC,489,260,229
Itaporã Do Tocantins,171110,TO,Norte,FIOCRUZ/ASTRAZENECA,378,349,29
Itaporanga,250700,PB,Nordeste,BUTANTAN/SINOVAC,4635,2399,2236
Itaporanga,250700,PB,Nordeste,FIOCRUZ/ASTRAZENECA,4224,3897,327
Itaporanga,250700,PB,Nordeste,PFIZER/BIONTECH,594,594,0
Itaporanga,352280,SP,Sudeste,BUTANTAN/SINOVAC,3623,1851,1772
Itaporanga,352280,SP,Sudeste,FIOCRUZ/ASTRAZENECA,3529,3267,262
Itaporanga,352280,SP,Sudeste,PFIZER/BIONTECH,276,276,0
Itaporanga D'Ajuda,280320,SE,Nordeste,BUTANTAN/SINOVAC,5786,3108,2678
Itaporanga D'Ajuda,280320,SE,Nordeste,FIOCRUZ/ASTRAZENECA,4540,4285,255
Itaporanga D'Ajuda,280320,SE,Nordeste,PFIZER/BIONTECH,572,572,0
Itapororoca,250710,PB,Nordeste,BUTANTAN/SINOVAC,4073,2305,1768
Itapororoca,250710,PB,Nordeste,FIOCRUZ/ASTRAZENECA,1245,1136,109
Itapuã Do Oeste,110110,RO,Norte,FIOCRUZ/ASTRAZENECA,2473,2389,84
Itapuã Do Oeste,110110,RO,Norte,BUTANTAN/SINOVAC,2343,1297,1046
Itapuã Do Oeste,110110,RO,Norte,PFIZER/BIONTECH,241,241,0
Itapuca,431057,RS,Sul,BUTANTAN/SINOVAC,551,276,275
Itapuca,431057,RS,Sul,FIOCRUZ/ASTRAZENECA,482,439,43
Itapuca,431057,RS,Sul,PFIZER/BIONTECH,71,71,0
Itapuí,352290,SP,Sudeste,FIOCRUZ/ASTRAZENECA,2982,2747,235
Itapuí,352290,SP,Sudeste,BUTANTAN/SINOVAC,2433,1243,1190
Itapuí,352290,SP,Sudeste,PFIZER/BIONTECH,195,195,0
Itapura,352300,SP,Sudeste,FIOCRUZ/ASTRAZENECA,1424,1314,110
Itapura,352300,SP,Sudeste,BUTANTAN/SINOVAC,1222,612,610
Itapura,352300,SP,Sudeste,PFIZER/BIONTECH,69,69,0
Itapuranga,521120,GO,Centro-Oeste,FIOCRUZ/ASTRAZENECA,8375,7924,451
Itapuranga,521120,GO,Centro-Oeste,BUTANTAN/SINOVAC,5599,2922,2677
Itaquaquecetuba,352310,SP,Sudeste,FIOCRUZ/ASTRAZENECA,56308,53691,2617
Itaquaquecetuba,352310,SP,Sudeste,BUTANTAN/SINOVAC,40046,21179,18867
Itaquaquecetuba,352310,SP,Sudeste,PFIZER/BIONTECH,2028,2026,2
Itaquara,291670,BA,Nordeste,BUTANTAN/SINOVAC,1763,1024,739
Itaquara,291670,BA,Nordeste,FIOCRUZ/ASTRAZENECA,1272,1143,129
Itaquara,291670,BA,Nordeste,PFIZER/BIONTECH,17,17,0
Itaqui,431060,RS,Sul,FIOCRUZ/ASTRAZENECA,8456,7996,460
Itaqui,431060,RS,Sul,BUTANTAN/SINOVAC,7709,3976,3733
Itaqui,431060,RS,Sul,PFIZER/BIONTECH,1042,1041,1
Itaquiraí,500460,MS,Centro-Oeste,FIOCRUZ/ASTRAZENECA,4625,4359,266
Itaquiraí,500460,MS,Centro-Oeste,BUTANTAN/SINOVAC,3978,2199,1779
Itaquiraí,500460,MS,Centro-Oeste,PFIZER/BIONTECH,678,672,6
Itaquitinga,260780,PE,Nordeste,FIOCRUZ/ASTRAZENECA,2807,2624,183
Itaquitinga,260780,PE,Nordeste,BUTANTAN/SINOVAC,2350,1194,1156
Itaquitinga,260780,PE,Nordeste,PFIZER/BIONTECH,151,151,0
Itarana,320290,ES,Sudeste,BUTANTAN/SINOVAC,3466,1739,1727
Itarana,320290,ES,Sudeste,FIOCRUZ/ASTRAZENECA,1987,1831,156
Itarana,320290,ES,Sudeste,PFIZER/BIONTECH,100,100,0
Itarantim,291680,BA,Nordeste,BUTANTAN/SINOVAC,3917,2002,1915
Itarantim,291680,BA,Nordeste,FIOCRUZ/ASTRAZENECA,3099,2832,267
Itarantim,291680,BA,Nordeste,PFIZER/BIONTECH,1,1,0
Itararé,352320,SP,Sudeste,FIOCRUZ/ASTRAZENECA,11715,10571,1144
Itararé,352320,SP,Sudeste,BUTANTAN/SINOVAC,10629,5325,5304
Itararé,352320,SP,Sudeste,PFIZER/BIONTECH,611,610,1
Itarema,230655,CE,Nordeste,BUTANTAN/SINOVAC,6423,3446,2977
Itarema,230655,CE,Nordeste,FIOCRUZ/ASTRAZENECA,1169,977,192
Itarema,230655,CE,Nordeste,PFIZER/BIONTECH,214,118,96
Itariri,352330,SP,Sudeste,FIOCRUZ/ASTRAZENECA,3293,3048,245
Itariri,352330,SP,Sudeste,BUTANTAN/SINOVAC,3194,1664,1530
Itariri,352330,SP,Sudeste,PFIZER/BIONTECH,203,201,2
Itarumã,521130,GO,Centro-Oeste,FIOCRUZ/ASTRAZENECA,1436,1329,107
Itarumã,521130,GO,Centro-Oeste,BUTANTAN/SINOVAC,1191,607,584
Itarumã,521130,GO,Centro-Oeste,PFIZER/BIONTECH,92,92,0
Itati,431065,RS,Sul,BUTANTAN/SINOVAC,1081,556,525
Itati,431065,RS,Sul,FIOCRUZ/ASTRAZENECA,925,848,77
Itati,431065,RS,Sul,PFIZER/BIONTECH,116,116,0
Itatiaia,330225,RJ,Sudeste,BUTANTAN/SINOVAC,5333,3529,1804
Itatiaia,330225,RJ,Sudeste,FIOCRUZ/ASTRAZENECA,2942,2708,234
Itatiaiuçu,313370,MG,Sudeste,BUTANTAN/SINOVAC,1411,753,658
Itatiaiuçu,313370,MG,Sudeste,FIOCRUZ/ASTRAZENECA,1312,1259,53
Itatiaiuçu,313370,MG,Sudeste,PFIZER/BIONTECH,99,99,0
Itatiba,352340,SP,Sudeste,FIOCRUZ/ASTRAZENECA,27449,25424,2025
Itatiba,352340,SP,Sudeste,BUTANTAN/SINOVAC,24241,12952,11289
Itatiba,352340,SP,Sudeste,PFIZER/BIONTECH,909,908,1
Itatiba Do Sul,431070,RS,Sul,BUTANTAN/SINOVAC,1122,580,542
Itatiba Do Sul,431070,RS,Sul,FIOCRUZ/ASTRAZENECA,1114,985,129
Itatiba Do Sul,431070,RS,Sul,PFIZER/BIONTECH,163,163,0
Itatim,291685,BA,Nordeste,FIOCRUZ/ASTRAZENECA,2586,2317,269
Itatim,291685,BA,Nordeste,BUTANTAN/SINOVAC,2418,1225,1193
Itatim,291685,BA,Nordeste,PFIZER/BIONTECH,312,312,0
Itatinga,352350,SP,Sudeste,FIOCRUZ/ASTRAZENECA,4038,3751,287
Itatinga,352350,SP,Sudeste,BUTANTAN/SINOVAC,3508,1966,1542
Itatinga,352350,SP,Sudeste,PFIZER/BIONTECH,422,422,0
Itatira,230660,CE,Nordeste,BUTANTAN/SINOVAC,3130,1663,1467
Itatira,230660,CE,Nordeste,FIOCRUZ/ASTRAZENECA,2047,1720,327
Itatuba,250720,PB,Nordeste,BUTANTAN/SINOVAC,2522,1284,1238
Itatuba,250720,PB,Nordeste,FIOCRUZ/ASTRAZENECA,1760,1600,160
Itatuba,250720,PB,Nordeste,PFIZER/BIONTECH,218,218,0
Itaú,240490,RN,Nordeste,BUTANTAN/SINOVAC,2053,1082,971
Itaú,240490,RN,Nordeste,FIOCRUZ/ASTRAZENECA,1510,1431,79
Itaú,240490,RN,Nordeste,PFIZER/BIONTECH,246,246,0
Itaú De Minas,313375,MG,Sudeste,FIOCRUZ/ASTRAZENECA,3721,3487,234
Itaú De Minas,313375,MG,Sudeste,BUTANTAN/SINOVAC,3415,1774,1641
Itaú De Minas,313375,MG,Sudeste,PFIZER/BIONTECH,135,135,0
Itaúba,510455,MT,Centro-Oeste,FIOCRUZ/ASTRAZENECA,1104,952,152
Itaúba,510455,MT,Centro-Oeste,BUTANTAN/SINOVAC,869,447,422
Itaúba,510455,MT,Centro-Oeste,PFIZER/BIONTECH,6,6,0
Itaubal,160025,AP,Norte,BUTANTAN/SINOVAC,769,444,325
Itaubal,160025,AP,Norte,FIOCRUZ/ASTRAZENECA,504,412,92
Itaubal,160025,AP,Norte,PFIZER/BIONTECH,6,6,0
Itauçu,521140,GO,Centro-Oeste,FIOCRUZ/ASTRAZENECA,2118,2068,50
Itauçu,521140,GO,Centro-Oeste,BUTANTAN/SINOVAC,2005,1077,928
Itauçu,521140,GO,Centro-Oeste,PFIZER/BIONTECH,101,101,0
Itaueira,220510,PI,Nordeste,FIOCRUZ/ASTRAZENECA,2023,1868,155
Itaueira,220510,PI,Nordeste,BUTANTAN/SINOVAC,1982,1018,964
Itaúna,313380,MG,Sudeste,BUTANTAN/SINOVAC,16517,8462,8055
Itaúna,313380,MG,Sudeste,FIOCRUZ/ASTRAZENECA,13127,11969,1158
Itaúna,313380,MG,Sudeste,PFIZER/BIONTECH,826,826,0
Itaúna Do Sul,411130,PR,Sul,FIOCRUZ/ASTRAZENECA,896,824,72
Itaúna Do Sul,411130,PR,Sul,BUTANTAN/SINOVAC,783,418,365
Itaúna Do Sul,411130,PR,Sul,PFIZER/BIONTECH,10,10,0
Itaverava,313390,MG,Sudeste,FIOCRUZ/ASTRAZENECA,1369,1245,124
Itaverava,313390,MG,Sudeste,BUTANTAN/SINOVAC,1102,553,549
Itaverava,313390,MG,Sudeste,PFIZER/BIONTECH,69,69,0
Itinga,313400,MG,Sudeste,BUTANTAN/SINOVAC,3034,1596,1438
Itinga,313400,MG,Sudeste,FIOCRUZ/ASTRAZENECA,2197,1984,213
Itinga,313400,MG,Sudeste,PFIZER/BIONTECH,72,72,0
Itinga Do Maranhão,210542,MA,Nordeste,FIOCRUZ/ASTRAZENECA,4356,4157,199
Itinga Do Maranhão,210542,MA,Nordeste,BUTANTAN/SINOVAC,3205,1681,1524
Itiquira,510460,MT,Centro-Oeste,FIOCRUZ/ASTRAZENECA,2218,2096,122
Itiquira,510460,MT,Centro-Oeste,BUTANTAN/SINOVAC,1683,867,816
Itiquira,510460,MT,Centro-Oeste,PFIZER/BIONTECH,151,151,0
Itirapina,352360,SP,Sudeste,FIOCRUZ/ASTRAZENECA,3579,3289,290
Itirapina,352360,SP,Sudeste,BUTANTAN/SINOVAC,3209,1809,1400
Itirapina,352360,SP,Sudeste,PFIZER/BIONTECH,63,63,0
Itirapuã,352370,SP,Sudeste,BUTANTAN/SINOVAC,1682,837,845
Itirapuã,352370,SP,Sudeste,FIOCRUZ/ASTRAZENECA,1406,1276,130
Itirapuã,352370,SP,Sudeste,PFIZER/BIONTECH,148,148,0
Itiruçu,291690,BA,Nordeste,BUTANTAN/SINOVAC,2560,1371,1189
Itiruçu,291690,BA,Nordeste,FIOCRUZ/ASTRAZENECA,2463,2204,259
Itiruçu,291690,BA,Nordeste,PFIZER/BIONTECH,136,136,0
Itiúba,291700,BA,Nordeste,BUTANTAN/SINOVAC,6544,3436,3108
Itiúba,291700,BA,Nordeste,FIOCRUZ/ASTRAZENECA,5250,4983,267
Itiúba,291700,BA,Nordeste,PFIZER/BIONTECH,36,36,0
Itobi,352380,SP,Sudeste,BUTANTAN/SINOVAC,1940,1025,915
Itobi,352380,SP,Sudeste,FIOCRUZ/ASTRAZENECA,1095,912,183
Itobi,352380,SP,Sudeste,PFIZER/BIONTECH,152,152,0
Itororó,291710,BA,Nordeste,FIOCRUZ/ASTRAZENECA,4477,3876,601
Itororó,291710,BA,Nordeste,BUTANTAN/SINOVAC,3801,2084,1717
Itu,352390,SP,Sudeste,BUTANTAN/SINOVAC,35807,19149,16658
Itu,352390,SP,Sudeste,FIOCRUZ/ASTRAZENECA,33652,30955,2697
Itu,352390,SP,Sudeste,PFIZER/BIONTECH,1856,1855,1
Ituaçu,291720,BA,Nordeste,FIOCRUZ/ASTRAZENECA,4295,3941,354
Ituaçu,291720,BA,Nordeste,BUTANTAN/SINOVAC,4168,2168,2000
Ituaçu,291720,BA,Nordeste,PFIZER/BIONTECH,245,245,0
Ituberá,291730,BA,Nordeste,FIOCRUZ/ASTRAZENECA,4234,4054,180
Ituberá,291730,BA,Nordeste,BUTANTAN/SINOVAC,3493,1871,1622
Ituberá,291730,BA,Nordeste,PFIZER/BIONTECH,29,29,0
Itueta,313410,MG,Sudeste,BUTANTAN/SINOVAC,1461,747,714
Itueta,313410,MG,Sudeste,FIOCRUZ/ASTRAZENECA,972,888,84
Ituiutaba,313420,MG,Sudeste,BUTANTAN/SINOVAC,17537,11242,6295
Ituiutaba,313420,MG,Sudeste,FIOCRUZ/ASTRAZENECA,4988,4955,33
Itumbiara,521150,GO,Centro-Oeste,FIOCRUZ/ASTRAZENECA,25435,22558,2877
Itumbiara,521150,GO,Centro-Oeste,BUTANTAN/SINOVAC,22917,11688,11229
Itumbiara,521150,GO,Centro-Oeste,PFIZER/BIONTECH,2398,2398,0
Itumirim,313430,MG,Sudeste,FIOCRUZ/ASTRAZENECA,906,806,100
Itumirim,313430,MG,Sudeste,BUTANTAN/SINOVAC,854,428,426
Itumirim,313430,MG,Sudeste,PFIZER/BIONTECH,30,30,0
Itupeva,352400,SP,Sudeste,FIOCRUZ/ASTRAZENECA,11493,10814,679
Itupeva,352400,SP,Sudeste,BUTANTAN/SINOVAC,8567,3930,4637
Itupeva,352400,SP,Sudeste,PFIZER/BIONTECH,604,603,1
Itupiranga,150370,PA,Norte,FIOCRUZ/ASTRAZENECA,4657,4242,415
Itupiranga,150370,PA,Norte,BUTANTAN/SINOVAC,1892,1082,810
Ituporanga,420850,SC,Sul,FIOCRUZ/ASTRAZENECA,5537,5108,429
Ituporanga,420850,SC,Sul,BUTANTAN/SINOVAC,4375,2374,2001
Ituporanga,420850,SC,Sul,PFIZER/BIONTECH,655,655,0
Iturama,313440,MG,Sudeste,FIOCRUZ/ASTRAZENECA,7279,6745,534
Iturama,313440,MG,Sudeste,BUTANTAN/SINOVAC,6484,3301,3183
Iturama,313440,MG,Sudeste,PFIZER/BIONTECH,997,997,0
Itutinga,313450,MG,Sudeste,FIOCRUZ/ASTRAZENECA,1003,935,68
Itutinga,313450,MG,Sudeste,BUTANTAN/SINOVAC,855,437,418
Itutinga,313450,MG,Sudeste,PFIZER/BIONTECH,44,44,0
Ituverava,352410,SP,Sudeste,FIOCRUZ/ASTRAZENECA,10296,9580,716
Ituverava,352410,SP,Sudeste,BUTANTAN/SINOVAC,10250,5588,4662
Ituverava,352410,SP,Sudeste,PFIZER/BIONTECH,238,237,1
Iuiu,291733,BA,Nordeste,FIOCRUZ/ASTRAZENECA,2180,1912,268
Iuiu,291733,BA,Nordeste,BUTANTAN/SINOVAC,1769,939,830
Iuiu,291733,BA,Nordeste,PFIZER/BIONTECH,254,253,1
Iúna,320300,ES,Sudeste,BUTANTAN/SINOVAC,6997,3768,3229
Iúna,320300,ES,Sudeste,FIOCRUZ/ASTRAZENECA,5652,5332,320
Iúna,320300,ES,Sudeste,PFIZER/BIONTECH,928,926,2
Ivaí,411140,PR,Sul,FIOCRUZ/ASTRAZENECA,3550,3406,144
Ivaí,411140,PR,Sul,BUTANTAN/SINOVAC,2273,1183,1090
Ivaí,411140,PR,Sul,PFIZER/BIONTECH,155,155,0
Ivaiporã,411150,PR,Sul,FIOCRUZ/ASTRAZENECA,8867,8235,632
Ivaiporã,411150,PR,Sul,BUTANTAN/SINOVAC,8464,4468,3996
Ivaiporã,411150,PR,Sul,PFIZER/BIONTECH,875,875,0
Ivaté,411155,PR,Sul,FIOCRUZ/ASTRAZENECA,1687,1627,60
Ivaté,411155,PR,Sul,BUTANTAN/SINOVAC,1431,747,684
Ivaté,411155,PR,Sul,PFIZER/BIONTECH,51,51,0
Ivatuba,411160,PR,Sul,FIOCRUZ/ASTRAZENECA,733,701,32
Ivatuba,411160,PR,Sul,BUTANTAN/SINOVAC,602,306,296
Ivatuba,411160,PR,Sul,PFIZER/BIONTECH,108,108,0
Ivinhema,500470,MS,Centro-Oeste,BUTANTAN/SINOVAC,5964,3104,2860
Ivinhema,500470,MS,Centro-Oeste,FIOCRUZ/ASTRAZENECA,5627,4984,643
Ivinhema,500470,MS,Centro-Oeste,PFIZER/BIONTECH,874,874,0
Ivolândia,521160,GO,Centro-Oeste,FIOCRUZ/ASTRAZENECA,858,791,67
Ivolândia,521160,GO,Centro-Oeste,BUTANTAN/SINOVAC,726,374,352
Ivorá,431075,RS,Sul,BUTANTAN/SINOVAC,774,391,383
Ivorá,431075,RS,Sul,FIOCRUZ/ASTRAZENECA,628,563,65
Ivorá,431075,RS,Sul,PFIZER/BIONTECH,72,72,0
Ivoti,431080,RS,Sul,BUTANTAN/SINOVAC,5448,2772,2676
Ivoti,431080,RS,Sul,FIOCRUZ/ASTRAZENECA,5264,5043,221
Ivoti,431080,RS,Sul,PFIZER/BIONTECH,819,819,0
Jaboatão Dos Guararapes,260790,PE,Nordeste,BUTANTAN/SINOVAC,119375,63112,56263
Jaboatão Dos Guararapes,260790,PE,Nordeste,FIOCRUZ/ASTRAZENECA,73607,66401,7206
Jaboatão Dos Guararapes,260790,PE,Nordeste,PFIZER/BIONTECH,4998,4985,13
Jaborá,420860,SC,Sul,FIOCRUZ/ASTRAZENECA,956,889,67
Jaborá,420860,SC,Sul,BUTANTAN/SINOVAC,955,555,400
Jaborá,420860,SC,Sul,PFIZER/BIONTECH,112,112,0
Jaborandi,291735,BA,Nordeste,BUTANTAN/SINOVAC,2045,1056,989
Jaborandi,291735,BA,Nordeste,FIOCRUZ/ASTRAZENECA,1899,1685,214
Jaborandi,291735,BA,Nordeste,PFIZER/BIONTECH,101,101,0
Jaborandi,352420,SP,Sudeste,FIOCRUZ/ASTRAZENECA,3001,2670,331
Jaborandi,352420,SP,Sudeste,BUTANTAN/SINOVAC,2375,1219,1156
Jaborandi,352420,SP,Sudeste,PFIZER/BIONTECH,192,192,0
Jaboti,411170,PR,Sul,FIOCRUZ/ASTRAZENECA,1322,1229,93
Jaboti,411170,PR,Sul,BUTANTAN/SINOVAC,1176,593,583
Jaboticaba,431085,RS,Sul,BUTANTAN/SINOVAC,1195,610,585
Jaboticaba,431085,RS,Sul,FIOCRUZ/ASTRAZENECA,1120,998,122
Jaboticaba,431085,RS,Sul,PFIZER/BIONTECH,120,120,0
Jaboticabal,352430,SP,Sudeste,FIOCRUZ/ASTRAZENECA,17798,16597,1201
Jaboticabal,352430,SP,Sudeste,BUTANTAN/SINOVAC,16679,9003,7676
Jaboticabal,352430,SP,Sudeste,PFIZER/BIONTECH,1241,1240,1
Jaboticatubas,313460,MG,Sudeste,BUTANTAN/SINOVAC,4163,2097,2066
Jaboticatubas,313460,MG,Sudeste,FIOCRUZ/ASTRAZENECA,3234,2952,282
Jaboticatubas,313460,MG,Sudeste,PFIZER/BIONTECH,100,100,0
Jaçanã,240500,RN,Nordeste,BUTANTAN/SINOVAC,2014,1044,970
Jaçanã,240500,RN,Nordeste,FIOCRUZ/ASTRAZENECA,1485,1363,122
Jaçanã,240500,RN,Nordeste,PFIZER/BIONTECH,273,273,0
Jacaraci,291740,BA,Nordeste,BUTANTAN/SINOVAC,4259,2176,2083
Jacaraci,291740,BA,Nordeste,FIOCRUZ/ASTRAZENECA,3170,3083,87
Jacaraci,291740,BA,Nordeste,PFIZER/BIONTECH,174,174,0
Jacaraú,250730,PB,Nordeste,BUTANTAN/SINOVAC,3767,1925,1842
Jacaraú,250730,PB,Nordeste,FIOCRUZ/ASTRAZENECA,1749,1488,261
Jacaraú,250730,PB,Nordeste,PFIZER/BIONTECH,151,151,0
Jacaré Dos Homens,270340,AL,Nordeste,FIOCRUZ/ASTRAZENECA,1805,1637,168
Jacaré Dos Homens,270340,AL,Nordeste,BUTANTAN/SINOVAC,956,482,474
Jacareacanga,150375,PA,Norte,BUTANTAN/SINOVAC,2337,1743,594
Jacareacanga,150375,PA,Norte,FIOCRUZ/ASTRAZENECA,917,607,310
Jacareí,352440,SP,Sudeste,FIOCRUZ/ASTRAZENECA,48751,44758,3993
Jacareí,352440,SP,Sudeste,BUTANTAN/SINOVAC,46695,24414,22281
Jacareí,352440,SP,Sudeste,PFIZER/BIONTECH,4750,4743,7
Jacarezinho,411180,PR,Sul,FIOCRUZ/ASTRAZENECA,8927,8274,653
Jacarezinho,411180,PR,Sul,BUTANTAN/SINOVAC,8432,4641,3791
Jacarezinho,411180,PR,Sul,PFIZER/BIONTECH,3400,3399,1
Jaci,352450,SP,Sudeste,BUTANTAN/SINOVAC,1940,1007,933
Jaci,352450,SP,Sudeste,FIOCRUZ/ASTRAZENECA,1635,1468,167
Jaci,352450,SP,Sudeste,PFIZER/BIONTECH,87,87,0
Jaciara,510480,MT,Centro-Oeste,FIOCRUZ/ASTRAZENECA,6006,5702,304
Jaciara,510480,MT,Centro-Oeste,BUTANTAN/SINOVAC,5505,2864,2641
Jaciara,510480,MT,Centro-Oeste,PFIZER/BIONTECH,284,284,0
Jacinto,313470,MG,Sudeste,BUTANTAN/SINOVAC,3430,1816,1614
Jacinto,313470,MG,Sudeste,FIOCRUZ/ASTRAZENECA,2085,1871,214
Jacinto,313470,MG,Sudeste,PFIZER/BIONTECH,87,87,0
Jacinto Machado,420870,SC,Sul,FIOCRUZ/ASTRAZENECA,3259,2977,282
Jacinto Machado,420870,SC,Sul,BUTANTAN/SINOVAC,2463,1274,1189
Jacobina,291750,BA,Nordeste,FIOCRUZ/ASTRAZENECA,17992,14954,3038
Jacobina,291750,BA,Nordeste,BUTANTAN/SINOVAC,15694,8306,7388
Jacobina,291750,BA,Nordeste,PFIZER/BIONTECH,988,988,0
Jacobina Do Piauí,220515,PI,Nordeste,FIOCRUZ/ASTRAZENECA,1436,1297,139
Jacobina Do Piauí,220515,PI,Nordeste,BUTANTAN/SINOVAC,1010,512,498
Jacobina Do Piauí,220515,PI,Nordeste,PFIZER/BIONTECH,75,75,0
Jacuí,313480,MG,Sudeste,BUTANTAN/SINOVAC,2005,1033,972
Jacuí,313480,MG,Sudeste,FIOCRUZ/ASTRAZENECA,1943,1803,140
Jacuí,313480,MG,Sudeste,PFIZER/BIONTECH,38,38,0
Jacuípe,270350,AL,Nordeste,FIOCRUZ/ASTRAZENECA,1026,957,69
Jacuípe,270350,AL,Nordeste,BUTANTAN/SINOVAC,878,478,400
Jacuizinho,431087,RS,Sul,FIOCRUZ/ASTRAZENECA,946,792,154
Jacuizinho,431087,RS,Sul,BUTANTAN/SINOVAC,721,364,357
Jacuizinho,431087,RS,Sul,PFIZER/BIONTECH,103,103,0
Jacundá,150380,PA,Norte,FIOCRUZ/ASTRAZENECA,6849,6400,449
Jacundá,150380,PA,Norte,BUTANTAN/SINOVAC,2334,1365,969
Jacupiranga,352460,SP,Sudeste,FIOCRUZ/ASTRAZENECA,4860,4547,313
Jacupiranga,352460,SP,Sudeste,BUTANTAN/SINOVAC,4651,2453,2198
Jacupiranga,352460,SP,Sudeste,PFIZER/BIONTECH,315,315,0
Jacutinga,313490,MG,Sudeste,BUTANTAN/SINOVAC,3983,2131,1852
Jacutinga,313490,MG,Sudeste,FIOCRUZ/ASTRAZENECA,967,793,174
Jacutinga,431090,RS,Sul,BUTANTAN/SINOVAC,1434,717,717
Jacutinga,431090,RS,Sul,FIOCRUZ/ASTRAZENECA,1052,957,95
Jacutinga,431090,RS,Sul,PFIZER/BIONTECH,138,138,0
Jaguapitã,411190,PR,Sul,FIOCRUZ/ASTRAZENECA,3698,3455,243
Jaguapitã,411190,PR,Sul,BUTANTAN/SINOVAC,3057,1586,1471
Jaguapitã,411190,PR,Sul,PFIZER/BIONTECH,23,23,0
Jaguaquara,291760,BA,Nordeste,FIOCRUZ/ASTRAZENECA,9071,8080,991
Jaguaquara,291760,BA,Nordeste,BUTANTAN/SINOVAC,8526,4668,3858
Jaguaquara,291760,BA,Nordeste,PFIZER/BIONTECH,148,148,0
Jaguaraçu,313500,MG,Sudeste,BUTANTAN/SINOVAC,622,360,262
Jaguaraçu,313500,MG,Sudeste,FIOCRUZ/ASTRAZENECA,575,501,74
Jaguaraçu,313500,MG,Sudeste,PFIZER/BIONTECH,12,12,0
Jaguarão,431100,RS,Sul,BUTANTAN/SINOVAC,8039,4390,3649
Jaguarão,431100,RS,Sul,FIOCRUZ/ASTRAZENECA,6957,6353,604
Jaguarão,431100,RS,Sul,PFIZER/BIONTECH,496,494,2
Jaguarari,291770,BA,Nordeste,BUTANTAN/SINOVAC,5525,3204,2321
Jaguarari,291770,BA,Nordeste,FIOCRUZ/ASTRAZENECA,4311,4098,213
Jaguarari,291770,BA,Nordeste,PFIZER/BIONTECH,30,30,0
Jaguaré,320305,ES,Sudeste,FIOCRUZ/ASTRAZENECA,5531,5414,117
Jaguaré,320305,ES,Sudeste,BUTANTAN/SINOVAC,5505,2950,2555
Jaguaré,320305,ES,Sudeste,PFIZER/BIONTECH,660,660,0
Jaguaretama,230670,CE,Nordeste,BUTANTAN/SINOVAC,4146,2126,2020
Jaguaretama,230670,CE,Nordeste,FIOCRUZ/ASTRAZENECA,2198,1852,346
Jaguari,431110,RS,Sul,BUTANTAN/SINOVAC,3857,1942,1915
Jaguari,431110,RS,Sul,FIOCRUZ/ASTRAZENECA,3673,3234,439
Jaguari,431110,RS,Sul,PFIZER/BIONTECH,402,402,0
Jaguariaíva,411200,PR,Sul,FIOCRUZ/ASTRAZENECA,7257,6927,330
Jaguariaíva,411200,PR,Sul,BUTANTAN/SINOVAC,4936,2588,2348
Jaguariaíva,411200,PR,Sul,PFIZER/BIONTECH,21,21,0
Jaguaribara,230680,CE,Nordeste,BUTANTAN/SINOVAC,1382,745,637
Jaguaribara,230680,CE,Nordeste,FIOCRUZ/ASTRAZENECA,291,227,64
Jaguaribe,230690,CE,Nordeste,BUTANTAN/SINOVAC,7005,3578,3427
Jaguaribe,230690,CE,Nordeste,FIOCRUZ/ASTRAZENECA,6063,5381,682
Jaguaribe,230690,CE,Nordeste,PFIZER/BIONTECH,4,4,0
Jaguaripe,291780,BA,Nordeste,BUTANTAN/SINOVAC,1726,1295,431
Jaguaripe,291780,BA,Nordeste,FIOCRUZ/ASTRAZENECA,821,821,0
Jaguaripe,291780,BA,Nordeste,PFIZER/BIONTECH,48,48,0
Jaguariúna,352470,SP,Sudeste,BUTANTAN/SINOVAC,14298,8248,6050
Jaguariúna,352470,SP,Sudeste,FIOCRUZ/ASTRAZENECA,5861,5683,178
Jaguariúna,352470,SP,Sudeste,PFIZER/BIONTECH,35,35,0
Jaguaruana,230700,CE,Nordeste,BUTANTAN/SINOVAC,4189,1967,2222
Jaguaruana,230700,CE,Nordeste,FIOCRUZ/ASTRAZENECA,2413,2051,362
Jaguaruna,420880,SC,Sul,BUTANTAN/SINOVAC,4506,2412,2094
Jaguaruna,420880,SC,Sul,FIOCRUZ/ASTRAZENECA,4420,4118,302
Jaguaruna,420880,SC,Sul,PFIZER/BIONTECH,36,36,0
Jaíba,313505,MG,Sudeste,FIOCRUZ/ASTRAZENECA,4353,4033,320
Jaíba,313505,MG,Sudeste,BUTANTAN/SINOVAC,4132,2408,1724
Jaíba,313505,MG,Sudeste,PFIZER/BIONTECH,387,387,0
Jaicós,220520,PI,Nordeste,FIOCRUZ/ASTRAZENECA,4288,4042,246
Jaicós,220520,PI,Nordeste,BUTANTAN/SINOVAC,3522,1850,1672
Jaicós,220520,PI,Nordeste,PFIZER/BIONTECH,120,120,0
Jales,352480,SP,Sudeste,BUTANTAN/SINOVAC,15076,8859,6217
Jales,352480,SP,Sudeste,FIOCRUZ/ASTRAZENECA,11702,10396,1306
Jales,352480,SP,Sudeste,PFIZER/BIONTECH,886,884,2
Jambeiro,352490,SP,Sudeste,BUTANTAN/SINOVAC,1383,687,696
Jambeiro,352490,SP,Sudeste,FIOCRUZ/ASTRAZENECA,1316,1190,126
Jambeiro,352490,SP,Sudeste,PFIZER/BIONTECH,24,24,0
Jampruca,313507,MG,Sudeste,BUTANTAN/SINOVAC,942,551,391
Jampruca,313507,MG,Sudeste,FIOCRUZ/ASTRAZENECA,560,501,59
Jampruca,313507,MG,Sudeste,PFIZER/BIONTECH,47,47,0
Janaúba,313510,MG,Sudeste,BUTANTAN/SINOVAC,6791,3906,2885
Janaúba,313510,MG,Sudeste,FIOCRUZ/ASTRAZENECA,5261,4909,352
Janaúba,313510,MG,Sudeste,PFIZER/BIONTECH,422,420,2
Jandaia,521170,GO,Centro-Oeste,FIOCRUZ/ASTRAZENECA,1982,1875,107
Jandaia,521170,GO,Centro-Oeste,BUTANTAN/SINOVAC,1471,841,630
Jandaia Do Sul,411210,PR,Sul,FIOCRUZ/ASTRAZENECA,5863,5479,384
Jandaia Do Sul,411210,PR,Sul,BUTANTAN/SINOVAC,5797,3005,2792
Jandaia Do Sul,411210,PR,Sul,PFIZER/BIONTECH,785,785,0
Jandaíra,240510,RN,Nordeste,BUTANTAN/SINOVAC,1297,654,643
Jandaíra,240510,RN,Nordeste,FIOCRUZ/ASTRAZENECA,1039,980,59
Jandaíra,240510,RN,Nordeste,PFIZER/BIONTECH,85,85,0
Jandaíra,291790,BA,Nordeste,BUTANTAN/SINOVAC,1097,683,414
Jandaíra,291790,BA,Nordeste,FIOCRUZ/ASTRAZENECA,855,819,36
Jandaíra,291790,BA,Nordeste,PFIZER/BIONTECH,38,38,0
Jandira,352500,SP,Sudeste,FIOCRUZ/ASTRAZENECA,18133,17703,430
Jandira,352500,SP,Sudeste,BUTANTAN/SINOVAC,14895,8385,6510
Jandira,352500,SP,Sudeste,PFIZER/BIONTECH,1742,1736,6
Janduís,240520,RN,Nordeste,FIOCRUZ/ASTRAZENECA,2211,2078,133
Janduís,240520,RN,Nordeste,BUTANTAN/SINOVAC,2155,1107,1048
Janduís,240520,RN,Nordeste,PFIZER/BIONTECH,264,263,1
Jangada,510490,MT,Centro-Oeste,BUTANTAN/SINOVAC,1700,871,829
Jangada,510490,MT,Centro-Oeste,FIOCRUZ/ASTRAZENECA,1205,1093,112
Janiópolis,411220,PR,Sul,FIOCRUZ/ASTRAZENECA,1779,1666,113
Janiópolis,411220,PR,Sul,BUTANTAN/SINOVAC,1543,794,749
Janiópolis,411220,PR,Sul,PFIZER/BIONTECH,29,29,0
Januária,313520,MG,Sudeste,BUTANTAN/SINOVAC,8489,4319,4170
Januária,313520,MG,Sudeste,FIOCRUZ/ASTRAZENECA,7056,6730,326
Januária,313520,MG,Sudeste,PFIZER/BIONTECH,368,368,0
Januário Cicco,240530,RN,Nordeste,BUTANTAN/SINOVAC,1496,787,709
Januário Cicco,240530,RN,Nordeste,FIOCRUZ/ASTRAZENECA,1088,973,115
Januário Cicco,240530,RN,Nordeste,PFIZER/BIONTECH,146,146,0
Japaraíba,313530,MG,Sudeste,FIOCRUZ/ASTRAZENECA,1168,1105,63
Japaraíba,313530,MG,Sudeste,BUTANTAN/SINOVAC,782,399,383
Japaraíba,313530,MG,Sudeste,PFIZER/BIONTECH,58,58,0
Japaratinga,270360,AL,Nordeste,BUTANTAN/SINOVAC,1075,556,519
Japaratinga,270360,AL,Nordeste,FIOCRUZ/ASTRAZENECA,948,895,53
Japaratuba,280330,SE,Nordeste,BUTANTAN/SINOVAC,3771,2227,1544
Japaratuba,280330,SE,Nordeste,FIOCRUZ/ASTRAZENECA,2755,2753,2
Japaratuba,280330,SE,Nordeste,PFIZER/BIONTECH,243,243,0
Japeri,330227,RJ,Sudeste,BUTANTAN/SINOVAC,19842,11230,8612
Japeri,330227,RJ,Sudeste,FIOCRUZ/ASTRAZENECA,11550,9912,1638
Japeri,330227,RJ,Sudeste,PFIZER/BIONTECH,43,43,0
Japi,240540,RN,Nordeste,FIOCRUZ/ASTRAZENECA,1055,998,57
Japi,240540,RN,Nordeste,BUTANTAN/SINOVAC,990,487,503
Japi,240540,RN,Nordeste,PFIZER/BIONTECH,104,104,0
Japira,411230,PR,Sul,FIOCRUZ/ASTRAZENECA,1303,1234,69
Japira,411230,PR,Sul,BUTANTAN/SINOVAC,1094,570,524
Japira,411230,PR,Sul,PFIZER/BIONTECH,24,24,0
Japoatã,280340,SE,Nordeste,FIOCRUZ/ASTRAZENECA,2521,2441,80
Japoatã,280340,SE,Nordeste,BUTANTAN/SINOVAC,2337,1206,1131
Japoatã,280340,SE,Nordeste,PFIZER/BIONTECH,43,43,0
Japonvar,313535,MG,Sudeste,FIOCRUZ/ASTRAZENECA,1758,1572,186
Japonvar,313535,MG,Sudeste,BUTANTAN/SINOVAC,1592,808,784
Japonvar,313535,MG,Sudeste,PFIZER/BIONTECH,113,113,0
Japorã,500480,MS,Centro-Oeste,BUTANTAN/SINOVAC,6045,3216,2829
Japorã,500480,MS,Centro-Oeste,FIOCRUZ/ASTRAZENECA,1396,1271,125
Japorã,500480,MS,Centro-Oeste,PFIZER/BIONTECH,126,126,0
Japurá,130210,AM,Norte,BUTANTAN/SINOVAC,930,576,354
Japurá,130210,AM,Norte,FIOCRUZ/ASTRAZENECA,546,485,61
Japurá,411240,PR,Sul,FIOCRUZ/ASTRAZENECA,3477,3321,156
Japurá,411240,PR,Sul,BUTANTAN/SINOVAC,2266,1156,1110
Japurá,411240,PR,Sul,PFIZER/BIONTECH,126,126,0
Jaqueira,260795,PE,Nordeste,FIOCRUZ/ASTRAZENECA,2212,2062,150
Jaqueira,260795,PE,Nordeste,BUTANTAN/SINOVAC,1689,855,834
Jaqueira,260795,PE,Nordeste,PFIZER/BIONTECH,245,245,0
Jaquirana,431112,RS,Sul,FIOCRUZ/ASTRAZENECA,1182,1000,182
Jaquirana,431112,RS,Sul,BUTANTAN/SINOVAC,960,477,483
Jaquirana,431112,RS,Sul,PFIZER/BIONTECH,126,126,0
Jaraguá,521180,GO,Centro-Oeste,FIOCRUZ/ASTRAZENECA,11457,10782,675
Jaraguá,521180,GO,Centro-Oeste,BUTANTAN/SINOVAC,5607,2885,2722
Jaraguá,521180,GO,Centro-Oeste,PFIZER/BIONTECH,493,491,2
Jaraguá Do Sul,420890,SC,Sul,FIOCRUZ/ASTRAZENECA,31120,28562,2558
Jaraguá Do Sul,420890,SC,Sul,BUTANTAN/SINOVAC,25983,13631,12352
Jaraguá Do Sul,420890,SC,Sul,PFIZER/BIONTECH,8320,8317,3
Jaraguari,500490,MS,Centro-Oeste,FIOCRUZ/ASTRAZENECA,2344,1976,368
Jaraguari,500490,MS,Centro-Oeste,BUTANTAN/SINOVAC,1979,1006,973
Jaraguari,500490,MS,Centro-Oeste,PFIZER/BIONTECH,167,167,0
Jaramataia,270370,AL,Nordeste,FIOCRUZ/ASTRAZENECA,892,854,38
Jaramataia,270370,AL,Nordeste,BUTANTAN/SINOVAC,772,392,380
Jardim,230710,CE,Nordeste,BUTANTAN/SINOVAC,4707,2424,2283
Jardim,230710,CE,Nordeste,FIOCRUZ/ASTRAZENECA,2871,2404,467
Jardim,500500,MS,Centro-Oeste,FIOCRUZ/ASTRAZENECA,7309,6565,744
Jardim,500500,MS,Centro-Oeste,BUTANTAN/SINOVAC,5676,3104,2572
Jardim,500500,MS,Centro-Oeste,PFIZER/BIONTECH,886,883,3
Jardim Alegre,411250,PR,Sul,FIOCRUZ/ASTRAZENECA,3214,3008,206
Jardim Alegre,411250,PR,Sul,BUTANTAN/SINOVAC,2879,1508,1371
Jardim Alegre,411250,PR,Sul,PFIZER/BIONTECH,76,76,0
Jardim De Angicos,240550,RN,Nordeste,BUTANTAN/SINOVAC,729,391,338
Jardim De Angicos,240550,RN,Nordeste,FIOCRUZ/ASTRAZENECA,689,570,119
Jardim De Angicos,240550,RN,Nordeste,PFIZER/BIONTECH,67,67,0
Jardim De Piranhas,240560,RN,Nordeste,BUTANTAN/SINOVAC,2537,1393,1144
Jardim De Piranhas,240560,RN,Nordeste,FIOCRUZ/ASTRAZENECA,2510,2401,109
Jardim De Piranhas,240560,RN,Nordeste,PFIZER/BIONTECH,219,219,0
Jardim Do Mulato,220525,PI,Nordeste,BUTANTAN/SINOVAC,1479,797,682
Jardim Do Mulato,220525,PI,Nordeste,FIOCRUZ/ASTRAZENECA,443,379,64
Jardim Do Mulato,220525,PI,Nordeste,PFIZER/BIONTECH,47,47,0
Jardim Do Seridó,240570,RN,Nordeste,BUTANTAN/SINOVAC,6614,3328,3286
Jardim Do Seridó,240570,RN,Nordeste,FIOCRUZ/ASTRAZENECA,6437,6010,427
Jardim Do Seridó,240570,RN,Nordeste,PFIZER/BIONTECH,268,268,0
Jardim Olinda,411260,PR,Sul,FIOCRUZ/ASTRAZENECA,511,457,54
Jardim Olinda,411260,PR,Sul,BUTANTAN/SINOVAC,354,195,159
Jardim Olinda,411260,PR,Sul,PFIZER/BIONTECH,12,12,0
Jardinópolis,352510,SP,Sudeste,FIOCRUZ/ASTRAZENECA,11014,10312,702
Jardinópolis,352510,SP,Sudeste,BUTANTAN/SINOVAC,7913,4346,3567
Jardinópolis,352510,SP,Sudeste,PFIZER/BIONTECH,613,613,0
Jardinópolis,420895,SC,Sul,BUTANTAN/SINOVAC,833,512,321
Jardinópolis,420895,SC,Sul,FIOCRUZ/ASTRAZENECA,624,562,62
Jardinópolis,420895,SC,Sul,PFIZER/BIONTECH,18,18,0
Jari,431113,RS,Sul,FIOCRUZ/ASTRAZENECA,941,834,107
Jari,431113,RS,Sul,BUTANTAN/SINOVAC,764,441,323
Jari,431113,RS,Sul,PFIZER/BIONTECH,66,66,0
Jarinu,352520,SP,Sudeste,FIOCRUZ/ASTRAZENECA,5503,5192,311
Jarinu,352520,SP,Sudeste,BUTANTAN/SINOVAC,5460,3066,2394
Jarinu,352520,SP,Sudeste,PFIZER/BIONTECH,670,670,0
Jaru,110011,RO,Norte,BUTANTAN/SINOVAC,9649,4966,4683
Jaru,110011,RO,Norte,FIOCRUZ/ASTRAZENECA,9515,9285,230
Jaru,110011,RO,Norte,PFIZER/BIONTECH,1905,1905,0
Jataí,521190,GO,Centro-Oeste,FIOCRUZ/ASTRAZENECA,21605,19741,1864
Jataí,521190,GO,Centro-Oeste,BUTANTAN/SINOVAC,17876,9028,8848
Jataí,521190,GO,Centro-Oeste,PFIZER/BIONTECH,2453,2452,1
Jataizinho,411270,PR,Sul,FIOCRUZ/ASTRAZENECA,3816,3606,210
Jataizinho,411270,PR,Sul,BUTANTAN/SINOVAC,2430,1238,1192
Jataizinho,411270,PR,Sul,PFIZER/BIONTECH,108,108,0
Jataúba,260800,PE,Nordeste,BUTANTAN/SINOVAC,2556,1390,1166
Jataúba,260800,PE,Nordeste,FIOCRUZ/ASTRAZENECA,2523,2392,131
Jataúba,260800,PE,Nordeste,PFIZER/BIONTECH,32,32,0
Jateí,500510,MS,Centro-Oeste,BUTANTAN/SINOVAC,983,540,443
Jateí,500510,MS,Centro-Oeste,FIOCRUZ/ASTRAZENECA,813,754,59
Jateí,500510,MS,Centro-Oeste,PFIZER/BIONTECH,125,120,5
Jati,230720,CE,Nordeste,BUTANTAN/SINOVAC,1405,742,663
Jati,230720,CE,Nordeste,FIOCRUZ/ASTRAZENECA,811,727,84
Jatobá,210545,MA,Nordeste,FIOCRUZ/ASTRAZENECA,1616,1511,105
Jatobá,210545,MA,Nordeste,BUTANTAN/SINOVAC,1348,690,658
Jatobá,260805,PE,Nordeste,BUTANTAN/SINOVAC,6938,4188,2750
Jatobá,260805,PE,Nordeste,FIOCRUZ/ASTRAZENECA,1984,1890,94
Jatobá,260805,PE,Nordeste,PFIZER/BIONTECH,61,61,0
Jatobá Do Piauí,220527,PI,Nordeste,BUTANTAN/SINOVAC,898,533,365
Jatobá Do Piauí,220527,PI,Nordeste,FIOCRUZ/ASTRAZENECA,595,561,34
Jaú,352530,SP,Sudeste,BUTANTAN/SINOVAC,34113,18589,15524
Jaú,352530,SP,Sudeste,FIOCRUZ/ASTRAZENECA,24845,21879,2966
Jaú,352530,SP,Sudeste,PFIZER/BIONTECH,434,434,0
Jaú Do Tocantins,171150,TO,Norte,FIOCRUZ/ASTRAZENECA,899,869,30
Jaú Do Tocantins,171150,TO,Norte,BUTANTAN/SINOVAC,772,393,379
Jaupaci,521200,GO,Centro-Oeste,FIOCRUZ/ASTRAZENECA,822,767,55
Jaupaci,521200,GO,Centro-Oeste,BUTANTAN/SINOVAC,722,373,349
Jauru,510500,MT,Centro-Oeste,FIOCRUZ/ASTRAZENECA,2171,2050,121
Jauru,510500,MT,Centro-Oeste,BUTANTAN/SINOVAC,1680,874,806
Jauru,510500,MT,Centro-Oeste,PFIZER/BIONTECH,33,33,0
Jeceaba,313540,MG,Sudeste,FIOCRUZ/ASTRAZENECA,1481,1180,301
Jeceaba,313540,MG,Sudeste,BUTANTAN/SINOVAC,1317,697,620
Jeceaba,313540,MG,Sudeste,PFIZER/BIONTECH,51,51,0
Jenipapo De Minas,313545,MG,Sudeste,FIOCRUZ/ASTRAZENECA,1657,1534,123
Jenipapo De Minas,313545,MG,Sudeste,BUTANTAN/SINOVAC,1126,579,547
Jenipapo De Minas,313545,MG,Sudeste,PFIZER/BIONTECH,56,56,0
Jenipapo Dos Vieiras,210547,MA,Nordeste,FIOCRUZ/ASTRAZENECA,2850,2674,176
Jenipapo Dos Vieiras,210547,MA,Nordeste,BUTANTAN/SINOVAC,2379,1392,987
Jequeri,313550,MG,Sudeste,BUTANTAN/SINOVAC,3026,1536,1490
Jequeri,313550,MG,Sudeste,FIOCRUZ/ASTRAZENECA,1901,1717,184
Jequeri,313550,MG,Sudeste,PFIZER/BIONTECH,93,93,0
Jequiá Da Praia,270375,AL,Nordeste,FIOCRUZ/ASTRAZENECA,1700,1494,206
Jequiá Da Praia,270375,AL,Nordeste,BUTANTAN/SINOVAC,1593,805,788
Jequié,291800,BA,Nordeste,BUTANTAN/SINOVAC,35153,18143,17010
Jequié,291800,BA,Nordeste,FIOCRUZ/ASTRAZENECA,31989,28706,3283
Jequié,291800,BA,Nordeste,PFIZER/BIONTECH,614,586,28
Jequitaí,313560,MG,Sudeste,FIOCRUZ/ASTRAZENECA,1702,1539,163
Jequitaí,313560,MG,Sudeste,BUTANTAN/SINOVAC,1506,728,778
Jequitaí,313560,MG,Sudeste,PFIZER/BIONTECH,35,35,0
Jequitibá,313570,MG,Sudeste,FIOCRUZ/ASTRAZENECA,1557,1440,117
Jequitibá,313570,MG,Sudeste,BUTANTAN/SINOVAC,1356,689,667
Jequitibá,313570,MG,Sudeste,PFIZER/BIONTECH,72,72,0
Jequitinhonha,313580,MG,Sudeste,BUTANTAN/SINOVAC,5275,2695,2580
Jequitinhonha,313580,MG,Sudeste,FIOCRUZ/ASTRAZENECA,4485,4129,356
Jequitinhonha,313580,MG,Sudeste,PFIZER/BIONTECH,203,203,0
Jeremoabo,291810,BA,Nordeste,FIOCRUZ/ASTRAZENECA,11947,10961,986
Jeremoabo,291810,BA,Nordeste,BUTANTAN/SINOVAC,6908,3475,3433
Jeremoabo,291810,BA,Nordeste,PFIZER/BIONTECH,170,170,0
Jericó,250740,PB,Nordeste,BUTANTAN/SINOVAC,2094,1074,1020
Jericó,250740,PB,Nordeste,FIOCRUZ/ASTRAZENECA,1648,1494,154
Jericó,250740,PB,Nordeste,PFIZER/BIONTECH,70,70,0
Jeriquara,352540,SP,Sudeste,FIOCRUZ/ASTRAZENECA,765,686,79
Jeriquara,352540,SP,Sudeste,BUTANTAN/SINOVAC,742,400,342
Jeriquara,352540,SP,Sudeste,PFIZER/BIONTECH,58,57,1
Jerônimo Monteiro,320310,ES,Sudeste,BUTANTAN/SINOVAC,3727,1912,1815
Jerônimo Monteiro,320310,ES,Sudeste,FIOCRUZ/ASTRAZENECA,3129,2827,302
Jerônimo Monteiro,320310,ES,Sudeste,PFIZER/BIONTECH,547,547,0
Jerumenha,220530,PI,Nordeste,BUTANTAN/SINOVAC,960,522,438
Jerumenha,220530,PI,Nordeste,FIOCRUZ/ASTRAZENECA,832,778,54
Jerumenha,220530,PI,Nordeste,PFIZER/BIONTECH,94,94,0
Jesuânia,313590,MG,Sudeste,FIOCRUZ/ASTRAZENECA,1318,1208,110
Jesuânia,313590,MG,Sudeste,BUTANTAN/SINOVAC,1250,655,595
Jesuânia,313590,MG,Sudeste,PFIZER/BIONTECH,78,78,0
Jesuítas,411275,PR,Sul,FIOCRUZ/ASTRAZENECA,3634,3467,167
Jesuítas,411275,PR,Sul,BUTANTAN/SINOVAC,2396,1226,1170
Jesuítas,411275,PR,Sul,PFIZER/BIONTECH,120,120,0
Jesúpolis,521205,GO,Centro-Oeste,BUTANTAN/SINOVAC,554,280,274
Jesúpolis,521205,GO,Centro-Oeste,FIOCRUZ/ASTRAZENECA,505,455,50
Ji-Paraná,110012,RO,Norte,BUTANTAN/SINOVAC,13720,7548,6172
Ji-Paraná,110012,RO,Norte,FIOCRUZ/ASTRAZENECA,4245,3648,597
Ji-Paraná,110012,RO,Norte,PFIZER/BIONTECH,40,40,0
Jijoca De Jericoacoara,230725,CE,Nordeste,BUTANTAN/SINOVAC,2513,1276,1237
Jijoca De Jericoacoara,230725,CE,Nordeste,FIOCRUZ/ASTRAZENECA,1545,1395,150
Jiquiriçá,291820,BA,Nordeste,FIOCRUZ/ASTRAZENECA,3025,2638,387
Jiquiriçá,291820,BA,Nordeste,BUTANTAN/SINOVAC,2574,1347,1227
Jiquiriçá,291820,BA,Nordeste,PFIZER/BIONTECH,633,631,2
Jitaúna,291830,BA,Nordeste,FIOCRUZ/ASTRAZENECA,2215,2149,66
Jitaúna,291830,BA,Nordeste,BUTANTAN/SINOVAC,2148,1206,942
Jitaúna,291830,BA,Nordeste,PFIZER/BIONTECH,30,30,0
Joaçaba,420900,SC,Sul,FIOCRUZ/ASTRAZENECA,9795,8794,1001
Joaçaba,420900,SC,Sul,BUTANTAN/SINOVAC,6610,3882,2728
Joaçaba,420900,SC,Sul,PFIZER/BIONTECH,847,847,0
Joaíma,313600,MG,Sudeste,BUTANTAN/SINOVAC,3352,1690,1662
Joaíma,313600,MG,Sudeste,FIOCRUZ/ASTRAZENECA,3237,3004,233
Joaíma,313600,MG,Sudeste,PFIZER/BIONTECH,109,109,0
Joanésia,313610,MG,Sudeste,BUTANTAN/SINOVAC,1282,647,635
Joanésia,313610,MG,Sudeste,FIOCRUZ/ASTRAZENECA,1008,897,111
Joanésia,313610,MG,Sudeste,PFIZER/BIONTECH,73,73,0
Joanópolis,352550,SP,Sudeste,BUTANTAN/SINOVAC,3274,1805,1469
Joanópolis,352550,SP,Sudeste,FIOCRUZ/ASTRAZENECA,2920,2691,229
Joanópolis,352550,SP,Sudeste,PFIZER/BIONTECH,296,296,0
João Alfredo,260810,PE,Nordeste,FIOCRUZ/ASTRAZENECA,7180,6585,595
João Alfredo,260810,PE,Nordeste,BUTANTAN/SINOVAC,5892,3059,2833
João Alfredo,260810,PE,Nordeste,PFIZER/BIONTECH,527,527,0
João Câmara,240580,RN,Nordeste,FIOCRUZ/ASTRAZENECA,8382,6918,1464
João Câmara,240580,RN,Nordeste,BUTANTAN/SINOVAC,4745,2562,2183
João Câmara,240580,RN,Nordeste,PFIZER/BIONTECH,712,712,0
João Costa,220535,PI,Nordeste,FIOCRUZ/ASTRAZENECA,778,736,42
João Costa,220535,PI,Nordeste,BUTANTAN/SINOVAC,521,268,253
João Costa,220535,PI,Nordeste,PFIZER/BIONTECH,23,23,0
João Dias,240590,RN,Nordeste,FIOCRUZ/ASTRAZENECA,608,570,38
João Dias,240590,RN,Nordeste,BUTANTAN/SINOVAC,565,299,266
João Dias,240590,RN,Nordeste,PFIZER/BIONTECH,90,90,0
João Dourado,291835,BA,Nordeste,FIOCRUZ/ASTRAZENECA,4638,4055,583
João Dourado,291835,BA,Nordeste,BUTANTAN/SINOVAC,3518,1825,1693
João Dourado,291835,BA,Nordeste,PFIZER/BIONTECH,139,139,0
João Lisboa,210550,MA,Nordeste,BUTANTAN/SINOVAC,3550,1856,1694
João Lisboa,210550,MA,Nordeste,FIOCRUZ/ASTRAZENECA,3465,3184,281
João Monlevade,313620,MG,Sudeste,BUTANTAN/SINOVAC,19175,9659,9516
João Monlevade,313620,MG,Sudeste,FIOCRUZ/ASTRAZENECA,11907,10295,1612
João Monlevade,313620,MG,Sudeste,PFIZER/BIONTECH,1732,1732,0
João Neiva,320313,ES,Sudeste,BUTANTAN/SINOVAC,5092,2664,2428
João Neiva,320313,ES,Sudeste,FIOCRUZ/ASTRAZENECA,3547,3357,190
João Neiva,320313,ES,Sudeste,PFIZER/BIONTECH,573,573,0
João Pessoa,250750,PB,Nordeste,BUTANTAN/SINOVAC,184145,95054,89091
João Pessoa,250750,PB,Nordeste,FIOCRUZ/ASTRAZENECA,175283,152616,22667
João Pessoa,250750,PB,Nordeste,PFIZER/BIONTECH,36102,36097,5
João Pinheiro,313630,MG,Sudeste,FIOCRUZ/ASTRAZENECA,9082,7885,1197
João Pinheiro,313630,MG,Sudeste,BUTANTAN/SINOVAC,8404,4245,4159
João Pinheiro,313630,MG,Sudeste,PFIZER/BIONTECH,427,426,1
João Ramalho,352560,SP,Sudeste,FIOCRUZ/ASTRAZENECA,1218,1130,88
João Ramalho,352560,SP,Sudeste,BUTANTAN/SINOVAC,897,507,390
João Ramalho,352560,SP,Sudeste,PFIZER/BIONTECH,103,103,0
Joaquim Felício,313640,MG,Sudeste,BUTANTAN/SINOVAC,1334,679,655
Joaquim Felício,313640,MG,Sudeste,FIOCRUZ/ASTRAZENECA,938,842,96
Joaquim Felício,313640,MG,Sudeste,PFIZER/BIONTECH,47,47,0
Joaquim Gomes,270380,AL,Nordeste,BUTANTAN/SINOVAC,4355,2306,2049
Joaquim Gomes,270380,AL,Nordeste,FIOCRUZ/ASTRAZENECA,2820,2662,158
Joaquim Nabuco,260820,PE,Nordeste,BUTANTAN/SINOVAC,1951,1137,814
Joaquim Nabuco,260820,PE,Nordeste,FIOCRUZ/ASTRAZENECA,1692,1629,63
Joaquim Nabuco,260820,PE,Nordeste,PFIZER/BIONTECH,30,30,0
Joaquim Pires,220540,PI,Nordeste,FIOCRUZ/ASTRAZENECA,2402,2250,152
Joaquim Pires,220540,PI,Nordeste,BUTANTAN/SINOVAC,1946,1046,900
Joaquim Pires,220540,PI,Nordeste,PFIZER/BIONTECH,236,236,0
Joaquim Távora,411280,PR,Sul,FIOCRUZ/ASTRAZENECA,2521,2371,150
Joaquim Távora,411280,PR,Sul,BUTANTAN/SINOVAC,2485,1284,1201
Joaquim Távora,411280,PR,Sul,PFIZER/BIONTECH,105,105,0
Joca Claudino,251365,PB,Nordeste,BUTANTAN/SINOVAC,783,414,369
Joca Claudino,251365,PB,Nordeste,FIOCRUZ/ASTRAZENECA,519,466,53
Joca Claudino,251365,PB,Nordeste,PFIZER/BIONTECH,52,52,0
Joca Marques,220545,PI,Nordeste,BUTANTAN/SINOVAC,655,427,228
Joca Marques,220545,PI,Nordeste,FIOCRUZ/ASTRAZENECA,540,510,30
Jóia,431115,RS,Sul,BUTANTAN/SINOVAC,2261,1241,1020
Jóia,431115,RS,Sul,FIOCRUZ/ASTRAZENECA,1504,1374,130
Jóia,431115,RS,Sul,PFIZER/BIONTECH,166,164,2
Joinville,420910,SC,Sul,FIOCRUZ/ASTRAZENECA,115457,106484,8973
Joinville,420910,SC,Sul,BUTANTAN/SINOVAC,102304,52464,49840
Joinville,420910,SC,Sul,PFIZER/BIONTECH,21410,21368,42
Jordânia,313650,MG,Sudeste,BUTANTAN/SINOVAC,2616,1331,1285
Jordânia,313650,MG,Sudeste,FIOCRUZ/ASTRAZENECA,1291,1106,185
Jordânia,313650,MG,Sudeste,PFIZER/BIONTECH,109,109,0
Jordão,120032,AC,Norte,BUTANTAN/SINOVAC,3377,1953,1424
Jordão,120032,AC,Norte,FIOCRUZ/ASTRAZENECA,695,663,32
Jordão,120032,AC,Norte,PFIZER/BIONTECH,40,40,0
José Boiteux,420915,SC,Sul,BUTANTAN/SINOVAC,2599,1362,1237
José Boiteux,420915,SC,Sul,FIOCRUZ/ASTRAZENECA,430,420,10
José Bonifácio,352570,SP,Sudeste,FIOCRUZ/ASTRAZENECA,8359,7672,687
José Bonifácio,352570,SP,Sudeste,BUTANTAN/SINOVAC,8152,4495,3657
José Bonifácio,352570,SP,Sudeste,PFIZER/BIONTECH,900,898,2
José Da Penha,240600,RN,Nordeste,BUTANTAN/SINOVAC,2072,1094,978
José Da Penha,240600,RN,Nordeste,FIOCRUZ/ASTRAZENECA,1463,1336,127
José Da Penha,240600,RN,Nordeste,PFIZER/BIONTECH,163,163,0
José De Freitas,220550,PI,Nordeste,BUTANTAN/SINOVAC,6203,3846,2357
José De Freitas,220550,PI,Nordeste,FIOCRUZ/ASTRAZENECA,4814,4202,612
José Gonçalves De Minas,313652,MG,Sudeste,FIOCRUZ/ASTRAZENECA,993,935,58
José Gonçalves De Minas,313652,MG,Sudeste,BUTANTAN/SINOVAC,503,270,233
José Gonçalves De Minas,313652,MG,Sudeste,PFIZER/BIONTECH,57,57,0
José Raydan,313655,MG,Sudeste,BUTANTAN/SINOVAC,991,601,390
José Raydan,313655,MG,Sudeste,FIOCRUZ/ASTRAZENECA,511,456,55
Joselândia,210560,MA,Nordeste,FIOCRUZ/ASTRAZENECA,2869,2694,175
Joselândia,210560,MA,Nordeste,BUTANTAN/SINOVAC,2284,1194,1090
Josenópolis,313657,MG,Sudeste,BUTANTAN/SINOVAC,596,330,266
Josenópolis,313657,MG,Sudeste,FIOCRUZ/ASTRAZENECA,191,168,23
Joviânia,521210,GO,Centro-Oeste,FIOCRUZ/ASTRAZENECA,1932,1794,138
Joviânia,521210,GO,Centro-Oeste,BUTANTAN/SINOVAC,1303,677,626
Juara,510510,MT,Centro-Oeste,FIOCRUZ/ASTRAZENECA,5758,5362,396
Juara,510510,MT,Centro-Oeste,BUTANTAN/SINOVAC,4401,2249,2152
Juara,510510,MT,Centro-Oeste,PFIZER/BIONTECH,412,412,0
Juarez Távora,250760,PB,Nordeste,FIOCRUZ/ASTRAZENECA,1641,1500,141
Juarez Távora,250760,PB,Nordeste,BUTANTAN/SINOVAC,1622,834,788
Juarez Távora,250760,PB,Nordeste,PFIZER/BIONTECH,118,118,0
Juarina,171180,TO,Norte,BUTANTAN/SINOVAC,425,223,202
Juarina,171180,TO,Norte,FIOCRUZ/ASTRAZENECA,308,298,10
Juatuba,313665,MG,Sudeste,BUTANTAN/SINOVAC,3288,1903,1385
Juatuba,313665,MG,Sudeste,FIOCRUZ/ASTRAZENECA,2598,2501,97
Juatuba,313665,MG,Sudeste,PFIZER/BIONTECH,12,12,0
Juazeirinho,250770,PB,Nordeste,BUTANTAN/SINOVAC,3045,1569,1476
Juazeirinho,250770,PB,Nordeste,FIOCRUZ/ASTRAZENECA,2158,1920,238
Juazeirinho,250770,PB,Nordeste,PFIZER/BIONTECH,136,136,0
Juazeiro,291840,BA,Nordeste,BUTANTAN/SINOVAC,26242,15559,10683
Juazeiro,291840,BA,Nordeste,FIOCRUZ/ASTRAZENECA,22520,20013,2507
Juazeiro,291840,BA,Nordeste,PFIZER/BIONTECH,987,987,0
Juazeiro Do Norte,230730,CE,Nordeste,BUTANTAN/SINOVAC,48989,25045,23944
Juazeiro Do Norte,230730,CE,Nordeste,FIOCRUZ/ASTRAZENECA,10600,8539,2061
Juazeiro Do Norte,230730,CE,Nordeste,PFIZER/BIONTECH,1,1,0
Juazeiro Do Piauí,220551,PI,Nordeste,BUTANTAN/SINOVAC,773,431,342
Juazeiro Do Piauí,220551,PI,Nordeste,FIOCRUZ/ASTRAZENECA,443,442,1
Jucás,230740,CE,Nordeste,BUTANTAN/SINOVAC,4739,2577,2162
Jucás,230740,CE,Nordeste,FIOCRUZ/ASTRAZENECA,2581,2250,331
Jucati,260825,PE,Nordeste,FIOCRUZ/ASTRAZENECA,1995,1829,166
Jucati,260825,PE,Nordeste,BUTANTAN/SINOVAC,1923,1027,896
Jucati,260825,PE,Nordeste,PFIZER/BIONTECH,176,176,0
Jucuruçu,291845,BA,Nordeste,BUTANTAN/SINOVAC,390,171,219
Jucuruçu,291845,BA,Nordeste,FIOCRUZ/ASTRAZENECA,316,303,13
Jucurutu,240610,RN,Nordeste,BUTANTAN/SINOVAC,4124,2085,2039
Jucurutu,240610,RN,Nordeste,FIOCRUZ/ASTRAZENECA,2558,2320,238
Jucurutu,240610,RN,Nordeste,PFIZER/BIONTECH,161,161,0
Juína,510515,MT,Centro-Oeste,BUTANTAN/SINOVAC,9278,4915,4363
Juína,510515,MT,Centro-Oeste,FIOCRUZ/ASTRAZENECA,6050,5513,537
Juína,510515,MT,Centro-Oeste,PFIZER/BIONTECH,325,325,0
Juiz De Fora,313670,MG,Sudeste,BUTANTAN/SINOVAC,100686,45997,54689
Juiz De Fora,313670,MG,Sudeste,FIOCRUZ/ASTRAZENECA,98497,86341,12156
Juiz De Fora,313670,MG,Sudeste,PFIZER/BIONTECH,5181,5175,6
Júlio Borges,220552,PI,Nordeste,BUTANTAN/SINOVAC,739,484,255
Júlio Borges,220552,PI,Nordeste,FIOCRUZ/ASTRAZENECA,567,551,16
Júlio De Castilhos,431120,RS,Sul,FIOCRUZ/ASTRAZENECA,5398,4732,666
Júlio De Castilhos,431120,RS,Sul,BUTANTAN/SINOVAC,5014,2541,2473
Júlio De Castilhos,431120,RS,Sul,PFIZER/BIONTECH,681,679,2
Júlio Mesquita,352580,SP,Sudeste,FIOCRUZ/ASTRAZENECA,1033,940,93
Júlio Mesquita,352580,SP,Sudeste,BUTANTAN/SINOVAC,905,508,397
Júlio Mesquita,352580,SP,Sudeste,PFIZER/BIONTECH,45,45,0
Jumirim,352585,SP,Sudeste,FIOCRUZ/ASTRAZENECA,678,605,73
Jumirim,352585,SP,Sudeste,BUTANTAN/SINOVAC,640,338,302
Jumirim,352585,SP,Sudeste,PFIZER/BIONTECH,53,53,0
Junco Do Maranhão,210565,MA,Nordeste,FIOCRUZ/ASTRAZENECA,1151,1090,61
Junco Do Maranhão,210565,MA,Nordeste,BUTANTAN/SINOVAC,751,338,413
Junco Do Seridó,250780,PB,Nordeste,BUTANTAN/SINOVAC,1435,721,714
Junco Do Seridó,250780,PB,Nordeste,FIOCRUZ/ASTRAZENECA,1039,939,100
Junco Do Seridó,250780,PB,Nordeste,PFIZER/BIONTECH,91,91,0
Jundiá,240615,RN,Nordeste,FIOCRUZ/ASTRAZENECA,899,793,106
Jundiá,240615,RN,Nordeste,BUTANTAN/SINOVAC,824,417,407
Jundiá,240615,RN,Nordeste,PFIZER/BIONTECH,45,45,0
Jundiá,270390,AL,Nordeste,BUTANTAN/SINOVAC,707,369,338
Jundiá,270390,AL,Nordeste,FIOCRUZ/ASTRAZENECA,619,547,72
Jundiaí,352590,SP,Sudeste,FIOCRUZ/ASTRAZENECA,104752,97024,7728
Jundiaí,352590,SP,Sudeste,BUTANTAN/SINOVAC,90032,47327,42705
Jundiaí,352590,SP,Sudeste,PFIZER/BIONTECH,6628,6621,7
Jundiaí Do Sul,411290,PR,Sul,FIOCRUZ/ASTRAZENECA,1031,981,50
Jundiaí Do Sul,411290,PR,Sul,BUTANTAN/SINOVAC,796,416,380
Jundiaí Do Sul,411290,PR,Sul,PFIZER/BIONTECH,10,10,0
Junqueiro,270400,AL,Nordeste,FIOCRUZ/ASTRAZENECA,4057,3775,282
Junqueiro,270400,AL,Nordeste,BUTANTAN/SINOVAC,3846,2066,1780
Junqueirópolis,352600,SP,Sudeste,BUTANTAN/SINOVAC,5452,2676,2776
Junqueirópolis,352600,SP,Sudeste,FIOCRUZ/ASTRAZENECA,5091,4671,420
Junqueirópolis,352600,SP,Sudeste,PFIZER/BIONTECH,348,348,0
Jupi,260830,PE,Nordeste,FIOCRUZ/ASTRAZENECA,3270,2986,284
Jupi,260830,PE,Nordeste,BUTANTAN/SINOVAC,2488,1285,1203
Jupi,260830,PE,Nordeste,PFIZER/BIONTECH,426,426,0
Jupiá,420917,SC,Sul,BUTANTAN/SINOVAC,598,313,285
Jupiá,420917,SC,Sul,FIOCRUZ/ASTRAZENECA,536,482,54
Jupiá,420917,SC,Sul,PFIZER/BIONTECH,27,27,0
Juquiá,352610,SP,Sudeste,FIOCRUZ/ASTRAZENECA,4468,4122,346
Juquiá,352610,SP,Sudeste,BUTANTAN/SINOVAC,4067,2150,1917
Juquiá,352610,SP,Sudeste,PFIZER/BIONTECH,182,182,0
Juquitiba,352620,SP,Sudeste,BUTANTAN/SINOVAC,6085,3109,2976
Juquitiba,352620,SP,Sudeste,FIOCRUZ/ASTRAZENECA,6007,5616,391
Juquitiba,352620,SP,Sudeste,PFIZER/BIONTECH,337,336,1
Juramento,313680,MG,Sudeste,BUTANTAN/SINOVAC,838,441,397
Juramento,313680,MG,Sudeste,FIOCRUZ/ASTRAZENECA,504,474,30
Juranda,411295,PR,Sul,FIOCRUZ/ASTRAZENECA,2273,2124,149
Juranda,411295,PR,Sul,BUTANTAN/SINOVAC,1611,841,770
Juranda,411295,PR,Sul,PFIZER/BIONTECH,114,114,0
Jurema,220553,PI,Nordeste,BUTANTAN/SINOVAC,762,389,373
Jurema,220553,PI,Nordeste,FIOCRUZ/ASTRAZENECA,759,698,61
Jurema,260840,PE,Nordeste,BUTANTAN/SINOVAC,2776,1437,1339
Jurema,260840,PE,Nordeste,FIOCRUZ/ASTRAZENECA,2671,2364,307
Jurema,260840,PE,Nordeste,PFIZER/BIONTECH,117,117,0
Juripiranga,250790,PB,Nordeste,BUTANTAN/SINOVAC,2161,1117,1044
Juripiranga,250790,PB,Nordeste,FIOCRUZ/ASTRAZENECA,1640,1476,164
Juripiranga,250790,PB,Nordeste,PFIZER/BIONTECH,205,205,0
Juru,250800,PB,Nordeste,BUTANTAN/SINOVAC,2919,1529,1390
Juru,250800,PB,Nordeste,FIOCRUZ/ASTRAZENECA,1884,1725,159
Juru,250800,PB,Nordeste,PFIZER/BIONTECH,136,135,1
Juruá,130220,AM,Norte,BUTANTAN/SINOVAC,592,381,211
Juruá,130220,AM,Norte,FIOCRUZ/ASTRAZENECA,401,400,1
Juruaia,313690,MG,Sudeste,BUTANTAN/SINOVAC,1941,979,962
Juruaia,313690,MG,Sudeste,FIOCRUZ/ASTRAZENECA,1761,1609,152
Juruaia,313690,MG,Sudeste,PFIZER/BIONTECH,58,58,0
Juruena,510517,MT,Centro-Oeste,BUTANTAN/SINOVAC,1402,703,699
Juruena,510517,MT,Centro-Oeste,FIOCRUZ/ASTRAZENECA,1002,787,215
Juruena,510517,MT,Centro-Oeste,PFIZER/BIONTECH,142,142,0
Juruti,150390,PA,Norte,FIOCRUZ/ASTRAZENECA,9175,6886,2289
Juruti,150390,PA,Norte,BUTANTAN/SINOVAC,1905,1013,892
Juscimeira,510520,MT,Centro-Oeste,FIOCRUZ/ASTRAZENECA,2515,2348,167
Juscimeira,510520,MT,Centro-Oeste,BUTANTAN/SINOVAC,2439,1281,1158
Juscimeira,510520,MT,Centro-Oeste,PFIZER/BIONTECH,263,263,0
Jussara,291850,BA,Nordeste,BUTANTAN/SINOVAC,3388,1801,1587
Jussara,291850,BA,Nordeste,FIOCRUZ/ASTRAZENECA,3259,3127,132
Jussara,291850,BA,Nordeste,PFIZER/BIONTECH,42,42,0
Jussara,411300,PR,Sul,FIOCRUZ/ASTRAZENECA,2043,1950,93
Jussara,411300,PR,Sul,BUTANTAN/SINOVAC,1253,673,580
Jussara,411300,PR,Sul,PFIZER/BIONTECH,36,36,0
Jussara,521220,GO,Centro-Oeste,FIOCRUZ/ASTRAZENECA,6608,6159,449
Jussara,521220,GO,Centro-Oeste,BUTANTAN/SINOVAC,4666,2366,2300
Jussara,521220,GO,Centro-Oeste,PFIZER/BIONTECH,8,4,4
Jussari,291855,BA,Nordeste,FIOCRUZ/ASTRAZENECA,1489,1309,180
Jussari,291855,BA,Nordeste,BUTANTAN/SINOVAC,1326,685,641
Jussari,291855,BA,Nordeste,PFIZER/BIONTECH,13,13,0
Jussiape,291860,BA,Nordeste,FIOCRUZ/ASTRAZENECA,2845,2580,265
Jussiape,291860,BA,Nordeste,BUTANTAN/SINOVAC,2364,1227,1137
Jussiape,291860,BA,Nordeste,PFIZER/BIONTECH,108,108,0
Jutaí,130230,AM,Norte,FIOCRUZ/ASTRAZENECA,395,395,0
Jutaí,130230,AM,Norte,BUTANTAN/SINOVAC,244,202,42
Juti,500515,MS,Centro-Oeste,BUTANTAN/SINOVAC,2330,1205,1125
Juti,500515,MS,Centro-Oeste,FIOCRUZ/ASTRAZENECA,2052,1859,193
Juti,500515,MS,Centro-Oeste,PFIZER/BIONTECH,273,273,0
Juvenília,313695,MG,Sudeste,FIOCRUZ/ASTRAZENECA,1669,1570,99
Juvenília,313695,MG,Sudeste,BUTANTAN/SINOVAC,943,463,480
Juvenília,313695,MG,Sudeste,PFIZER/BIONTECH,42,42,0
Kaloré,411310,PR,Sul,FIOCRUZ/ASTRAZENECA,1780,1677,103
Kaloré,411310,PR,Sul,BUTANTAN/SINOVAC,1437,749,688
Kaloré,411310,PR,Sul,PFIZER/BIONTECH,23,23,0
Lábrea,130240,AM,Norte,BUTANTAN/SINOVAC,9954,5415,4539
Lábrea,130240,AM,Norte,FIOCRUZ/ASTRAZENECA,8549,7124,1425
Lacerdópolis,420920,SC,Sul,BUTANTAN/SINOVAC,796,405,391
Lacerdópolis,420920,SC,Sul,FIOCRUZ/ASTRAZENECA,645,579,66
Lacerdópolis,420920,SC,Sul,PFIZER/BIONTECH,72,72,0
Ladainha,313700,MG,Sudeste,BUTANTAN/SINOVAC,3398,1684,1714
Ladainha,313700,MG,Sudeste,FIOCRUZ/ASTRAZENECA,2155,1873,282
Ladainha,313700,MG,Sudeste,PFIZER/BIONTECH,136,136,0
Ladário,500520,MS,Centro-Oeste,FIOCRUZ/ASTRAZENECA,6050,5726,324
Ladário,500520,MS,Centro-Oeste,BUTANTAN/SINOVAC,3116,1755,1361
Ladário,500520,MS,Centro-Oeste,PFIZER/BIONTECH,562,561,1
Lafaiete Coutinho,291870,BA,Nordeste,BUTANTAN/SINOVAC,925,519,406
Lafaiete Coutinho,291870,BA,Nordeste,FIOCRUZ/ASTRAZENECA,494,471,23
Lagamar,313710,MG,Sudeste,BUTANTAN/SINOVAC,1966,1001,965
Lagamar,313710,MG,Sudeste,FIOCRUZ/ASTRAZENECA,1699,1547,152
Lagamar,313710,MG,Sudeste,PFIZER/BIONTECH,190,190,0
Lagarto,280350,SE,Nordeste,BUTANTAN/SINOVAC,14282,8379,5903
Lagarto,280350,SE,Nordeste,FIOCRUZ/ASTRAZENECA,8401,7090,1311
Lages,420930,SC,Sul,FIOCRUZ/ASTRAZENECA,42811,39669,3142
Lages,420930,SC,Sul,BUTANTAN/SINOVAC,34384,18897,15487
Lages,420930,SC,Sul,PFIZER/BIONTECH,4606,4604,2
Lago Da Pedra,210570,MA,Nordeste,FIOCRUZ/ASTRAZENECA,8401,7660,741
Lago Da Pedra,210570,MA,Nordeste,BUTANTAN/SINOVAC,7171,3725,3446
Lago Do Junco,210580,MA,Nordeste,FIOCRUZ/ASTRAZENECA,2025,1886,139
Lago Do Junco,210580,MA,Nordeste,BUTANTAN/SINOVAC,1593,820,773
Lago Dos Rodrigues,210594,MA,Nordeste,FIOCRUZ/ASTRAZENECA,1818,1684,134
Lago Dos Rodrigues,210594,MA,Nordeste,BUTANTAN/SINOVAC,1557,804,753
Lago Verde,210590,MA,Nordeste,BUTANTAN/SINOVAC,2756,1557,1199
Lago Verde,210590,MA,Nordeste,FIOCRUZ/ASTRAZENECA,2742,2608,134
Lagoa,250810,PB,Nordeste,BUTANTAN/SINOVAC,1601,831,770
Lagoa,250810,PB,Nordeste,FIOCRUZ/ASTRAZENECA,928,858,70
Lagoa,250810,PB,Nordeste,PFIZER/BIONTECH,102,102,0
Lagoa Alegre,220555,PI,Nordeste,BUTANTAN/SINOVAC,1631,894,737
Lagoa Alegre,220555,PI,Nordeste,FIOCRUZ/ASTRAZENECA,1285,1176,109
Lagoa Bonita Do Sul,431123,RS,Sul,BUTANTAN/SINOVAC,636,317,319
Lagoa Bonita Do Sul,431123,RS,Sul,FIOCRUZ/ASTRAZENECA,603,559,44
Lagoa Bonita Do Sul,431123,RS,Sul,PFIZER/BIONTECH,101,101,0
Lagoa D'Anta,240620,RN,Nordeste,BUTANTAN/SINOVAC,1288,669,619
Lagoa D'Anta,240620,RN,Nordeste,FIOCRUZ/ASTRAZENECA,1274,1205,69
Lagoa D'Anta,240620,RN,Nordeste,PFIZER/BIONTECH,117,117,0
Lagoa Da Canoa,270410,AL,Nordeste,FIOCRUZ/ASTRAZENECA,3309,3032,277
Lagoa Da Canoa,270410,AL,Nordeste,BUTANTAN/SINOVAC,3236,1667,1569
Lagoa Da Confusão,171190,TO,Norte,BUTANTAN/SINOVAC,1571,852,719
Lagoa Da Confusão,171190,TO,Norte,FIOCRUZ/ASTRAZENECA,1231,1195,36
Lagoa Da Prata,313720,MG,Sudeste,FIOCRUZ/ASTRAZENECA,8722,8261,461
Lagoa Da Prata,313720,MG,Sudeste,BUTANTAN/SINOVAC,8479,4481,3998
Lagoa Da Prata,313720,MG,Sudeste,PFIZER/BIONTECH,1717,1717,0
Lagoa De Dentro,250820,PB,Nordeste,BUTANTAN/SINOVAC,1916,963,953
Lagoa De Dentro,250820,PB,Nordeste,FIOCRUZ/ASTRAZENECA,1549,1376,173
Lagoa De Dentro,250820,PB,Nordeste,PFIZER/BIONTECH,103,103,0
Lagoa De Itaenga,260850,PE,Nordeste,FIOCRUZ/ASTRAZENECA,3677,3439,238
Lagoa De Itaenga,260850,PE,Nordeste,BUTANTAN/SINOVAC,3318,1730,1588
Lagoa De Itaenga,260850,PE,Nordeste,PFIZER/BIONTECH,248,248,0
Lagoa De Pedras,240630,RN,Nordeste,BUTANTAN/SINOVAC,1781,900,881
Lagoa De Pedras,240630,RN,Nordeste,FIOCRUZ/ASTRAZENECA,1586,1504,82
Lagoa De Pedras,240630,RN,Nordeste,PFIZER/BIONTECH,188,188,0
Lagoa De São Francisco,220557,PI,Nordeste,FIOCRUZ/ASTRAZENECA,1676,1345,331
Lagoa De São Francisco,220557,PI,Nordeste,BUTANTAN/SINOVAC,1374,802,572
Lagoa De Velhos,240640,RN,Nordeste,FIOCRUZ/ASTRAZENECA,597,559,38
Lagoa De Velhos,240640,RN,Nordeste,BUTANTAN/SINOVAC,587,302,285
Lagoa De Velhos,240640,RN,Nordeste,PFIZER/BIONTECH,95,95,0
Lagoa Do Barro Do Piauí,220556,PI,Nordeste,BUTANTAN/SINOVAC,881,452,429
Lagoa Do Barro Do Piauí,220556,PI,Nordeste,FIOCRUZ/ASTRAZENECA,724,651,73
Lagoa Do Carro,260845,PE,Nordeste,FIOCRUZ/ASTRAZENECA,3430,3191,239
Lagoa Do Carro,260845,PE,Nordeste,BUTANTAN/SINOVAC,2783,1456,1327
Lagoa Do Carro,260845,PE,Nordeste,PFIZER/BIONTECH,380,380,0
Lagoa Do Mato,210592,MA,Nordeste,FIOCRUZ/ASTRAZENECA,1954,1894,60
Lagoa Do Mato,210592,MA,Nordeste,BUTANTAN/SINOVAC,1502,786,716
Lagoa Do Ouro,260860,PE,Nordeste,FIOCRUZ/ASTRAZENECA,2591,2397,194
Lagoa Do Ouro,260860,PE,Nordeste,BUTANTAN/SINOVAC,2482,1274,1208
Lagoa Do Ouro,260860,PE,Nordeste,PFIZER/BIONTECH,120,120,0
Lagoa Do Piauí,220558,PI,Nordeste,BUTANTAN/SINOVAC,959,496,463
Lagoa Do Piauí,220558,PI,Nordeste,FIOCRUZ/ASTRAZENECA,823,799,24
Lagoa Do Piauí,220558,PI,Nordeste,PFIZER/BIONTECH,29,29,0
Lagoa Do Sítio,220559,PI,Nordeste,BUTANTAN/SINOVAC,622,377,245
Lagoa Do Sítio,220559,PI,Nordeste,FIOCRUZ/ASTRAZENECA,291,288,3
Lagoa Do Tocantins,171195,TO,Norte,BUTANTAN/SINOVAC,773,407,366
Lagoa Do Tocantins,171195,TO,Norte,FIOCRUZ/ASTRAZENECA,295,277,18
Lagoa Dos Gatos,260870,PE,Nordeste,FIOCRUZ/ASTRAZENECA,3102,2745,357
Lagoa Dos Gatos,260870,PE,Nordeste,BUTANTAN/SINOVAC,2462,1290,1172
Lagoa Dos Gatos,260870,PE,Nordeste,PFIZER/BIONTECH,90,90,0
Lagoa Dos Patos,313730,MG,Sudeste,BUTANTAN/SINOVAC,900,450,450
Lagoa Dos Patos,313730,MG,Sudeste,FIOCRUZ/ASTRAZENECA,867,779,88
Lagoa Dos Patos,313730,MG,Sudeste,PFIZER/BIONTECH,48,47,1
Lagoa Dos Três Cantos,431127,RS,Sul,BUTANTAN/SINOVAC,754,383,371
Lagoa Dos Três Cantos,431127,RS,Sul,FIOCRUZ/ASTRAZENECA,498,405,93
Lagoa Dos Três Cantos,431127,RS,Sul,PFIZER/BIONTECH,52,52,0
Lagoa Dourada,313740,MG,Sudeste,FIOCRUZ/ASTRAZENECA,2537,2362,175
Lagoa Dourada,313740,MG,Sudeste,BUTANTAN/SINOVAC,2045,1034,1011
Lagoa Dourada,313740,MG,Sudeste,PFIZER/BIONTECH,256,256,0
Lagoa Formosa,313750,MG,Sudeste,BUTANTAN/SINOVAC,5505,2762,2743
Lagoa Formosa,313750,MG,Sudeste,FIOCRUZ/ASTRAZENECA,3690,3525,165
Lagoa Formosa,313750,MG,Sudeste,PFIZER/BIONTECH,67,67,0
Lagoa Grande,260875,PE,Nordeste,BUTANTAN/SINOVAC,3534,1827,1707
Lagoa Grande,260875,PE,Nordeste,FIOCRUZ/ASTRAZENECA,2919,2690,229
Lagoa Grande,260875,PE,Nordeste,PFIZER/BIONTECH,119,119,0
Lagoa Grande,313753,MG,Sudeste,FIOCRUZ/ASTRAZENECA,1889,1727,162
Lagoa Grande,313753,MG,Sudeste,BUTANTAN/SINOVAC,1779,935,844
Lagoa Grande,313753,MG,Sudeste,PFIZER/BIONTECH,256,256,0
Lagoa Grande Do Maranhão,210596,MA,Nordeste,BUTANTAN/SINOVAC,1172,651,521
Lagoa Grande Do Maranhão,210596,MA,Nordeste,FIOCRUZ/ASTRAZENECA,992,952,40
Lagoa Nova,240650,RN,Nordeste,FIOCRUZ/ASTRAZENECA,4543,4334,209
Lagoa Nova,240650,RN,Nordeste,BUTANTAN/SINOVAC,3507,1830,1677
Lagoa Nova,240650,RN,Nordeste,PFIZER/BIONTECH,100,100,0
Lagoa Real,291875,BA,Nordeste,FIOCRUZ/ASTRAZENECA,2919,2725,194
Lagoa Real,291875,BA,Nordeste,BUTANTAN/SINOVAC,2790,1531,1259
Lagoa Real,291875,BA,Nordeste,PFIZER/BIONTECH,11,11,0
Lagoa Salgada,240660,RN,Nordeste,FIOCRUZ/ASTRAZENECA,1770,1629,141
Lagoa Salgada,240660,RN,Nordeste,BUTANTAN/SINOVAC,1533,806,727
Lagoa Salgada,240660,RN,Nordeste,PFIZER/BIONTECH,346,346,0
Lagoa Santa,313760,MG,Sudeste,BUTANTAN/SINOVAC,11800,6286,5514
Lagoa Santa,313760,MG,Sudeste,FIOCRUZ/ASTRAZENECA,9951,8878,1073
Lagoa Santa,313760,MG,Sudeste,PFIZER/BIONTECH,1122,1121,1
Lagoa Santa,521225,GO,Centro-Oeste,BUTANTAN/SINOVAC,377,188,189
Lagoa Santa,521225,GO,Centro-Oeste,FIOCRUZ/ASTRAZENECA,371,341,30
Lagoa Santa,521225,GO,Centro-Oeste,PFIZER/BIONTECH,29,29,0
Lagoa Seca,250830,PB,Nordeste,BUTANTAN/SINOVAC,5178,2665,2513
Lagoa Seca,250830,PB,Nordeste,FIOCRUZ/ASTRAZENECA,4125,3727,398
Lagoa Seca,250830,PB,Nordeste,PFIZER/BIONTECH,503,503,0
Lagoa Vermelha,431130,RS,Sul,FIOCRUZ/ASTRAZENECA,7207,6662,545
Lagoa Vermelha,431130,RS,Sul,BUTANTAN/SINOVAC,6966,3521,3445
Lagoa Vermelha,431130,RS,Sul,PFIZER/BIONTECH,787,787,0
Lagoão,431125,RS,Sul,FIOCRUZ/ASTRAZENECA,1519,1312,207
Lagoão,431125,RS,Sul,BUTANTAN/SINOVAC,1046,529,517
Lagoão,431125,RS,Sul,PFIZER/BIONTECH,94,94,0
Lagoinha,352630,SP,Sudeste,FIOCRUZ/ASTRAZENECA,1543,1400,143
Lagoinha,352630,SP,Sudeste,BUTANTAN/SINOVAC,1442,713,729
Lagoinha,352630,SP,Sudeste,PFIZER/BIONTECH,106,106,0
Lagoinha Do Piauí,220554,PI,Nordeste,BUTANTAN/SINOVAC,699,377,322
Lagoinha Do Piauí,220554,PI,Nordeste,FIOCRUZ/ASTRAZENECA,485,441,44
Laguna,420940,SC,Sul,FIOCRUZ/ASTRAZENECA,11970,11129,841
Laguna,420940,SC,Sul,BUTANTAN/SINOVAC,10768,5703,5065
Laguna,420940,SC,Sul,PFIZER/BIONTECH,839,838,1
Laguna Carapã,500525,MS,Centro-Oeste,BUTANTAN/SINOVAC,2626,1434,1192
Laguna Carapã,500525,MS,Centro-Oeste,FIOCRUZ/ASTRAZENECA,1514,1383,131
Laguna Carapã,500525,MS,Centro-Oeste,PFIZER/BIONTECH,167,167,0
Laje,291880,BA,Nordeste,BUTANTAN/SINOVAC,3350,1760,1590
Laje,291880,BA,Nordeste,FIOCRUZ/ASTRAZENECA,2892,2777,115
Laje,291880,BA,Nordeste,PFIZER/BIONTECH,217,217,0
Laje Do Muriaé,330230,RJ,Sudeste,BUTANTAN/SINOVAC,1763,951,812
Laje Do Muriaé,330230,RJ,Sudeste,FIOCRUZ/ASTRAZENECA,1253,1114,139
Lajeado,171200,TO,Norte,BUTANTAN/SINOVAC,781,414,367
Lajeado,171200,TO,Norte,FIOCRUZ/ASTRAZENECA,732,661,71
Lajeado,431140,RS,Sul,BUTANTAN/SINOVAC,18816,9797,9019
Lajeado,431140,RS,Sul,FIOCRUZ/ASTRAZENECA,16566,15154,1412
Lajeado,431140,RS,Sul,PFIZER/BIONTECH,1157,1157,0
Lajeado Do Bugre,431142,RS,Sul,BUTANTAN/SINOVAC,685,355,330
Lajeado Do Bugre,431142,RS,Sul,FIOCRUZ/ASTRAZENECA,587,540,47
Lajeado Do Bugre,431142,RS,Sul,PFIZER/BIONTECH,64,64,0
Lajeado Grande,420945,SC,Sul,BUTANTAN/SINOVAC,465,231,234
Lajeado Grande,420945,SC,Sul,FIOCRUZ/ASTRAZENECA,243,221,22
Lajeado Novo,210598,MA,Nordeste,BUTANTAN/SINOVAC,1116,610,506
Lajeado Novo,210598,MA,Nordeste,FIOCRUZ/ASTRAZENECA,1012,964,48
Lajedão,291890,BA,Nordeste,BUTANTAN/SINOVAC,1376,764,612
Lajedão,291890,BA,Nordeste,FIOCRUZ/ASTRAZENECA,1164,1001,163
Lajedão,291890,BA,Nordeste,PFIZER/BIONTECH,12,12,0
Lajedinho,291900,BA,Nordeste,FIOCRUZ/ASTRAZENECA,1147,1058,89
Lajedinho,291900,BA,Nordeste,BUTANTAN/SINOVAC,647,331,316
Lajedinho,291900,BA,Nordeste,PFIZER/BIONTECH,9,9,0
Lajedo,260880,PE,Nordeste,FIOCRUZ/ASTRAZENECA,7051,6444,607
Lajedo,260880,PE,Nordeste,BUTANTAN/SINOVAC,6499,3416,3083
Lajedo,260880,PE,Nordeste,PFIZER/BIONTECH,311,311,0
Lajedo Do Tabocal,291905,BA,Nordeste,BUTANTAN/SINOVAC,1788,1017,771
Lajedo Do Tabocal,291905,BA,Nordeste,FIOCRUZ/ASTRAZENECA,1224,1124,100
Lajedo Do Tabocal,291905,BA,Nordeste,PFIZER/BIONTECH,35,35,0
Lajes,240670,RN,Nordeste,FIOCRUZ/ASTRAZENECA,1652,1571,81
Lajes,240670,RN,Nordeste,BUTANTAN/SINOVAC,1570,807,763
Lajes,240670,RN,Nordeste,PFIZER/BIONTECH,141,141,0
Lajes Pintadas,240680,RN,Nordeste,FIOCRUZ/ASTRAZENECA,1475,1354,121
Lajes Pintadas,240680,RN,Nordeste,BUTANTAN/SINOVAC,1411,738,673
Lajes Pintadas,240680,RN,Nordeste,PFIZER/BIONTECH,220,219,1
Lajinha,313770,MG,Sudeste,BUTANTAN/SINOVAC,3379,1845,1534
Lajinha,313770,MG,Sudeste,FIOCRUZ/ASTRAZENECA,2461,2270,191
Lamarão,291910,BA,Nordeste,BUTANTAN/SINOVAC,1392,811,581
Lamarão,291910,BA,Nordeste,FIOCRUZ/ASTRAZENECA,1074,1056,18
Lamarão,291910,BA,Nordeste,PFIZER/BIONTECH,216,215,1
Lambari,313780,MG,Sudeste,FIOCRUZ/ASTRAZENECA,4532,4173,359
Lambari,313780,MG,Sudeste,BUTANTAN/SINOVAC,3858,2016,1842
Lambari,313780,MG,Sudeste,PFIZER/BIONTECH,23,23,0
Lambari D'Oeste,510523,MT,Centro-Oeste,FIOCRUZ/ASTRAZENECA,1004,952,52
Lambari D'Oeste,510523,MT,Centro-Oeste,BUTANTAN/SINOVAC,697,370,327
Lambari D'Oeste,510523,MT,Centro-Oeste,PFIZER/BIONTECH,30,30,0
Lamim,313790,MG,Sudeste,FIOCRUZ/ASTRAZENECA,1424,1039,385
Lamim,313790,MG,Sudeste,BUTANTAN/SINOVAC,841,434,407
Lamim,313790,MG,Sudeste,PFIZER/BIONTECH,23,23,0
Landri Sales,220560,PI,Nordeste,FIOCRUZ/ASTRAZENECA,1409,1326,83
Landri Sales,220560,PI,Nordeste,BUTANTAN/SINOVAC,1131,588,543
Landri Sales,220560,PI,Nordeste,PFIZER/BIONTECH,105,105,0
Lapa,411320,PR,Sul,BUTANTAN/SINOVAC,8952,4701,4251
Lapa,411320,PR,Sul,FIOCRUZ/ASTRAZENECA,8015,7516,499
Lapa,411320,PR,Sul,PFIZER/BIONTECH,210,210,0
Lapão,291915,BA,Nordeste,FIOCRUZ/ASTRAZENECA,6510,6459,51
Lapão,291915,BA,Nordeste,BUTANTAN/SINOVAC,2646,1446,1200
Laranja Da Terra,320316,ES,Sudeste,BUTANTAN/SINOVAC,3791,1920,1871
Laranja Da Terra,320316,ES,Sudeste,FIOCRUZ/ASTRAZENECA,2737,2601,136
Laranja Da Terra,320316,ES,Sudeste,PFIZER/BIONTECH,458,458,0
Laranjal,313800,MG,Sudeste,FIOCRUZ/ASTRAZENECA,1996,1858,138
Laranjal,313800,MG,Sudeste,BUTANTAN/SINOVAC,1472,790,682
Laranjal,313800,MG,Sudeste,PFIZER/BIONTECH,50,50,0
Laranjal,411325,PR,Sul,FIOCRUZ/ASTRAZENECA,1517,1454,63
Laranjal,411325,PR,Sul,BUTANTAN/SINOVAC,888,457,431
Laranjal,411325,PR,Sul,PFIZER/BIONTECH,30,30,0
Laranjal Do Jari,160027,AP,Norte,FIOCRUZ/ASTRAZENECA,6180,5759,421
Laranjal Do Jari,160027,AP,Norte,BUTANTAN/SINOVAC,5599,2865,2734
Laranjal Do Jari,160027,AP,Norte,PFIZER/BIONTECH,1585,1583,2
Laranjal Paulista,352640,SP,Sudeste,FIOCRUZ/ASTRAZENECA,6442,6001,441
Laranjal Paulista,352640,SP,Sudeste,BUTANTAN/SINOVAC,6149,3371,2778
Laranjal Paulista,352640,SP,Sudeste,PFIZER/BIONTECH,481,481,0
Laranjeiras,280360,SE,Nordeste,BUTANTAN/SINOVAC,3261,1724,1537
Laranjeiras,280360,SE,Nordeste,FIOCRUZ/ASTRAZENECA,3230,3229,1
Laranjeiras Do Sul,411330,PR,Sul,FIOCRUZ/ASTRAZENECA,9350,8937,413
Laranjeiras Do Sul,411330,PR,Sul,BUTANTAN/SINOVAC,6288,3280,3008
Laranjeiras Do Sul,411330,PR,Sul,PFIZER/BIONTECH,383,383,0
Lassance,313810,MG,Sudeste,FIOCRUZ/ASTRAZENECA,1782,1681,101
Lassance,313810,MG,Sudeste,BUTANTAN/SINOVAC,1255,625,630
Lassance,313810,MG,Sudeste,PFIZER/BIONTECH,138,138,0
Lastro,250840,PB,Nordeste,BUTANTAN/SINOVAC,684,351,333
Lastro,250840,PB,Nordeste,FIOCRUZ/ASTRAZENECA,600,543,57
Lastro,250840,PB,Nordeste,PFIZER/BIONTECH,53,53,0
Laurentino,420950,SC,Sul,FIOCRUZ/ASTRAZENECA,1422,1348,74
Laurentino,420950,SC,Sul,BUTANTAN/SINOVAC,1249,646,603
Laurentino,420950,SC,Sul,PFIZER/BIONTECH,169,169,0
Lauro De Freitas,291920,BA,Nordeste,BUTANTAN/SINOVAC,37202,19452,17750
Lauro De Freitas,291920,BA,Nordeste,FIOCRUZ/ASTRAZENECA,36920,33570,3350
Lauro De Freitas,291920,BA,Nordeste,PFIZER/BIONTECH,7171,7164,7
Lauro Müller,420960,SC,Sul,BUTANTAN/SINOVAC,2550,1327,1223
Lauro Müller,420960,SC,Sul,FIOCRUZ/ASTRAZENECA,2451,2280,171
Lavandeira,171215,TO,Norte,BUTANTAN/SINOVAC,457,232,225
Lavandeira,171215,TO,Norte,FIOCRUZ/ASTRAZENECA,365,347,18
Lavínia,352650,SP,Sudeste,BUTANTAN/SINOVAC,2247,1244,1003
Lavínia,352650,SP,Sudeste,FIOCRUZ/ASTRAZENECA,1752,1620,132
Lavínia,352650,SP,Sudeste,PFIZER/BIONTECH,156,156,0
Lavras,313820,MG,Sudeste,BUTANTAN/SINOVAC,19900,10655,9245
Lavras,313820,MG,Sudeste,FIOCRUZ/ASTRAZENECA,8064,7559,505
Lavras,313820,MG,Sudeste,PFIZER/BIONTECH,1,1,0
Lavras Da Mangabeira,230750,CE,Nordeste,BUTANTAN/SINOVAC,5621,3032,2589
Lavras Da Mangabeira,230750,CE,Nordeste,FIOCRUZ/ASTRAZENECA,3187,2805,382
Lavras Da Mangabeira,230750,CE,Nordeste,PFIZER/BIONTECH,30,30,0
Lavras Do Sul,431150,RS,Sul,FIOCRUZ/ASTRAZENECA,1992,1878,114
Lavras Do Sul,431150,RS,Sul,BUTANTAN/SINOVAC,1720,930,790
Lavras Do Sul,431150,RS,Sul,PFIZER/BIONTECH,114,114,0
Lavrinhas,352660,SP,Sudeste,FIOCRUZ/ASTRAZENECA,1275,1201,74
Lavrinhas,352660,SP,Sudeste,BUTANTAN/SINOVAC,1094,571,523
Leandro Ferreira,313830,MG,Sudeste,BUTANTAN/SINOVAC,943,475,468
Leandro Ferreira,313830,MG,Sudeste,FIOCRUZ/ASTRAZENECA,622,572,50
Lebon Régis,420970,SC,Sul,FIOCRUZ/ASTRAZENECA,2646,2502,144
Lebon Régis,420970,SC,Sul,BUTANTAN/SINOVAC,2104,1175,929
Lebon Régis,420970,SC,Sul,PFIZER/BIONTECH,270,270,0
Leme,352670,SP,Sudeste,FIOCRUZ/ASTRAZENECA,21861,20048,1813
Leme,352670,SP,Sudeste,BUTANTAN/SINOVAC,19967,11426,8541
Leme,352670,SP,Sudeste,PFIZER/BIONTECH,1853,1853,0
Leme Do Prado,313835,MG,Sudeste,FIOCRUZ/ASTRAZENECA,1440,1358,82
Leme Do Prado,313835,MG,Sudeste,BUTANTAN/SINOVAC,889,457,432
Leme Do Prado,313835,MG,Sudeste,PFIZER/BIONTECH,57,57,0
Lençóis,291930,BA,Nordeste,FIOCRUZ/ASTRAZENECA,2355,2150,205
Lençóis,291930,BA,Nordeste,BUTANTAN/SINOVAC,1544,821,723
Lençóis,291930,BA,Nordeste,PFIZER/BIONTECH,97,97,0
Lençóis Paulista,352680,SP,Sudeste,FIOCRUZ/ASTRAZENECA,16565,15603,962
Lençóis Paulista,352680,SP,Sudeste,BUTANTAN/SINOVAC,11475,5749,5726
Lençóis Paulista,352680,SP,Sudeste,PFIZER/BIONTECH,1127,1126,1
Leoberto Leal,420980,SC,Sul,FIOCRUZ/ASTRAZENECA,1062,898,164
Leoberto Leal,420980,SC,Sul,BUTANTAN/SINOVAC,611,350,261
Leopoldina,313840,MG,Sudeste,BUTANTAN/SINOVAC,13599,6938,6661
Leopoldina,313840,MG,Sudeste,FIOCRUZ/ASTRAZENECA,9589,8609,980
Leopoldina,313840,MG,Sudeste,PFIZER/BIONTECH,671,671,0
Leopoldo De Bulhões,521230,GO,Centro-Oeste,FIOCRUZ/ASTRAZENECA,2125,2022,103
Leopoldo De Bulhões,521230,GO,Centro-Oeste,BUTANTAN/SINOVAC,1243,636,607
Leopoldo De Bulhões,521230,GO,Centro-Oeste,PFIZER/BIONTECH,102,102,0
Leópolis,411340,PR,Sul,FIOCRUZ/ASTRAZENECA,1488,1416,72
Leópolis,411340,PR,Sul,BUTANTAN/SINOVAC,987,506,481
Leópolis,411340,PR,Sul,PFIZER/BIONTECH,24,24,0
Liberato Salzano,431160,RS,Sul,BUTANTAN/SINOVAC,2070,1051,1019
Liberato Salzano,431160,RS,Sul,FIOCRUZ/ASTRAZENECA,1341,1207,134
Liberato Salzano,431160,RS,Sul,PFIZER/BIONTECH,89,89,0
Liberdade,313850,MG,Sudeste,BUTANTAN/SINOVAC,1444,772,672
Liberdade,313850,MG,Sudeste,FIOCRUZ/ASTRAZENECA,669,604,65
Licínio De Almeida,291940,BA,Nordeste,BUTANTAN/SINOVAC,2706,1388,1318
Licínio De Almeida,291940,BA,Nordeste,FIOCRUZ/ASTRAZENECA,2419,2218,201
Licínio De Almeida,291940,BA,Nordeste,PFIZER/BIONTECH,157,157,0
Lidianópolis,411342,PR,Sul,FIOCRUZ/ASTRAZENECA,1493,1409,84
Lidianópolis,411342,PR,Sul,BUTANTAN/SINOVAC,1093,562,531
Lidianópolis,411342,PR,Sul,PFIZER/BIONTECH,24,24,0
Lima Campos,210600,MA,Nordeste,FIOCRUZ/ASTRAZENECA,3997,3127,870
Lima Campos,210600,MA,Nordeste,BUTANTAN/SINOVAC,2096,1101,995
Lima Duarte,313860,MG,Sudeste,BUTANTAN/SINOVAC,3201,1928,1273
Lima Duarte,313860,MG,Sudeste,FIOCRUZ/ASTRAZENECA,2109,2083,26
Limeira,352690,SP,Sudeste,FIOCRUZ/ASTRAZENECA,57989,53246,4743
Limeira,352690,SP,Sudeste,BUTANTAN/SINOVAC,57163,32414,24749
Limeira,352690,SP,Sudeste,PFIZER/BIONTECH,3673,3671,2
Limeira Do Oeste,313862,MG,Sudeste,FIOCRUZ/ASTRAZENECA,1852,1716,136
Limeira Do Oeste,313862,MG,Sudeste,BUTANTAN/SINOVAC,1240,643,597
Limeira Do Oeste,313862,MG,Sudeste,PFIZER/BIONTECH,88,88,0
Limoeiro,260890,PE,Nordeste,FIOCRUZ/ASTRAZENECA,14803,13712,1091
Limoeiro,260890,PE,Nordeste,BUTANTAN/SINOVAC,12074,6260,5814
Limoeiro,260890,PE,Nordeste,PFIZER/BIONTECH,1507,1507,0
Limoeiro De Anadia,270420,AL,Nordeste,BUTANTAN/SINOVAC,5744,3064,2680
Limoeiro De Anadia,270420,AL,Nordeste,FIOCRUZ/ASTRAZENECA,4586,3921,665
Limoeiro Do Ajuru,150400,PA,Norte,FIOCRUZ/ASTRAZENECA,3123,2809,314
Limoeiro Do Ajuru,150400,PA,Norte,BUTANTAN/SINOVAC,2181,1185,996
Limoeiro Do Norte,230760,CE,Nordeste,BUTANTAN/SINOVAC,9916,5084,4832
Limoeiro Do Norte,230760,CE,Nordeste,FIOCRUZ/ASTRAZENECA,6428,5636,792
Lindoeste,411345,PR,Sul,BUTANTAN/SINOVAC,1510,837,673
Lindoeste,411345,PR,Sul,FIOCRUZ/ASTRAZENECA,1120,1051,69
Lindóia,352700,SP,Sudeste,FIOCRUZ/ASTRAZENECA,1824,1657,167
Lindóia,352700,SP,Sudeste,BUTANTAN/SINOVAC,1769,920,849
Lindóia,352700,SP,Sudeste,PFIZER/BIONTECH,186,186,0
Lindóia Do Sul,420985,SC,Sul,BUTANTAN/SINOVAC,1414,730,684
Lindóia Do Sul,420985,SC,Sul,FIOCRUZ/ASTRAZENECA,1248,1115,133
Lindóia Do Sul,420985,SC,Sul,PFIZER/BIONTECH,132,132,0
Lindolfo Collor,431162,RS,Sul,FIOCRUZ/ASTRAZENECA,997,948,49
Lindolfo Collor,431162,RS,Sul,BUTANTAN/SINOVAC,879,458,421
Lindolfo Collor,431162,RS,Sul,PFIZER/BIONTECH,100,100,0
Linha Nova,431164,RS,Sul,BUTANTAN/SINOVAC,510,270,240
Linha Nova,431164,RS,Sul,FIOCRUZ/ASTRAZENECA,466,416,50
Linha Nova,431164,RS,Sul,PFIZER/BIONTECH,54,54,0
Linhares,320320,ES,Sudeste,FIOCRUZ/ASTRAZENECA,35751,32768,2983
Linhares,320320,ES,Sudeste,BUTANTAN/SINOVAC,32039,17648,14391
Linhares,320320,ES,Sudeste,PFIZER/BIONTECH,3497,3482,15
Lins,352710,SP,Sudeste,BUTANTAN/SINOVAC,19677,10226,9451
Lins,352710,SP,Sudeste,FIOCRUZ/ASTRAZENECA,18544,16515,2029
Lins,352710,SP,Sudeste,PFIZER/BIONTECH,755,754,1
Livramento,250850,PB,Nordeste,BUTANTAN/SINOVAC,1632,821,811
Livramento,250850,PB,Nordeste,FIOCRUZ/ASTRAZENECA,1015,891,124
Livramento,250850,PB,Nordeste,PFIZER/BIONTECH,66,66,0
Livramento De Nossa Senhora,291950,BA,Nordeste,FIOCRUZ/ASTRAZENECA,11558,10136,1422
Livramento De Nossa Senhora,291950,BA,Nordeste,BUTANTAN/SINOVAC,9952,5186,4766
Livramento De Nossa Senhora,291950,BA,Nordeste,PFIZER/BIONTECH,864,864,0
Lizarda,171240,TO,Norte,BUTANTAN/SINOVAC,671,348,323
Lizarda,171240,TO,Norte,FIOCRUZ/ASTRAZENECA,612,600,12
Loanda,411350,PR,Sul,FIOCRUZ/ASTRAZENECA,6632,6307,325
Loanda,411350,PR,Sul,BUTANTAN/SINOVAC,5040,2641,2399
Loanda,411350,PR,Sul,PFIZER/BIONTECH,776,776,0
Lobato,411360,PR,Sul,FIOCRUZ/ASTRAZENECA,1368,1300,68
Lobato,411360,PR,Sul,BUTANTAN/SINOVAC,937,478,459
Logradouro,250855,PB,Nordeste,BUTANTAN/SINOVAC,912,474,438
Logradouro,250855,PB,Nordeste,FIOCRUZ/ASTRAZENECA,767,683,84
Logradouro,250855,PB,Nordeste,PFIZER/BIONTECH,67,67,0
Londrina,411370,PR,Sul,BUTANTAN/SINOVAC,143927,73346,70581
Londrina,411370,PR,Sul,FIOCRUZ/ASTRAZENECA,116328,102714,13614
Londrina,411370,PR,Sul,PFIZER/BIONTECH,16078,16066,12
Lontra,313865,MG,Sudeste,BUTANTAN/SINOVAC,1886,950,936
Lontra,313865,MG,Sudeste,FIOCRUZ/ASTRAZENECA,1604,1450,154
Lontra,313865,MG,Sudeste,PFIZER/BIONTECH,119,119,0
Lontras,420990,SC,Sul,FIOCRUZ/ASTRAZENECA,2335,2150,185
Lontras,420990,SC,Sul,BUTANTAN/SINOVAC,1786,973,813
Lontras,420990,SC,Sul,PFIZER/BIONTECH,167,167,0
Lorena,352720,SP,Sudeste,FIOCRUZ/ASTRAZENECA,18222,16980,1242
Lorena,352720,SP,Sudeste,BUTANTAN/SINOVAC,17772,9268,8504
Lorena,352720,SP,Sudeste,PFIZER/BIONTECH,637,636,1
Loreto,210610,MA,Nordeste,FIOCRUZ/ASTRAZENECA,2421,2292,129
Loreto,210610,MA,Nordeste,BUTANTAN/SINOVAC,1569,827,742
Lourdes,352725,SP,Sudeste,BUTANTAN/SINOVAC,974,502,472
Lourdes,352725,SP,Sudeste,FIOCRUZ/ASTRAZENECA,762,665,97
Lourdes,352725,SP,Sudeste,PFIZER/BIONTECH,96,95,1
Louveira,352730,SP,Sudeste,FIOCRUZ/ASTRAZENECA,8938,8540,398
Louveira,352730,SP,Sudeste,BUTANTAN/SINOVAC,6520,3380,3140
Louveira,352730,SP,Sudeste,PFIZER/BIONTECH,968,968,0
Lucas Do Rio Verde,510525,MT,Centro-Oeste,FIOCRUZ/ASTRAZENECA,7710,7137,573
Lucas Do Rio Verde,510525,MT,Centro-Oeste,BUTANTAN/SINOVAC,5068,2800,2268
Lucélia,352740,SP,Sudeste,BUTANTAN/SINOVAC,5088,2706,2382
Lucélia,352740,SP,Sudeste,FIOCRUZ/ASTRAZENECA,4299,3656,643
Lucélia,352740,SP,Sudeste,PFIZER/BIONTECH,214,213,1
Lucena,250860,PB,Nordeste,BUTANTAN/SINOVAC,2122,1055,1067
Lucena,250860,PB,Nordeste,FIOCRUZ/ASTRAZENECA,1258,1147,111
Lucianópolis,352750,SP,Sudeste,BUTANTAN/SINOVAC,706,363,343
Lucianópolis,352750,SP,Sudeste,FIOCRUZ/ASTRAZENECA,704,638,66
Lucianópolis,352750,SP,Sudeste,PFIZER/BIONTECH,56,56,0
Luciara,510530,MT,Centro-Oeste,FIOCRUZ/ASTRAZENECA,487,447,40
Luciara,510530,MT,Centro-Oeste,BUTANTAN/SINOVAC,451,252,199
Luciara,510530,MT,Centro-Oeste,PFIZER/BIONTECH,42,42,0
Lucrécia,240690,RN,Nordeste,FIOCRUZ/ASTRAZENECA,1546,1436,110
Lucrécia,240690,RN,Nordeste,BUTANTAN/SINOVAC,1483,768,715
Lucrécia,240690,RN,Nordeste,PFIZER/BIONTECH,177,176,1
Luís Antônio,352760,SP,Sudeste,FIOCRUZ/ASTRAZENECA,2955,2788,167
Luís Antônio,352760,SP,Sudeste,BUTANTAN/SINOVAC,2122,1154,968
Luís Antônio,352760,SP,Sudeste,PFIZER/BIONTECH,121,121,0
Luís Correia,220570,PI,Nordeste,BUTANTAN/SINOVAC,3715,1930,1785
Luís Correia,220570,PI,Nordeste,FIOCRUZ/ASTRAZENECA,3325,3094,231
Luís Domingues,210620,MA,Nordeste,FIOCRUZ/ASTRAZENECA,1177,1080,97
Luís Domingues,210620,MA,Nordeste,BUTANTAN/SINOVAC,897,489,408
Luís Eduardo Magalhães,291955,BA,Nordeste,FIOCRUZ/ASTRAZENECA,6597,6289,308
Luís Eduardo Magalhães,291955,BA,Nordeste,BUTANTAN/SINOVAC,6007,3124,2883
Luís Eduardo Magalhães,291955,BA,Nordeste,PFIZER/BIONTECH,396,395,1
Luís Gomes,240700,RN,Nordeste,FIOCRUZ/ASTRAZENECA,2643,2519,124
Luís Gomes,240700,RN,Nordeste,BUTANTAN/SINOVAC,2367,1216,1151
Luís Gomes,240700,RN,Nordeste,PFIZER/BIONTECH,292,291,1
Luisburgo,313867,MG,Sudeste,BUTANTAN/SINOVAC,1074,546,528
Luisburgo,313867,MG,Sudeste,FIOCRUZ/ASTRAZENECA,765,703,62
Luisburgo,313867,MG,Sudeste,PFIZER/BIONTECH,29,29,0
Luislândia,313868,MG,Sudeste,BUTANTAN/SINOVAC,978,518,460
Luislândia,313868,MG,Sudeste,FIOCRUZ/ASTRAZENECA,704,640,64
Luislândia,313868,MG,Sudeste,PFIZER/BIONTECH,18,18,0
Luiz Alves,421000,SC,Sul,BUTANTAN/SINOVAC,2115,1109,1006
Luiz Alves,421000,SC,Sul,FIOCRUZ/ASTRAZENECA,2013,1950,63
Luiz Alves,421000,SC,Sul,PFIZER/BIONTECH,320,320,0
Luiziana,411373,PR,Sul,FIOCRUZ/ASTRAZENECA,2246,2168,78
Luiziana,411373,PR,Sul,BUTANTAN/SINOVAC,1324,679,645
Luiziânia,352770,SP,Sudeste,BUTANTAN/SINOVAC,1097,570,527
Luiziânia,352770,SP,Sudeste,FIOCRUZ/ASTRAZENECA,875,752,123
Luiziânia,352770,SP,Sudeste,PFIZER/BIONTECH,159,159,0
Luminárias,313870,MG,Sudeste,BUTANTAN/SINOVAC,1118,583,535
Luminárias,313870,MG,Sudeste,FIOCRUZ/ASTRAZENECA,1069,982,87
Luminárias,313870,MG,Sudeste,PFIZER/BIONTECH,25,25,0
Lunardelli,411375,PR,Sul,FIOCRUZ/ASTRAZENECA,1409,1314,95
Lunardelli,411375,PR,Sul,BUTANTAN/SINOVAC,1145,614,531
Lupércio,352780,SP,Sudeste,FIOCRUZ/ASTRAZENECA,1170,1059,111
Lupércio,352780,SP,Sudeste,BUTANTAN/SINOVAC,973,512,461
Lupércio,352780,SP,Sudeste,PFIZER/BIONTECH,36,36,0
Lupionópolis,411380,PR,Sul,BUTANTAN/SINOVAC,1181,600,581
Lupionópolis,411380,PR,Sul,FIOCRUZ/ASTRAZENECA,1179,1051,128
Lupionópolis,411380,PR,Sul,PFIZER/BIONTECH,25,25,0
Lutécia,352790,SP,Sudeste,BUTANTAN/SINOVAC,1010,533,477
Lutécia,352790,SP,Sudeste,FIOCRUZ/ASTRAZENECA,751,677,74
Lutécia,352790,SP,Sudeste,PFIZER/BIONTECH,65,65,0
Luz,313880,MG,Sudeste,BUTANTAN/SINOVAC,4197,2156,2041
Luz,313880,MG,Sudeste,FIOCRUZ/ASTRAZENECA,3496,3148,348
Luzerna,421003,SC,Sul,BUTANTAN/SINOVAC,1824,920,904
Luzerna,421003,SC,Sul,FIOCRUZ/ASTRAZENECA,1748,1651,97
Luzerna,421003,SC,Sul,PFIZER/BIONTECH,196,196,0
Luziânia,521250,GO,Centro-Oeste,FIOCRUZ/ASTRAZENECA,30982,28951,2031
Luziânia,521250,GO,Centro-Oeste,BUTANTAN/SINOVAC,22415,11511,10904
Luziânia,521250,GO,Centro-Oeste,PFIZER/BIONTECH,2390,2388,2
Luzilândia,220580,PI,Nordeste,BUTANTAN/SINOVAC,3906,2006,1900
Luzilândia,220580,PI,Nordeste,FIOCRUZ/ASTRAZENECA,3432,3097,335
Luzilândia,220580,PI,Nordeste,PFIZER/BIONTECH,128,128,0
Luzinópolis,171245,TO,Norte,BUTANTAN/SINOVAC,617,319,298
Luzinópolis,171245,TO,Norte,FIOCRUZ/ASTRAZENECA,358,337,21
Macaé,330240,RJ,Sudeste,FIOCRUZ/ASTRAZENECA,19394,18999,395
Macaé,330240,RJ,Sudeste,BUTANTAN/SINOVAC,19136,12306,6830
Macaé,330240,RJ,Sudeste,PFIZER/BIONTECH,2000,2000,0
Macaíba,240710,RN,Nordeste,FIOCRUZ/ASTRAZENECA,10964,9826,1138
Macaíba,240710,RN,Nordeste,BUTANTAN/SINOVAC,10659,5521,5138
Macaíba,240710,RN,Nordeste,PFIZER/BIONTECH,1694,1691,3
Macajuba,291960,BA,Nordeste,BUTANTAN/SINOVAC,1930,1054,876
Macajuba,291960,BA,Nordeste,FIOCRUZ/ASTRAZENECA,573,509,64
Macajuba,291960,BA,Nordeste,PFIZER/BIONTECH,11,11,0
Maçambará,431171,RS,Sul,BUTANTAN/SINOVAC,940,477,463
Maçambará,431171,RS,Sul,FIOCRUZ/ASTRAZENECA,927,853,74
Maçambará,431171,RS,Sul,PFIZER/BIONTECH,187,187,0
Macambira,280370,SE,Nordeste,BUTANTAN/SINOVAC,1738,932,806
Macambira,280370,SE,Nordeste,FIOCRUZ/ASTRAZENECA,1066,1065,1
Macambira,280370,SE,Nordeste,PFIZER/BIONTECH,185,185,0
Macapá,160030,AP,Norte,BUTANTAN/SINOVAC,71769,38802,32967
Macapá,160030,AP,Norte,FIOCRUZ/ASTRAZENECA,63788,59296,4492
Macapá,160030,AP,Norte,PFIZER/BIONTECH,4083,4076,7
Macaparana,260900,PE,Nordeste,FIOCRUZ/ASTRAZENECA,4788,4391,397
Macaparana,260900,PE,Nordeste,BUTANTAN/SINOVAC,4207,2177,2030
Macaparana,260900,PE,Nordeste,PFIZER/BIONTECH,515,515,0
Macarani,291970,BA,Nordeste,FIOCRUZ/ASTRAZENECA,3922,3559,363
Macarani,291970,BA,Nordeste,BUTANTAN/SINOVAC,3075,1628,1447
Macarani,291970,BA,Nordeste,PFIZER/BIONTECH,350,350,0
Macatuba,352800,SP,Sudeste,FIOCRUZ/ASTRAZENECA,4426,4042,384
Macatuba,352800,SP,Sudeste,BUTANTAN/SINOVAC,3706,1867,1839
Macatuba,352800,SP,Sudeste,PFIZER/BIONTECH,277,277,0
Macau,240720,RN,Nordeste,BUTANTAN/SINOVAC,224,207,17
Macau,240720,RN,Nordeste,FIOCRUZ/ASTRAZENECA,11,11,0
Macaubal,352810,SP,Sudeste,BUTANTAN/SINOVAC,2005,1069,936
Macaubal,352810,SP,Sudeste,FIOCRUZ/ASTRAZENECA,1857,1690,167
Macaubal,352810,SP,Sudeste,PFIZER/BIONTECH,158,158,0
Macaúbas,291980,BA,Nordeste,BUTANTAN/SINOVAC,7217,4473,2744
Macaúbas,291980,BA,Nordeste,FIOCRUZ/ASTRAZENECA,4201,3965,236
Macaúbas,291980,BA,Nordeste,PFIZER/BIONTECH,96,95,1
Macedônia,352820,SP,Sudeste,FIOCRUZ/ASTRAZENECA,1505,1391,114
Macedônia,352820,SP,Sudeste,BUTANTAN/SINOVAC,1466,759,707
Macedônia,352820,SP,Sudeste,PFIZER/BIONTECH,97,97,0
Maceió,270430,AL,Nordeste,FIOCRUZ/ASTRAZENECA,197584,160345,37239
Maceió,270430,AL,Nordeste,BUTANTAN/SINOVAC,187353,95278,92075
Maceió,270430,AL,Nordeste,PFIZER/BIONTECH,69831,69636,195
Machacalis,313890,MG,Sudeste,BUTANTAN/SINOVAC,1736,925,811
Machacalis,313890,MG,Sudeste,FIOCRUZ/ASTRAZENECA,1003,886,117
Machacalis,313890,MG,Sudeste,PFIZER/BIONTECH,53,53,0
Machadinho,431170,RS,Sul,BUTANTAN/SINOVAC,1815,1050,765
Machadinho,431170,RS,Sul,FIOCRUZ/ASTRAZENECA,1409,1290,119
Machadinho,431170,RS,Sul,PFIZER/BIONTECH,72,72,0
Machadinho D'Oeste,110013,RO,Norte,FIOCRUZ/ASTRAZENECA,5126,4891,235
Machadinho D'Oeste,110013,RO,Norte,BUTANTAN/SINOVAC,4574,2389,2185
Machadinho D'Oeste,110013,RO,Norte,PFIZER/BIONTECH,581,581,0
Machado,313900,MG,Sudeste,BUTANTAN/SINOVAC,7509,3822,3687
Machado,313900,MG,Sudeste,FIOCRUZ/ASTRAZENECA,6375,5746,629
Machado,313900,MG,Sudeste,PFIZER/BIONTECH,967,967,0
Machados,260910,PE,Nordeste,BUTANTAN/SINOVAC,2440,1492,948
Machados,260910,PE,Nordeste,FIOCRUZ/ASTRAZENECA,2072,1909,163
Machados,260910,PE,Nordeste,PFIZER/BIONTECH,226,226,0
Macieira,421005,SC,Sul,FIOCRUZ/ASTRAZENECA,440,408,32
Macieira,421005,SC,Sul,BUTANTAN/SINOVAC,434,229,205
Macieira,421005,SC,Sul,PFIZER/BIONTECH,48,47,1
Macuco,330245,RJ,Sudeste,FIOCRUZ/ASTRAZENECA,2320,2089,231
Macuco,330245,RJ,Sudeste,BUTANTAN/SINOVAC,2290,1224,1066
Macururé,291990,BA,Nordeste,BUTANTAN/SINOVAC,1717,878,839
Macururé,291990,BA,Nordeste,FIOCRUZ/ASTRAZENECA,1699,1559,140
Macururé,291990,BA,Nordeste,PFIZER/BIONTECH,48,48,0
Madalena,230763,CE,Nordeste,BUTANTAN/SINOVAC,3910,1992,1918
Madalena,230763,CE,Nordeste,FIOCRUZ/ASTRAZENECA,1683,1366,317
Madeiro,220585,PI,Nordeste,FIOCRUZ/ASTRAZENECA,1310,1097,213
Madeiro,220585,PI,Nordeste,BUTANTAN/SINOVAC,1026,545,481
Madeiro,220585,PI,Nordeste,PFIZER/BIONTECH,82,82,0
Madre De Deus,291992,BA,Nordeste,FIOCRUZ/ASTRAZENECA,3577,3459,118
Madre De Deus,291992,BA,Nordeste,BUTANTAN/SINOVAC,3456,1851,1605
Madre De Deus,291992,BA,Nordeste,PFIZER/BIONTECH,774,773,1
Madre De Deus De Minas,313910,MG,Sudeste,FIOCRUZ/ASTRAZENECA,1487,1380,107
Madre De Deus De Minas,313910,MG,Sudeste,BUTANTAN/SINOVAC,1192,611,581
Madre De Deus De Minas,313910,MG,Sudeste,PFIZER/BIONTECH,70,70,0
Mãe D'Água,250870,PB,Nordeste,BUTANTAN/SINOVAC,984,493,491
Mãe D'Água,250870,PB,Nordeste,FIOCRUZ/ASTRAZENECA,699,633,66
Mãe D'Água,250870,PB,Nordeste,PFIZER/BIONTECH,33,33,0
Mãe Do Rio,150405,PA,Norte,FIOCRUZ/ASTRAZENECA,4799,4090,709
Mãe Do Rio,150405,PA,Norte,BUTANTAN/SINOVAC,3066,1582,1484
Maetinga,291995,BA,Nordeste,BUTANTAN/SINOVAC,1451,830,621
Maetinga,291995,BA,Nordeste,FIOCRUZ/ASTRAZENECA,1343,1232,111
Maetinga,291995,BA,Nordeste,PFIZER/BIONTECH,37,37,0
Mafra,421010,SC,Sul,FIOCRUZ/ASTRAZENECA,14013,12906,1107
Mafra,421010,SC,Sul,BUTANTAN/SINOVAC,11095,5971,5124
Mafra,421010,SC,Sul,PFIZER/BIONTECH,661,661,0
Magalhães Barata,150410,PA,Norte,FIOCRUZ/ASTRAZENECA,1702,1203,499
Magalhães Barata,150410,PA,Norte,BUTANTAN/SINOVAC,1329,688,641
Magalhães De Almeida,210630,MA,Nordeste,BUTANTAN/SINOVAC,2113,1233,880
Magalhães De Almeida,210630,MA,Nordeste,FIOCRUZ/ASTRAZENECA,2069,1920,149
Magda,352830,SP,Sudeste,BUTANTAN/SINOVAC,992,499,493
Magda,352830,SP,Sudeste,FIOCRUZ/ASTRAZENECA,784,712,72
Magda,352830,SP,Sudeste,PFIZER/BIONTECH,85,85,0
Magé,330250,RJ,Sudeste,BUTANTAN/SINOVAC,43425,23754,19671
Magé,330250,RJ,Sudeste,FIOCRUZ/ASTRAZENECA,29872,25793,4079
Magé,330250,RJ,Sudeste,PFIZER/BIONTECH,7999,7980,19
Maiquinique,292000,BA,Nordeste,BUTANTAN/SINOVAC,1231,732,499
Maiquinique,292000,BA,Nordeste,FIOCRUZ/ASTRAZENECA,356,281,75
Mairi,292010,BA,Nordeste,BUTANTAN/SINOVAC,4668,2505,2163
Mairi,292010,BA,Nordeste,FIOCRUZ/ASTRAZENECA,4385,3606,779
Mairi,292010,BA,Nordeste,PFIZER/BIONTECH,386,386,0
Mairinque,352840,SP,Sudeste,BUTANTAN/SINOVAC,9721,5293,4428
Mairinque,352840,SP,Sudeste,FIOCRUZ/ASTRAZENECA,8748,8096,652
Mairinque,352840,SP,Sudeste,PFIZER/BIONTECH,229,229,0
Mairiporã,352850,SP,Sudeste,FIOCRUZ/ASTRAZENECA,18153,17440,713
Mairiporã,352850,SP,Sudeste,BUTANTAN/SINOVAC,13858,7845,6013
Mairiporã,352850,SP,Sudeste,PFIZER/BIONTECH,712,712,0
Mairipotaba,521260,GO,Centro-Oeste,FIOCRUZ/ASTRAZENECA,1187,1129,58
Mairipotaba,521260,GO,Centro-Oeste,BUTANTAN/SINOVAC,755,382,373
Mairipotaba,521260,GO,Centro-Oeste,PFIZER/BIONTECH,12,12,0
Major Gercino,421020,SC,Sul,FIOCRUZ/ASTRAZENECA,1144,1005,139
Major Gercino,421020,SC,Sul,BUTANTAN/SINOVAC,643,364,279
Major Isidoro,270440,AL,Nordeste,FIOCRUZ/ASTRAZENECA,4357,4069,288
Major Isidoro,270440,AL,Nordeste,BUTANTAN/SINOVAC,3094,1628,1466
Major Sales,240725,RN,Nordeste,BUTANTAN/SINOVAC,2068,1115,953
Major Sales,240725,RN,Nordeste,FIOCRUZ/ASTRAZENECA,1360,1257,103
Major Sales,240725,RN,Nordeste,PFIZER/BIONTECH,137,137,0
Major Vieira,421030,SC,Sul,FIOCRUZ/ASTRAZENECA,1501,1360,141
Major Vieira,421030,SC,Sul,BUTANTAN/SINOVAC,1479,762,717
Major Vieira,421030,SC,Sul,PFIZER/BIONTECH,192,192,0
Malacacheta,313920,MG,Sudeste,BUTANTAN/SINOVAC,5355,2729,2626
Malacacheta,313920,MG,Sudeste,FIOCRUZ/ASTRAZENECA,2955,2682,273
Malacacheta,313920,MG,Sudeste,PFIZER/BIONTECH,24,24,0
Malhada,292020,BA,Nordeste,FIOCRUZ/ASTRAZENECA,2609,2525,84
Malhada,292020,BA,Nordeste,BUTANTAN/SINOVAC,637,431,206
Malhada De Pedras,292030,BA,Nordeste,BUTANTAN/SINOVAC,1961,985,976
Malhada De Pedras,292030,BA,Nordeste,FIOCRUZ/ASTRAZENECA,1830,1623,207
Malhada De Pedras,292030,BA,Nordeste,PFIZER/BIONTECH,93,92,1
Malhada Dos Bois,280380,SE,Nordeste,BUTANTAN/SINOVAC,632,361,271
Malhada Dos Bois,280380,SE,Nordeste,FIOCRUZ/ASTRAZENECA,439,412,27
Malhada Dos Bois,280380,SE,Nordeste,PFIZER/BIONTECH,68,68,0
Malhador,280390,SE,Nordeste,BUTANTAN/SINOVAC,2406,1248,1158
Malhador,280390,SE,Nordeste,FIOCRUZ/ASTRAZENECA,2122,2122,0
Malhador,280390,SE,Nordeste,PFIZER/BIONTECH,286,286,0
Mallet,411390,PR,Sul,BUTANTAN/SINOVAC,2671,1377,1294
Mallet,411390,PR,Sul,FIOCRUZ/ASTRAZENECA,2627,2431,196
Mallet,411390,PR,Sul,PFIZER/BIONTECH,30,30,0
Malta,250880,PB,Nordeste,BUTANTAN/SINOVAC,1402,723,679
Malta,250880,PB,Nordeste,FIOCRUZ/ASTRAZENECA,1168,1068,100
Malta,250880,PB,Nordeste,PFIZER/BIONTECH,165,165,0
Mamanguape,250890,PB,Nordeste,BUTANTAN/SINOVAC,6528,3879,2649
Mamanguape,250890,PB,Nordeste,FIOCRUZ/ASTRAZENECA,4042,3704,338
Mamanguape,250890,PB,Nordeste,PFIZER/BIONTECH,55,55,0
Mambaí,521270,GO,Centro-Oeste,FIOCRUZ/ASTRAZENECA,2165,1885,280
Mambaí,521270,GO,Centro-Oeste,BUTANTAN/SINOVAC,529,300,229
Mamborê,411400,PR,Sul,FIOCRUZ/ASTRAZENECA,4072,3863,209
Mamborê,411400,PR,Sul,BUTANTAN/SINOVAC,2882,1456,1426
Mamborê,411400,PR,Sul,PFIZER/BIONTECH,35,35,0
Mamonas,313925,MG,Sudeste,BUTANTAN/SINOVAC,1619,863,756
Mamonas,313925,MG,Sudeste,FIOCRUZ/ASTRAZENECA,1332,1232,100
Mamonas,313925,MG,Sudeste,PFIZER/BIONTECH,81,81,0
Mampituba,431173,RS,Sul,FIOCRUZ/ASTRAZENECA,901,809,92
Mampituba,431173,RS,Sul,BUTANTAN/SINOVAC,616,324,292
Mampituba,431173,RS,Sul,PFIZER/BIONTECH,98,98,0
Manacapuru,130250,AM,Norte,FIOCRUZ/ASTRAZENECA,26208,23096,3112
Manacapuru,130250,AM,Norte,BUTANTAN/SINOVAC,7962,4111,3851
Manaíra,250900,PB,Nordeste,BUTANTAN/SINOVAC,2732,1386,1346
Manaíra,250900,PB,Nordeste,FIOCRUZ/ASTRAZENECA,1737,1573,164
Manaíra,250900,PB,Nordeste,PFIZER/BIONTECH,51,51,0
Manaquiri,130255,AM,Norte,FIOCRUZ/ASTRAZENECA,5310,4459,851
Manaquiri,130255,AM,Norte,BUTANTAN/SINOVAC,3161,1702,1459
Manari,260915,PE,Nordeste,BUTANTAN/SINOVAC,2631,1407,1224
Manari,260915,PE,Nordeste,FIOCRUZ/ASTRAZENECA,2487,2312,175
Manari,260915,PE,Nordeste,PFIZER/BIONTECH,213,213,0
Manaus,130260,AM,Norte,FIOCRUZ/ASTRAZENECA,594982,479357,115625
Manaus,130260,AM,Norte,BUTANTAN/SINOVAC,400964,207994,192970
Manaus,130260,AM,Norte,PFIZER/BIONTECH,31104,31100,4
Mâncio Lima,120033,AC,Norte,FIOCRUZ/ASTRAZENECA,3805,3177,628
Mâncio Lima,120033,AC,Norte,BUTANTAN/SINOVAC,3251,1685,1566
Mandaguaçu,411410,PR,Sul,FIOCRUZ/ASTRAZENECA,4868,4677,191
Mandaguaçu,411410,PR,Sul,BUTANTAN/SINOVAC,4081,2050,2031
Mandaguari,411420,PR,Sul,BUTANTAN/SINOVAC,7293,3876,3417
Mandaguari,411420,PR,Sul,FIOCRUZ/ASTRAZENECA,6603,6141,462
Mandaguari,411420,PR,Sul,PFIZER/BIONTECH,679,679,0
Mandirituba,411430,PR,Sul,FIOCRUZ/ASTRAZENECA,5585,5398,187
Mandirituba,411430,PR,Sul,BUTANTAN/SINOVAC,3848,2009,1839
Mandirituba,411430,PR,Sul,PFIZER/BIONTECH,280,280,0
Manduri,352860,SP,Sudeste,BUTANTAN/SINOVAC,2296,1119,1177
Manduri,352860,SP,Sudeste,FIOCRUZ/ASTRAZENECA,1886,1750,136
Manduri,352860,SP,Sudeste,PFIZER/BIONTECH,254,254,0
Manfrinópolis,411435,PR,Sul,FIOCRUZ/ASTRAZENECA,859,821,38
Manfrinópolis,411435,PR,Sul,BUTANTAN/SINOVAC,616,321,295
Manga,313930,MG,Sudeste,FIOCRUZ/ASTRAZENECA,5033,4073,960
Manga,313930,MG,Sudeste,BUTANTAN/SINOVAC,3730,1967,1763
Manga,313930,MG,Sudeste,PFIZER/BIONTECH,30,30,0
Mangaratiba,330260,RJ,Sudeste,BUTANTAN/SINOVAC,10320,5373,4947
Mangaratiba,330260,RJ,Sudeste,FIOCRUZ/ASTRAZENECA,8680,7873,807
Mangaratiba,330260,RJ,Sudeste,PFIZER/BIONTECH,98,98,0
Mangueirinha,411440,PR,Sul,BUTANTAN/SINOVAC,3997,2081,1916
Mangueirinha,411440,PR,Sul,FIOCRUZ/ASTRAZENECA,3409,3230,179
Mangueirinha,411440,PR,Sul,PFIZER/BIONTECH,169,169,0
Manhuaçu,313940,MG,Sudeste,FIOCRUZ/ASTRAZENECA,14588,13249,1339
Manhuaçu,313940,MG,Sudeste,BUTANTAN/SINOVAC,14527,7687,6840
Manhuaçu,313940,MG,Sudeste,PFIZER/BIONTECH,1480,1479,1
Manhumirim,313950,MG,Sudeste,BUTANTAN/SINOVAC,4612,2364,2248
Manhumirim,313950,MG,Sudeste,FIOCRUZ/ASTRAZENECA,3014,2774,240
Manhumirim,313950,MG,Sudeste,PFIZER/BIONTECH,1,1,0
Manicoré,130270,AM,Norte,FIOCRUZ/ASTRAZENECA,12623,11641,982
Manicoré,130270,AM,Norte,BUTANTAN/SINOVAC,3642,1983,1659
Manoel Emídio,220590,PI,Nordeste,FIOCRUZ/ASTRAZENECA,1023,952,71
Manoel Emídio,220590,PI,Nordeste,BUTANTAN/SINOVAC,898,493,405
Manoel Ribas,411450,PR,Sul,BUTANTAN/SINOVAC,4541,2429,2112
Manoel Ribas,411450,PR,Sul,FIOCRUZ/ASTRAZENECA,3013,2801,212
Manoel Ribas,411450,PR,Sul,PFIZER/BIONTECH,174,173,1
Manoel Urbano,120034,AC,Norte,FIOCRUZ/ASTRAZENECA,2103,1837,266
Manoel Urbano,120034,AC,Norte,BUTANTAN/SINOVAC,1469,822,647
Manoel Urbano,120034,AC,Norte,PFIZER/BIONTECH,28,28,0
Manoel Viana,431175,RS,Sul,BUTANTAN/SINOVAC,2210,1115,1095
Manoel Viana,431175,RS,Sul,FIOCRUZ/ASTRAZENECA,2008,1766,242
Manoel Viana,431175,RS,Sul,PFIZER/BIONTECH,266,266,0
Manoel Vitorino,292040,BA,Nordeste,FIOCRUZ/ASTRAZENECA,3195,2799,396
Manoel Vitorino,292040,BA,Nordeste,BUTANTAN/SINOVAC,3082,1561,1521
Manoel Vitorino,292040,BA,Nordeste,PFIZER/BIONTECH,119,119,0
Mansidão,292045,BA,Nordeste,BUTANTAN/SINOVAC,2008,1039,969
Mansidão,292045,BA,Nordeste,FIOCRUZ/ASTRAZENECA,1978,1880,98
Mansidão,292045,BA,Nordeste,PFIZER/BIONTECH,70,70,0
Mantena,313960,MG,Sudeste,BUTANTAN/SINOVAC,5101,3093,2008
Mantena,313960,MG,Sudeste,FIOCRUZ/ASTRAZENECA,3927,3699,228
Mantena,313960,MG,Sudeste,PFIZER/BIONTECH,86,86,0
Mantenópolis,320330,ES,Sudeste,BUTANTAN/SINOVAC,4351,2407,1944
Mantenópolis,320330,ES,Sudeste,FIOCRUZ/ASTRAZENECA,3025,2858,167
Mantenópolis,320330,ES,Sudeste,PFIZER/BIONTECH,504,501,3
Maquiné,431177,RS,Sul,BUTANTAN/SINOVAC,2135,1101,1034
Maquiné,431177,RS,Sul,FIOCRUZ/ASTRAZENECA,2100,1934,166
Maquiné,431177,RS,Sul,PFIZER/BIONTECH,269,269,0
Mar De Espanha,313980,MG,Sudeste,BUTANTAN/SINOVAC,2717,1396,1321
Mar De Espanha,313980,MG,Sudeste,FIOCRUZ/ASTRAZENECA,2317,2116,201
Mar De Espanha,313980,MG,Sudeste,PFIZER/BIONTECH,140,140,0
Mar Vermelho,270490,AL,Nordeste,BUTANTAN/SINOVAC,816,411,405
Mar Vermelho,270490,AL,Nordeste,FIOCRUZ/ASTRAZENECA,786,658,128
Mar Vermelho,270490,AL,Nordeste,PFIZER/BIONTECH,41,41,0
Mara Rosa,521280,GO,Centro-Oeste,FIOCRUZ/ASTRAZENECA,3018,2896,122
Mara Rosa,521280,GO,Centro-Oeste,BUTANTAN/SINOVAC,1658,936,722
Maraã,130280,AM,Norte,BUTANTAN/SINOVAC,1738,964,774
Maraã,130280,AM,Norte,FIOCRUZ/ASTRAZENECA,1173,891,282
Marabá,150420,PA,Norte,FIOCRUZ/ASTRAZENECA,34428,31127,3301
Marabá,150420,PA,Norte,BUTANTAN/SINOVAC,16366,9301,7065
Marabá,150420,PA,Norte,PFIZER/BIONTECH,5339,5328,11
Marabá Paulista,352870,SP,Sudeste,BUTANTAN/SINOVAC,1109,645,464
Marabá Paulista,352870,SP,Sudeste,FIOCRUZ/ASTRAZENECA,1107,1036,71
Marabá Paulista,352870,SP,Sudeste,PFIZER/BIONTECH,152,152,0
Maracaçumé,210632,MA,Nordeste,FIOCRUZ/ASTRAZENECA,3343,3146,197
Maracaçumé,210632,MA,Nordeste,BUTANTAN/SINOVAC,2482,1308,1174
Maracaí,352880,SP,Sudeste,FIOCRUZ/ASTRAZENECA,3610,3352,258
Maracaí,352880,SP,Sudeste,BUTANTAN/SINOVAC,2872,1645,1227
Maracaí,352880,SP,Sudeste,PFIZER/BIONTECH,408,408,0
Maracajá,421040,SC,Sul,FIOCRUZ/ASTRAZENECA,1865,1749,116
Maracajá,421040,SC,Sul,BUTANTAN/SINOVAC,1436,758,678
Maracajá,421040,SC,Sul,PFIZER/BIONTECH,175,175,0
Maracaju,500540,MS,Centro-Oeste,FIOCRUZ/ASTRAZENECA,8793,7852,941
Maracaju,500540,MS,Centro-Oeste,BUTANTAN/SINOVAC,7328,3913,3415
Maracaju,500540,MS,Centro-Oeste,PFIZER/BIONTECH,1586,1582,4
Maracanã,150430,PA,Norte,BUTANTAN/SINOVAC,3228,2007,1221
Maracanã,150430,PA,Norte,FIOCRUZ/ASTRAZENECA,1813,1448,365
Maracanaú,230765,CE,Nordeste,BUTANTAN/SINOVAC,32366,17333,15033
Maracanaú,230765,CE,Nordeste,FIOCRUZ/ASTRAZENECA,28269,27556,713
Maracanaú,230765,CE,Nordeste,PFIZER/BIONTECH,2177,2175,2
Maracás,292050,BA,Nordeste,BUTANTAN/SINOVAC,5004,2632,2372
Maracás,292050,BA,Nordeste,FIOCRUZ/ASTRAZENECA,4850,4453,397
Maracás,292050,BA,Nordeste,PFIZER/BIONTECH,160,160,0
Maragogi,270450,AL,Nordeste,BUTANTAN/SINOVAC,4368,2272,2096
Maragogi,270450,AL,Nordeste,FIOCRUZ/ASTRAZENECA,4244,3966,278
Maragogi,270450,AL,Nordeste,PFIZER/BIONTECH,180,180,0
Maragogipe,292060,BA,Nordeste,FIOCRUZ/ASTRAZENECA,6993,6012,981
Maragogipe,292060,BA,Nordeste,BUTANTAN/SINOVAC,5349,3217,2132
Maragogipe,292060,BA,Nordeste,PFIZER/BIONTECH,371,371,0
Maraial,260920,PE,Nordeste,FIOCRUZ/ASTRAZENECA,1698,1575,123
Maraial,260920,PE,Nordeste,BUTANTAN/SINOVAC,1694,886,808
Maraial,260920,PE,Nordeste,PFIZER/BIONTECH,179,177,2
Marajá Do Sena,210635,MA,Nordeste,FIOCRUZ/ASTRAZENECA,883,831,52
Marajá Do Sena,210635,MA,Nordeste,BUTANTAN/SINOVAC,482,259,223
Maranguape,230770,CE,Nordeste,BUTANTAN/SINOVAC,5777,4473,1304
Maranguape,230770,CE,Nordeste,FIOCRUZ/ASTRAZENECA,1609,1607,2
Maranhãozinho,210637,MA,Nordeste,FIOCRUZ/ASTRAZENECA,1867,1775,92
Maranhãozinho,210637,MA,Nordeste,BUTANTAN/SINOVAC,1327,695,632
Marapanim,150440,PA,Norte,FIOCRUZ/ASTRAZENECA,4960,3606,1354
Marapanim,150440,PA,Norte,BUTANTAN/SINOVAC,4293,2345,1948
Marapoama,352885,SP,Sudeste,FIOCRUZ/ASTRAZENECA,985,865,120
Marapoama,352885,SP,Sudeste,BUTANTAN/SINOVAC,952,529,423
Marapoama,352885,SP,Sudeste,PFIZER/BIONTECH,69,69,0
Maratá,431179,RS,Sul,BUTANTAN/SINOVAC,1944,1111,833
Maratá,431179,RS,Sul,FIOCRUZ/ASTRAZENECA,1069,938,131
Maratá,431179,RS,Sul,PFIZER/BIONTECH,119,119,0
Marataízes,320332,ES,Sudeste,BUTANTAN/SINOVAC,10100,5416,4684
Marataízes,320332,ES,Sudeste,FIOCRUZ/ASTRAZENECA,8999,8704,295
Marataízes,320332,ES,Sudeste,PFIZER/BIONTECH,1138,1138,0
Marau,431180,RS,Sul,FIOCRUZ/ASTRAZENECA,10695,10101,594
Marau,431180,RS,Sul,BUTANTAN/SINOVAC,7027,3924,3103
Marau,431180,RS,Sul,PFIZER/BIONTECH,1025,1025,0
Maraú,292070,BA,Nordeste,FIOCRUZ/ASTRAZENECA,5333,5223,110
Maraú,292070,BA,Nordeste,BUTANTAN/SINOVAC,2380,1237,1143
Maraú,292070,BA,Nordeste,PFIZER/BIONTECH,24,24,0
Maravilha,270460,AL,Nordeste,FIOCRUZ/ASTRAZENECA,2062,1966,96
Maravilha,270460,AL,Nordeste,BUTANTAN/SINOVAC,1654,842,812
Maravilha,421050,SC,Sul,FIOCRUZ/ASTRAZENECA,6804,6226,578
Maravilha,421050,SC,Sul,BUTANTAN/SINOVAC,5721,3075,2646
Maravilha,421050,SC,Sul,PFIZER/BIONTECH,654,654,0
Maravilhas,313970,MG,Sudeste,FIOCRUZ/ASTRAZENECA,1442,1337,105
Maravilhas,313970,MG,Sudeste,BUTANTAN/SINOVAC,1238,626,612
Maravilhas,313970,MG,Sudeste,PFIZER/BIONTECH,49,49,0
Marcação,250905,PB,Nordeste,BUTANTAN/SINOVAC,8174,4439,3735
Marcação,250905,PB,Nordeste,FIOCRUZ/ASTRAZENECA,1180,1101,79
Marcação,250905,PB,Nordeste,PFIZER/BIONTECH,12,12,0
Marcelândia,510558,MT,Centro-Oeste,FIOCRUZ/ASTRAZENECA,2925,2135,790
Marcelândia,510558,MT,Centro-Oeste,BUTANTAN/SINOVAC,1827,948,879
Marcelino Ramos,431190,RS,Sul,BUTANTAN/SINOVAC,1530,767,763
Marcelino Ramos,431190,RS,Sul,FIOCRUZ/ASTRAZENECA,1405,1243,162
Marcelino Ramos,431190,RS,Sul,PFIZER/BIONTECH,176,176,0
Marcelino Vieira,240730,RN,Nordeste,BUTANTAN/SINOVAC,1851,960,891
Marcelino Vieira,240730,RN,Nordeste,FIOCRUZ/ASTRAZENECA,1687,1586,101
Marcelino Vieira,240730,RN,Nordeste,PFIZER/BIONTECH,248,248,0
Marcionílio Souza,292080,BA,Nordeste,BUTANTAN/SINOVAC,1835,959,876
Marcionílio Souza,292080,BA,Nordeste,FIOCRUZ/ASTRAZENECA,1627,1527,100
Marcionílio Souza,292080,BA,Nordeste,PFIZER/BIONTECH,4,4,0
Marco,230780,CE,Nordeste,BUTANTAN/SINOVAC,3120,1677,1443
Marco,230780,CE,Nordeste,FIOCRUZ/ASTRAZENECA,1568,1338,230
Marcolândia,220595,PI,Nordeste,BUTANTAN/SINOVAC,1190,628,562
Marcolândia,220595,PI,Nordeste,FIOCRUZ/ASTRAZENECA,976,960,16
Marcos Parente,220600,PI,Nordeste,BUTANTAN/SINOVAC,899,467,432
Marcos Parente,220600,PI,Nordeste,FIOCRUZ/ASTRAZENECA,776,705,71
Marcos Parente,220600,PI,Nordeste,PFIZER/BIONTECH,31,31,0
Marechal Cândido Rondon,411460,PR,Sul,BUTANTAN/SINOVAC,11112,5600,5512
Marechal Cândido Rondon,411460,PR,Sul,FIOCRUZ/ASTRAZENECA,10490,9695,795
Marechal Cândido Rondon,411460,PR,Sul,PFIZER/BIONTECH,2558,2558,0
Marechal Deodoro,270470,AL,Nordeste,FIOCRUZ/ASTRAZENECA,10380,9848,532
Marechal Deodoro,270470,AL,Nordeste,BUTANTAN/SINOVAC,7877,4151,3726
Marechal Deodoro,270470,AL,Nordeste,PFIZER/BIONTECH,3478,3475,3
Marechal Floriano,320334,ES,Sudeste,BUTANTAN/SINOVAC,4458,2449,2009
Marechal Floriano,320334,ES,Sudeste,FIOCRUZ/ASTRAZENECA,3630,3492,138
Marechal Floriano,320334,ES,Sudeste,PFIZER/BIONTECH,469,469,0
Marechal Thaumaturgo,120035,AC,Norte,BUTANTAN/SINOVAC,5812,3533,2279
Marechal Thaumaturgo,120035,AC,Norte,FIOCRUZ/ASTRAZENECA,1139,979,160
Marema,421055,SC,Sul,FIOCRUZ/ASTRAZENECA,661,625,36
Marema,421055,SC,Sul,BUTANTAN/SINOVAC,596,331,265
Marema,421055,SC,Sul,PFIZER/BIONTECH,65,65,0
Mari,250910,PB,Nordeste,BUTANTAN/SINOVAC,4953,2485,2468
Mari,250910,PB,Nordeste,FIOCRUZ/ASTRAZENECA,3515,3164,351
Mari,250910,PB,Nordeste,PFIZER/BIONTECH,370,370,0
Maria Da Fé,313990,MG,Sudeste,FIOCRUZ/ASTRAZENECA,3084,2888,196
Maria Da Fé,313990,MG,Sudeste,BUTANTAN/SINOVAC,3077,1563,1514
Maria Da Fé,313990,MG,Sudeste,PFIZER/BIONTECH,105,105,0
Maria Helena,411470,PR,Sul,FIOCRUZ/ASTRAZENECA,1559,1449,110
Maria Helena,411470,PR,Sul,BUTANTAN/SINOVAC,1277,652,625
Marialva,411480,PR,Sul,FIOCRUZ/ASTRAZENECA,8662,8273,389
Marialva,411480,PR,Sul,BUTANTAN/SINOVAC,7390,3819,3571
Marialva,411480,PR,Sul,PFIZER/BIONTECH,364,364,0
Mariana,314000,MG,Sudeste,FIOCRUZ/ASTRAZENECA,12439,11301,1138
Mariana,314000,MG,Sudeste,BUTANTAN/SINOVAC,9859,5139,4720
Mariana,314000,MG,Sudeste,PFIZER/BIONTECH,1942,1941,1
Mariana Pimentel,431198,RS,Sul,BUTANTAN/SINOVAC,1519,789,730
Mariana Pimentel,431198,RS,Sul,FIOCRUZ/ASTRAZENECA,874,780,94
Mariana Pimentel,431198,RS,Sul,PFIZER/BIONTECH,67,67,0
Mariano Moro,431200,RS,Sul,BUTANTAN/SINOVAC,767,390,377
Mariano Moro,431200,RS,Sul,FIOCRUZ/ASTRAZENECA,689,632,57
Mariano Moro,431200,RS,Sul,PFIZER/BIONTECH,96,96,0
Marianópolis Do Tocantins,171250,TO,Norte,BUTANTAN/SINOVAC,681,361,320
Marianópolis Do Tocantins,171250,TO,Norte,FIOCRUZ/ASTRAZENECA,496,460,36
Mariápolis,352890,SP,Sudeste,FIOCRUZ/ASTRAZENECA,1090,977,113
Mariápolis,352890,SP,Sudeste,BUTANTAN/SINOVAC,946,477,469
Mariápolis,352890,SP,Sudeste,PFIZER/BIONTECH,108,108,0
Maribondo,270480,AL,Nordeste,FIOCRUZ/ASTRAZENECA,3240,3005,235
Maribondo,270480,AL,Nordeste,BUTANTAN/SINOVAC,2257,1177,1080
Maricá,330270,RJ,Sudeste,BUTANTAN/SINOVAC,28054,20417,7637
Maricá,330270,RJ,Sudeste,FIOCRUZ/ASTRAZENECA,3593,3574,19
Marilac,314010,MG,Sudeste,BUTANTAN/SINOVAC,906,455,451
Marilac,314010,MG,Sudeste,FIOCRUZ/ASTRAZENECA,765,671,94
Marilac,314010,MG,Sudeste,PFIZER/BIONTECH,57,57,0
Marilândia,320335,ES,Sudeste,BUTANTAN/SINOVAC,3735,1864,1871
Marilândia,320335,ES,Sudeste,FIOCRUZ/ASTRAZENECA,2860,2710,150
Marilândia,320335,ES,Sudeste,PFIZER/BIONTECH,392,392,0
Marilândia Do Sul,411490,PR,Sul,FIOCRUZ/ASTRAZENECA,2608,2478,130
Marilândia Do Sul,411490,PR,Sul,BUTANTAN/SINOVAC,1796,987,809
Marilena,411500,PR,Sul,FIOCRUZ/ASTRAZENECA,2057,1929,128
Marilena,411500,PR,Sul,BUTANTAN/SINOVAC,1813,960,853
Marilena,411500,PR,Sul,PFIZER/BIONTECH,30,30,0
Marília,352900,SP,Sudeste,FIOCRUZ/ASTRAZENECA,69134,62987,6147
Marília,352900,SP,Sudeste,BUTANTAN/SINOVAC,58956,31854,27102
Marília,352900,SP,Sudeste,PFIZER/BIONTECH,5758,5751,7
Mariluz,411510,PR,Sul,BUTANTAN/SINOVAC,1861,1034,827
Mariluz,411510,PR,Sul,FIOCRUZ/ASTRAZENECA,1723,1643,80
Maringá,411520,PR,Sul,BUTANTAN/SINOVAC,139269,72758,66511
Maringá,411520,PR,Sul,FIOCRUZ/ASTRAZENECA,133820,124817,9003
Maringá,411520,PR,Sul,PFIZER/BIONTECH,26019,26017,2
Marinópolis,352910,SP,Sudeste,BUTANTAN/SINOVAC,1117,599,518
Marinópolis,352910,SP,Sudeste,FIOCRUZ/ASTRAZENECA,908,810,98
Marinópolis,352910,SP,Sudeste,PFIZER/BIONTECH,74,74,0
Mário Campos,314015,MG,Sudeste,BUTANTAN/SINOVAC,1345,949,396
Mário Campos,314015,MG,Sudeste,FIOCRUZ/ASTRAZENECA,1182,1174,8
Mariópolis,411530,PR,Sul,BUTANTAN/SINOVAC,1775,902,873
Mariópolis,411530,PR,Sul,FIOCRUZ/ASTRAZENECA,1225,1144,81
Maripá,411535,PR,Sul,BUTANTAN/SINOVAC,1501,773,728
Maripá,411535,PR,Sul,FIOCRUZ/ASTRAZENECA,1360,1265,95
Maripá,411535,PR,Sul,PFIZER/BIONTECH,18,18,0
Maripá De Minas,314020,MG,Sudeste,FIOCRUZ/ASTRAZENECA,349,346,3
Maripá De Minas,314020,MG,Sudeste,BUTANTAN/SINOVAC,289,210,79
Maripá De Minas,314020,MG,Sudeste,PFIZER/BIONTECH,30,30,0
Marituba,150442,PA,Norte,BUTANTAN/SINOVAC,16034,8375,7659
Marituba,150442,PA,Norte,FIOCRUZ/ASTRAZENECA,10189,10074,115
Marituba,150442,PA,Norte,PFIZER/BIONTECH,1484,1484,0
Marizópolis,250915,PB,Nordeste,BUTANTAN/SINOVAC,1771,1191,580
Marizópolis,250915,PB,Nordeste,FIOCRUZ/ASTRAZENECA,1241,1127,114
Marizópolis,250915,PB,Nordeste,PFIZER/BIONTECH,30,29,1
Marliéria,314030,MG,Sudeste,FIOCRUZ/ASTRAZENECA,1154,990,164
Marliéria,314030,MG,Sudeste,BUTANTAN/SINOVAC,991,500,491
Marliéria,314030,MG,Sudeste,PFIZER/BIONTECH,119,119,0
Marmeleiro,411540,PR,Sul,FIOCRUZ/ASTRAZENECA,3578,3332,246
Marmeleiro,411540,PR,Sul,BUTANTAN/SINOVAC,3166,1620,1546
Marmeleiro,411540,PR,Sul,PFIZER/BIONTECH,120,120,0
Marmelópolis,314040,MG,Sudeste,BUTANTAN/SINOVAC,728,380,348
Marmelópolis,314040,MG,Sudeste,FIOCRUZ/ASTRAZENECA,639,592,47
Marmelópolis,314040,MG,Sudeste,PFIZER/BIONTECH,94,94,0
Marques De Souza,431205,RS,Sul,BUTANTAN/SINOVAC,1527,800,727
Marques De Souza,431205,RS,Sul,FIOCRUZ/ASTRAZENECA,1145,986,159
Marques De Souza,431205,RS,Sul,PFIZER/BIONTECH,110,110,0
Marquinho,411545,PR,Sul,FIOCRUZ/ASTRAZENECA,962,899,63
Marquinho,411545,PR,Sul,BUTANTAN/SINOVAC,782,409,373
Martinho Campos,314050,MG,Sudeste,BUTANTAN/SINOVAC,2983,1523,1460
Martinho Campos,314050,MG,Sudeste,FIOCRUZ/ASTRAZENECA,2779,2534,245
Martinho Campos,314050,MG,Sudeste,PFIZER/BIONTECH,219,219,0
Martinópole,230790,CE,Nordeste,BUTANTAN/SINOVAC,2131,1167,964
Martinópole,230790,CE,Nordeste,FIOCRUZ/ASTRAZENECA,953,774,179
Martinópole,230790,CE,Nordeste,PFIZER/BIONTECH,12,12,0
Martinópolis,352920,SP,Sudeste,FIOCRUZ/ASTRAZENECA,6313,5782,531
Martinópolis,352920,SP,Sudeste,BUTANTAN/SINOVAC,5951,3417,2534
Martinópolis,352920,SP,Sudeste,PFIZER/BIONTECH,457,457,0
Martins,240740,RN,Nordeste,BUTANTAN/SINOVAC,2265,1041,1224
Martins,240740,RN,Nordeste,FIOCRUZ/ASTRAZENECA,2048,1917,131
Martins,240740,RN,Nordeste,PFIZER/BIONTECH,301,301,0
Martins Soares,314053,MG,Sudeste,FIOCRUZ/ASTRAZENECA,1460,1368,92
Martins Soares,314053,MG,Sudeste,BUTANTAN/SINOVAC,1350,707,643
Martins Soares,314053,MG,Sudeste,PFIZER/BIONTECH,130,130,0
Maruim,280400,SE,Nordeste,BUTANTAN/SINOVAC,2761,1425,1336
Maruim,280400,SE,Nordeste,FIOCRUZ/ASTRAZENECA,2145,2144,1
Maruim,280400,SE,Nordeste,PFIZER/BIONTECH,277,277,0
Marumbi,411550,PR,Sul,FIOCRUZ/ASTRAZENECA,1533,1454,79
Marumbi,411550,PR,Sul,BUTANTAN/SINOVAC,1063,535,528
Marzagão,521290,GO,Centro-Oeste,FIOCRUZ/ASTRAZENECA,752,701,51
Marzagão,521290,GO,Centro-Oeste,BUTANTAN/SINOVAC,418,222,196
Marzagão,521290,GO,Centro-Oeste,PFIZER/BIONTECH,9,9,0
Mascote,292090,BA,Nordeste,BUTANTAN/SINOVAC,2696,1466,1230
Mascote,292090,BA,Nordeste,FIOCRUZ/ASTRAZENECA,1535,1421,114
Mascote,292090,BA,Nordeste,PFIZER/BIONTECH,13,13,0
Massapê,230800,CE,Nordeste,BUTANTAN/SINOVAC,5729,2924,2805
Massapê,230800,CE,Nordeste,FIOCRUZ/ASTRAZENECA,3653,3153,500
Massapê Do Piauí,220605,PI,Nordeste,BUTANTAN/SINOVAC,1351,757,594
Massapê Do Piauí,220605,PI,Nordeste,FIOCRUZ/ASTRAZENECA,991,876,115
Massaranduba,250920,PB,Nordeste,BUTANTAN/SINOVAC,2924,1476,1448
Massaranduba,250920,PB,Nordeste,FIOCRUZ/ASTRAZENECA,2004,1779,225
Massaranduba,250920,PB,Nordeste,PFIZER/BIONTECH,118,118,0
Massaranduba,421060,SC,Sul,FIOCRUZ/ASTRAZENECA,4026,3729,297
Massaranduba,421060,SC,Sul,BUTANTAN/SINOVAC,3612,1886,1726
Massaranduba,421060,SC,Sul,PFIZER/BIONTECH,265,265,0
Mata,431210,RS,Sul,BUTANTAN/SINOVAC,1550,806,744
Mata,431210,RS,Sul,FIOCRUZ/ASTRAZENECA,1380,1144,236
Mata,431210,RS,Sul,PFIZER/BIONTECH,127,127,0
Mata De São João,292100,BA,Nordeste,FIOCRUZ/ASTRAZENECA,8409,7384,1025
Mata De São João,292100,BA,Nordeste,BUTANTAN/SINOVAC,6566,3433,3133
Mata De São João,292100,BA,Nordeste,PFIZER/BIONTECH,2291,2290,1
Mata Grande,270500,AL,Nordeste,FIOCRUZ/ASTRAZENECA,3875,3326,549
Mata Grande,270500,AL,Nordeste,BUTANTAN/SINOVAC,3774,1918,1856
Mata Roma,210640,MA,Nordeste,FIOCRUZ/ASTRAZENECA,3580,2643,937
Mata Roma,210640,MA,Nordeste,BUTANTAN/SINOVAC,2060,1067,993
Mata Verde,314055,MG,Sudeste,BUTANTAN/SINOVAC,1798,953,845
Mata Verde,314055,MG,Sudeste,FIOCRUZ/ASTRAZENECA,1671,1475,196
Mata Verde,314055,MG,Sudeste,PFIZER/BIONTECH,40,40,0
Matão,352930,SP,Sudeste,FIOCRUZ/ASTRAZENECA,21419,19992,1427
Matão,352930,SP,Sudeste,BUTANTAN/SINOVAC,18280,9319,8961
Matão,352930,SP,Sudeste,PFIZER/BIONTECH,1254,1254,0
Mataraca,250930,PB,Nordeste,BUTANTAN/SINOVAC,1098,574,524
Mataraca,250930,PB,Nordeste,FIOCRUZ/ASTRAZENECA,691,661,30
Mateiros,171270,TO,Norte,FIOCRUZ/ASTRAZENECA,764,709,55
Mateiros,171270,TO,Norte,BUTANTAN/SINOVAC,280,175,105
Matelândia,411560,PR,Sul,FIOCRUZ/ASTRAZENECA,3583,3329,254
Matelândia,411560,PR,Sul,BUTANTAN/SINOVAC,3460,1836,1624
Matelândia,411560,PR,Sul,PFIZER/BIONTECH,94,94,0
Materlândia,314060,MG,Sudeste,FIOCRUZ/ASTRAZENECA,1776,1678,98
Materlândia,314060,MG,Sudeste,BUTANTAN/SINOVAC,1165,598,567
Materlândia,314060,MG,Sudeste,PFIZER/BIONTECH,39,39,0
Mateus Leme,314070,MG,Sudeste,FIOCRUZ/ASTRAZENECA,6097,5579,518
Mateus Leme,314070,MG,Sudeste,BUTANTAN/SINOVAC,6060,3095,2965
Mateus Leme,314070,MG,Sudeste,PFIZER/BIONTECH,674,674,0
Mathias Lobato,317150,MG,Sudeste,FIOCRUZ/ASTRAZENECA,751,702,49
Mathias Lobato,317150,MG,Sudeste,BUTANTAN/SINOVAC,647,335,312
Mathias Lobato,317150,MG,Sudeste,PFIZER/BIONTECH,48,48,0
Matias Barbosa,314080,MG,Sudeste,BUTANTAN/SINOVAC,2188,1105,1083
Matias Barbosa,314080,MG,Sudeste,FIOCRUZ/ASTRAZENECA,1180,1103,77
Matias Barbosa,314080,MG,Sudeste,PFIZER/BIONTECH,18,18,0
Matias Cardoso,314085,MG,Sudeste,FIOCRUZ/ASTRAZENECA,2271,2204,67
Matias Cardoso,314085,MG,Sudeste,BUTANTAN/SINOVAC,1225,702,523
Matias Olímpio,220610,PI,Nordeste,BUTANTAN/SINOVAC,1552,887,665
Matias Olímpio,220610,PI,Nordeste,FIOCRUZ/ASTRAZENECA,1527,1428,99
Matias Olímpio,220610,PI,Nordeste,PFIZER/BIONTECH,113,113,0
Matina,292105,BA,Nordeste,FIOCRUZ/ASTRAZENECA,2366,2157,209
Matina,292105,BA,Nordeste,BUTANTAN/SINOVAC,2245,1175,1070
Matina,292105,BA,Nordeste,PFIZER/BIONTECH,43,43,0
Matinha,210650,MA,Nordeste,FIOCRUZ/ASTRAZENECA,6343,5886,457
Matinha,210650,MA,Nordeste,BUTANTAN/SINOVAC,3154,1691,1463
Matinhas,250933,PB,Nordeste,BUTANTAN/SINOVAC,951,513,438
Matinhas,250933,PB,Nordeste,FIOCRUZ/ASTRAZENECA,574,521,53
Matinhas,250933,PB,Nordeste,PFIZER/BIONTECH,5,5,0
Matinhos,411570,PR,Sul,FIOCRUZ/ASTRAZENECA,9338,9134,204
Matinhos,411570,PR,Sul,BUTANTAN/SINOVAC,7950,4256,3694
Matipó,314090,MG,Sudeste,BUTANTAN/SINOVAC,2085,1142,943
Matipó,314090,MG,Sudeste,FIOCRUZ/ASTRAZENECA,1997,1842,155
Mato Castelhano,431213,RS,Sul,BUTANTAN/SINOVAC,772,392,380
Mato Castelhano,431213,RS,Sul,FIOCRUZ/ASTRAZENECA,561,520,41
Mato Castelhano,431213,RS,Sul,PFIZER/BIONTECH,126,122,4
Mato Grosso,250937,PB,Nordeste,BUTANTAN/SINOVAC,627,318,309
Mato Grosso,250937,PB,Nordeste,FIOCRUZ/ASTRAZENECA,590,537,53
Mato Grosso,250937,PB,Nordeste,PFIZER/BIONTECH,48,48,0
Mato Leitão,431215,RS,Sul,FIOCRUZ/ASTRAZENECA,1291,1138,153
Mato Leitão,431215,RS,Sul,BUTANTAN/SINOVAC,1168,584,584
Mato Leitão,431215,RS,Sul,PFIZER/BIONTECH,192,192,0
Mato Queimado,431217,RS,Sul,BUTANTAN/SINOVAC,665,337,328
Mato Queimado,431217,RS,Sul,FIOCRUZ/ASTRAZENECA,468,385,83
Mato Queimado,431217,RS,Sul,PFIZER/BIONTECH,36,36,0
Mato Rico,411573,PR,Sul,FIOCRUZ/ASTRAZENECA,967,909,58
Mato Rico,411573,PR,Sul,BUTANTAN/SINOVAC,726,374,352
Mato Verde,314100,MG,Sudeste,BUTANTAN/SINOVAC,2892,1729,1163
Mato Verde,314100,MG,Sudeste,FIOCRUZ/ASTRAZENECA,2878,2730,148
Mato Verde,314100,MG,Sudeste,PFIZER/BIONTECH,52,52,0
Matões,210660,MA,Nordeste,FIOCRUZ/ASTRAZENECA,7984,7305,679
Matões,210660,MA,Nordeste,BUTANTAN/SINOVAC,4278,2263,2015
Matões Do Norte,210663,MA,Nordeste,FIOCRUZ/ASTRAZENECA,2822,2764,58
Matões Do Norte,210663,MA,Nordeste,BUTANTAN/SINOVAC,1330,746,584
Matos Costa,421070,SC,Sul,FIOCRUZ/ASTRAZENECA,535,474,61
Matos Costa,421070,SC,Sul,BUTANTAN/SINOVAC,529,300,229
Matos Costa,421070,SC,Sul,PFIZER/BIONTECH,18,18,0
Matozinhos,314110,MG,Sudeste,FIOCRUZ/ASTRAZENECA,6326,5829,497
Matozinhos,314110,MG,Sudeste,BUTANTAN/SINOVAC,5412,2848,2564
Matozinhos,314110,MG,Sudeste,PFIZER/BIONTECH,979,979,0
Matrinchã,521295,GO,Centro-Oeste,BUTANTAN/SINOVAC,1262,657,605
Matrinchã,521295,GO,Centro-Oeste,FIOCRUZ/ASTRAZENECA,1099,1032,67
Matriz De Camaragibe,270510,AL,Nordeste,FIOCRUZ/ASTRAZENECA,3818,3575,243
Matriz De Camaragibe,270510,AL,Nordeste,BUTANTAN/SINOVAC,3321,1716,1605
Matriz De Camaragibe,270510,AL,Nordeste,PFIZER/BIONTECH,23,23,0
Matupá,510560,MT,Centro-Oeste,FIOCRUZ/ASTRAZENECA,2259,2120,139
Matupá,510560,MT,Centro-Oeste,BUTANTAN/SINOVAC,2170,1116,1054
Matupá,510560,MT,Centro-Oeste,PFIZER/BIONTECH,91,91,0
Maturéia,250939,PB,Nordeste,BUTANTAN/SINOVAC,1373,696,677
Maturéia,250939,PB,Nordeste,FIOCRUZ/ASTRAZENECA,1113,1026,87
Maturéia,250939,PB,Nordeste,PFIZER/BIONTECH,142,142,0
Matutina,314120,MG,Sudeste,BUTANTAN/SINOVAC,2404,1220,1184
Matutina,314120,MG,Sudeste,FIOCRUZ/ASTRAZENECA,1135,1004,131
Matutina,314120,MG,Sudeste,PFIZER/BIONTECH,96,95,1
Mauá,352940,SP,Sudeste,BUTANTAN/SINOVAC,67573,36284,31289
Mauá,352940,SP,Sudeste,FIOCRUZ/ASTRAZENECA,65233,61382,3851
Mauá,352940,SP,Sudeste,PFIZER/BIONTECH,5996,5989,7
Mauá Da Serra,411575,PR,Sul,FIOCRUZ/ASTRAZENECA,2297,2179,118
Mauá Da Serra,411575,PR,Sul,BUTANTAN/SINOVAC,1632,865,767
Mauá Da Serra,411575,PR,Sul,PFIZER/BIONTECH,125,125,0
Maués,130290,AM,Norte,FIOCRUZ/ASTRAZENECA,10880,8722,2158
Maués,130290,AM,Norte,BUTANTAN/SINOVAC,7924,5440,2484
Maurilândia,521300,GO,Centro-Oeste,FIOCRUZ/ASTRAZENECA,2208,2049,159
Maurilândia,521300,GO,Centro-Oeste,BUTANTAN/SINOVAC,1406,724,682
Maurilândia Do Tocantins,171280,TO,Norte,BUTANTAN/SINOVAC,736,386,350
Maurilândia Do Tocantins,171280,TO,Norte,FIOCRUZ/ASTRAZENECA,291,281,10
Mauriti,230810,CE,Nordeste,BUTANTAN/SINOVAC,3926,3281,645
Mauriti,230810,CE,Nordeste,FIOCRUZ/ASTRAZENECA,2483,2481,2
Mauriti,230810,CE,Nordeste,PFIZER/BIONTECH,1,1,0
Maxaranguape,240750,RN,Nordeste,BUTANTAN/SINOVAC,1430,830,600
Maxaranguape,240750,RN,Nordeste,FIOCRUZ/ASTRAZENECA,884,787,97
Maxaranguape,240750,RN,Nordeste,PFIZER/BIONTECH,38,38,0
Maximiliano De Almeida,431220,RS,Sul,FIOCRUZ/ASTRAZENECA,1388,1209,179
Maximiliano De Almeida,431220,RS,Sul,BUTANTAN/SINOVAC,1255,648,607
Maximiliano De Almeida,431220,RS,Sul,PFIZER/BIONTECH,183,183,0
Mazagão,160040,AP,Norte,FIOCRUZ/ASTRAZENECA,3427,3252,175
Mazagão,160040,AP,Norte,BUTANTAN/SINOVAC,1920,980,940
Mazagão,160040,AP,Norte,PFIZER/BIONTECH,130,130,0
Medeiros,314130,MG,Sudeste,FIOCRUZ/ASTRAZENECA,797,735,62
Medeiros,314130,MG,Sudeste,BUTANTAN/SINOVAC,751,370,381
Medeiros,314130,MG,Sudeste,PFIZER/BIONTECH,92,92,0
Medeiros Neto,292110,BA,Nordeste,BUTANTAN/SINOVAC,4600,2449,2151
Medeiros Neto,292110,BA,Nordeste,FIOCRUZ/ASTRAZENECA,4107,3799,308
Medeiros Neto,292110,BA,Nordeste,PFIZER/BIONTECH,36,36,0
Medianeira,411580,PR,Sul,FIOCRUZ/ASTRAZENECA,10538,9850,688
Medianeira,411580,PR,Sul,BUTANTAN/SINOVAC,7858,4136,3722
Medianeira,411580,PR,Sul,PFIZER/BIONTECH,594,594,0
Medicilândia,150445,PA,Norte,BUTANTAN/SINOVAC,3005,1559,1446
Medicilândia,150445,PA,Norte,FIOCRUZ/ASTRAZENECA,2781,2024,757
Medina,314140,MG,Sudeste,BUTANTAN/SINOVAC,4680,2373,2307
Medina,314140,MG,Sudeste,FIOCRUZ/ASTRAZENECA,3462,3101,361
Medina,314140,MG,Sudeste,PFIZER/BIONTECH,101,101,0
Meleiro,421080,SC,Sul,FIOCRUZ/ASTRAZENECA,1679,1490,189
Meleiro,421080,SC,Sul,BUTANTAN/SINOVAC,1671,866,805
Meleiro,421080,SC,Sul,PFIZER/BIONTECH,211,211,0
Melgaço,150450,PA,Norte,FIOCRUZ/ASTRAZENECA,5095,4495,600
Melgaço,150450,PA,Norte,BUTANTAN/SINOVAC,919,518,401
Mendes,330280,RJ,Sudeste,BUTANTAN/SINOVAC,4675,2489,2186
Mendes,330280,RJ,Sudeste,FIOCRUZ/ASTRAZENECA,4174,3848,326
Mendes Pimentel,314150,MG,Sudeste,BUTANTAN/SINOVAC,1523,761,762
Mendes Pimentel,314150,MG,Sudeste,FIOCRUZ/ASTRAZENECA,1462,1335,127
Mendes Pimentel,314150,MG,Sudeste,PFIZER/BIONTECH,201,201,0
Mendonça,352950,SP,Sudeste,FIOCRUZ/ASTRAZENECA,1760,1574,186
Mendonça,352950,SP,Sudeste,BUTANTAN/SINOVAC,1723,905,818
Mendonça,352950,SP,Sudeste,PFIZER/BIONTECH,94,94,0
Mercedes,411585,PR,Sul,FIOCRUZ/ASTRAZENECA,1387,1288,99
Mercedes,411585,PR,Sul,BUTANTAN/SINOVAC,1215,631,584
Mercedes,411585,PR,Sul,PFIZER/BIONTECH,18,18,0
Mercês,314160,MG,Sudeste,FIOCRUZ/ASTRAZENECA,2849,2588,261
Mercês,314160,MG,Sudeste,BUTANTAN/SINOVAC,2658,1336,1322
Meridiano,352960,SP,Sudeste,BUTANTAN/SINOVAC,1171,603,568
Meridiano,352960,SP,Sudeste,FIOCRUZ/ASTRAZENECA,1012,911,101
Meridiano,352960,SP,Sudeste,PFIZER/BIONTECH,91,91,0
Meruoca,230820,CE,Nordeste,BUTANTAN/SINOVAC,2675,1454,1221
Meruoca,230820,CE,Nordeste,FIOCRUZ/ASTRAZENECA,1929,1792,137
Mesópolis,352965,SP,Sudeste,BUTANTAN/SINOVAC,589,316,273
Mesópolis,352965,SP,Sudeste,FIOCRUZ/ASTRAZENECA,474,424,50
Mesópolis,352965,SP,Sudeste,PFIZER/BIONTECH,22,22,0
Mesquita,314170,MG,Sudeste,BUTANTAN/SINOVAC,1543,785,758
Mesquita,314170,MG,Sudeste,FIOCRUZ/ASTRAZENECA,1210,1111,99
Mesquita,314170,MG,Sudeste,PFIZER/BIONTECH,11,11,0
Mesquita,330285,RJ,Sudeste,BUTANTAN/SINOVAC,39577,20979,18598
Mesquita,330285,RJ,Sudeste,FIOCRUZ/ASTRAZENECA,31960,29449,2511
Mesquita,330285,RJ,Sudeste,PFIZER/BIONTECH,5861,5859,2
Messias,270520,AL,Nordeste,BUTANTAN/SINOVAC,2635,1465,1170
Messias,270520,AL,Nordeste,FIOCRUZ/ASTRAZENECA,2221,2076,145
Messias Targino,240760,RN,Nordeste,BUTANTAN/SINOVAC,1010,518,492
Messias Targino,240760,RN,Nordeste,FIOCRUZ/ASTRAZENECA,849,800,49
Messias Targino,240760,RN,Nordeste,PFIZER/BIONTECH,168,168,0
Miguel Alves,220620,PI,Nordeste,FIOCRUZ/ASTRAZENECA,6438,6023,415
Miguel Alves,220620,PI,Nordeste,BUTANTAN/SINOVAC,4646,2403,2243
Miguel Calmon,292120,BA,Nordeste,FIOCRUZ/ASTRAZENECA,5767,5155,612
Miguel Calmon,292120,BA,Nordeste,BUTANTAN/SINOVAC,5637,2960,2677
Miguel Calmon,292120,BA,Nordeste,PFIZER/BIONTECH,249,249,0
Miguel Leão,220630,PI,Nordeste,BUTANTAN/SINOVAC,569,323,246
Miguel Leão,220630,PI,Nordeste,FIOCRUZ/ASTRAZENECA,557,509,48
Miguel Leão,220630,PI,Nordeste,PFIZER/BIONTECH,4,4,0
Miguel Pereira,330290,RJ,Sudeste,FIOCRUZ/ASTRAZENECA,6267,5695,572
Miguel Pereira,330290,RJ,Sudeste,BUTANTAN/SINOVAC,6216,3239,2977
Miguel Pereira,330290,RJ,Sudeste,PFIZER/BIONTECH,481,481,0
Miguelópolis,352970,SP,Sudeste,FIOCRUZ/ASTRAZENECA,4832,4382,450
Miguelópolis,352970,SP,Sudeste,BUTANTAN/SINOVAC,4157,2193,1964
Miguelópolis,352970,SP,Sudeste,PFIZER/BIONTECH,173,173,0
Milagres,230830,CE,Nordeste,BUTANTAN/SINOVAC,5324,2771,2553
Milagres,230830,CE,Nordeste,FIOCRUZ/ASTRAZENECA,3313,2762,551
Milagres,292130,BA,Nordeste,BUTANTAN/SINOVAC,1201,908,293
Milagres,292130,BA,Nordeste,FIOCRUZ/ASTRAZENECA,843,842,1
Milagres,292130,BA,Nordeste,PFIZER/BIONTECH,130,130,0
Milagres Do Maranhão,210667,MA,Nordeste,FIOCRUZ/ASTRAZENECA,1411,1341,70
Milagres Do Maranhão,210667,MA,Nordeste,BUTANTAN/SINOVAC,1092,564,528
Milhã,230835,CE,Nordeste,BUTANTAN/SINOVAC,3150,1583,1567
Milhã,230835,CE,Nordeste,FIOCRUZ/ASTRAZENECA,1745,1467,278
Milton Brandão,220635,PI,Nordeste,FIOCRUZ/ASTRAZENECA,692,692,0
Milton Brandão,220635,PI,Nordeste,BUTANTAN/SINOVAC,508,270,238
Mimoso De Goiás,521305,GO,Centro-Oeste,FIOCRUZ/ASTRAZENECA,1025,923,102
Mimoso De Goiás,521305,GO,Centro-Oeste,BUTANTAN/SINOVAC,420,221,199
Mimoso De Goiás,521305,GO,Centro-Oeste,PFIZER/BIONTECH,20,20,0
Mimoso Do Sul,320340,ES,Sudeste,BUTANTAN/SINOVAC,7801,4537,3264
Mimoso Do Sul,320340,ES,Sudeste,FIOCRUZ/ASTRAZENECA,4864,4682,182
Mimoso Do Sul,320340,ES,Sudeste,PFIZER/BIONTECH,393,393,0
Minaçu,521308,GO,Centro-Oeste,FIOCRUZ/ASTRAZENECA,10117,9479,638
Minaçu,521308,GO,Centro-Oeste,BUTANTAN/SINOVAC,7356,3801,3555
Minador Do Negrão,270530,AL,Nordeste,FIOCRUZ/ASTRAZENECA,1294,1198,96
Minador Do Negrão,270530,AL,Nordeste,BUTANTAN/SINOVAC,1181,629,552
Minas Do Leão,431225,RS,Sul,FIOCRUZ/ASTRAZENECA,1720,1669,51
Minas Do Leão,431225,RS,Sul,BUTANTAN/SINOVAC,1688,916,772
Minas Do Leão,431225,RS,Sul,PFIZER/BIONTECH,210,209,1
Minas Novas,314180,MG,Sudeste,FIOCRUZ/ASTRAZENECA,5674,5384,290
Minas Novas,314180,MG,Sudeste,BUTANTAN/SINOVAC,4104,2127,1977
Minas Novas,314180,MG,Sudeste,PFIZER/BIONTECH,1085,1085,0
Minduri,314190,MG,Sudeste,FIOCRUZ/ASTRAZENECA,601,587,14
Minduri,314190,MG,Sudeste,BUTANTAN/SINOVAC,583,343,240
Minduri,314190,MG,Sudeste,PFIZER/BIONTECH,28,28,0
Mineiros,521310,GO,Centro-Oeste,FIOCRUZ/ASTRAZENECA,11871,10671,1200
Mineiros,521310,GO,Centro-Oeste,BUTANTAN/SINOVAC,10956,5710,5246
Mineiros Do Tietê,352980,SP,Sudeste,FIOCRUZ/ASTRAZENECA,2963,2721,242
Mineiros Do Tietê,352980,SP,Sudeste,BUTANTAN/SINOVAC,2655,1370,1285
Mineiros Do Tietê,352980,SP,Sudeste,PFIZER/BIONTECH,341,341,0
Ministro Andreazza,110120,RO,Norte,BUTANTAN/SINOVAC,1750,931,819
Ministro Andreazza,110120,RO,Norte,FIOCRUZ/ASTRAZENECA,1398,1345,53
Ministro Andreazza,110120,RO,Norte,PFIZER/BIONTECH,154,154,0
Mira Estrela,353000,SP,Sudeste,FIOCRUZ/ASTRAZENECA,962,876,86
Mira Estrela,353000,SP,Sudeste,BUTANTAN/SINOVAC,922,475,447
Mira Estrela,353000,SP,Sudeste,PFIZER/BIONTECH,63,63,0
Mirabela,314200,MG,Sudeste,BUTANTAN/SINOVAC,2758,1388,1370
Mirabela,314200,MG,Sudeste,FIOCRUZ/ASTRAZENECA,2568,2377,191
Mirabela,314200,MG,Sudeste,PFIZER/BIONTECH,34,34,0
Miracatu,352990,SP,Sudeste,BUTANTAN/SINOVAC,5255,3006,2249
Miracatu,352990,SP,Sudeste,FIOCRUZ/ASTRAZENECA,3992,3677,315
Miracatu,352990,SP,Sudeste,PFIZER/BIONTECH,400,400,0
Miracema,330300,RJ,Sudeste,FIOCRUZ/ASTRAZENECA,5310,4837,473
Miracema,330300,RJ,Sudeste,BUTANTAN/SINOVAC,4956,2744,2212
Miracema,330300,RJ,Sudeste,PFIZER/BIONTECH,861,861,0
Miracema Do Tocantins,171320,TO,Norte,BUTANTAN/SINOVAC,3551,1821,1730
Miracema Do Tocantins,171320,TO,Norte,FIOCRUZ/ASTRAZENECA,3102,2861,241
Mirador,210670,MA,Nordeste,FIOCRUZ/ASTRAZENECA,3437,3241,196
Mirador,210670,MA,Nordeste,BUTANTAN/SINOVAC,2560,1345,1215
Mirador,411590,PR,Sul,FIOCRUZ/ASTRAZENECA,596,557,39
Mirador,411590,PR,Sul,BUTANTAN/SINOVAC,556,291,265
Mirador,411590,PR,Sul,PFIZER/BIONTECH,5,5,0
Miradouro,314210,MG,Sudeste,BUTANTAN/SINOVAC,2114,1064,1050
Miradouro,314210,MG,Sudeste,FIOCRUZ/ASTRAZENECA,1963,1808,155
Miradouro,314210,MG,Sudeste,PFIZER/BIONTECH,95,95,0
Miraguaí,431230,RS,Sul,BUTANTAN/SINOVAC,1494,751,743
Miraguaí,431230,RS,Sul,FIOCRUZ/ASTRAZENECA,1266,1167,99
Miraguaí,431230,RS,Sul,PFIZER/BIONTECH,143,143,0
Miraí,314220,MG,Sudeste,BUTANTAN/SINOVAC,3652,1883,1769
Miraí,314220,MG,Sudeste,FIOCRUZ/ASTRAZENECA,2188,1973,215
Miraí,314220,MG,Sudeste,PFIZER/BIONTECH,128,128,0
Miraíma,230837,CE,Nordeste,BUTANTAN/SINOVAC,2146,1094,1052
Miraíma,230837,CE,Nordeste,FIOCRUZ/ASTRAZENECA,1005,793,212
Miranda,500560,MS,Centro-Oeste,BUTANTAN/SINOVAC,12368,7144,5224
Miranda,500560,MS,Centro-Oeste,FIOCRUZ/ASTRAZENECA,5322,5142,180
Miranda,500560,MS,Centro-Oeste,PFIZER/BIONTECH,853,853,0
Miranda Do Norte,210675,MA,Nordeste,FIOCRUZ/ASTRAZENECA,4154,3926,228
Miranda Do Norte,210675,MA,Nordeste,BUTANTAN/SINOVAC,3013,1640,1373
Mirandiba,260930,PE,Nordeste,FIOCRUZ/ASTRAZENECA,4304,4016,288
Mirandiba,260930,PE,Nordeste,BUTANTAN/SINOVAC,2785,1554,1231
Mirandiba,260930,PE,Nordeste,PFIZER/BIONTECH,200,199,1
Mirandópolis,353010,SP,Sudeste,BUTANTAN/SINOVAC,7276,3905,3371
Mirandópolis,353010,SP,Sudeste,FIOCRUZ/ASTRAZENECA,7274,6531,743
Mirandópolis,353010,SP,Sudeste,PFIZER/BIONTECH,253,253,0
Mirangaba,292140,BA,Nordeste,FIOCRUZ/ASTRAZENECA,5003,4665,338
Mirangaba,292140,BA,Nordeste,BUTANTAN/SINOVAC,3121,1640,1481
Mirangaba,292140,BA,Nordeste,PFIZER/BIONTECH,67,67,0
Miranorte,171330,TO,Norte,FIOCRUZ/ASTRAZENECA,2387,2286,101
Miranorte,171330,TO,Norte,BUTANTAN/SINOVAC,2305,1176,1129
Mirante,292145,BA,Nordeste,BUTANTAN/SINOVAC,2403,1342,1061
Mirante,292145,BA,Nordeste,FIOCRUZ/ASTRAZENECA,1713,1583,130
Mirante,292145,BA,Nordeste,PFIZER/BIONTECH,22,22,0
Mirante Da Serra,110130,RO,Norte,BUTANTAN/SINOVAC,2533,1328,1205
Mirante Da Serra,110130,RO,Norte,FIOCRUZ/ASTRAZENECA,1194,1184,10
Mirante Do Paranapanema,353020,SP,Sudeste,BUTANTAN/SINOVAC,4622,2336,2286
Mirante Do Paranapanema,353020,SP,Sudeste,FIOCRUZ/ASTRAZENECA,3481,3241,240
Mirante Do Paranapanema,353020,SP,Sudeste,PFIZER/BIONTECH,671,671,0
Miraselva,411600,PR,Sul,FIOCRUZ/ASTRAZENECA,732,659,73
Miraselva,411600,PR,Sul,BUTANTAN/SINOVAC,607,314,293
Mirassol,353030,SP,Sudeste,BUTANTAN/SINOVAC,12992,7515,5477
Mirassol,353030,SP,Sudeste,FIOCRUZ/ASTRAZENECA,12763,11764,999
Mirassol,353030,SP,Sudeste,PFIZER/BIONTECH,1307,1307,0
Mirassol D'Oeste,510562,MT,Centro-Oeste,FIOCRUZ/ASTRAZENECA,4431,3990,441
Mirassol D'Oeste,510562,MT,Centro-Oeste,BUTANTAN/SINOVAC,3750,2078,1672
Mirassol D'Oeste,510562,MT,Centro-Oeste,PFIZER/BIONTECH,72,72,0
Mirassolândia,353040,SP,Sudeste,BUTANTAN/SINOVAC,1203,656,547
Mirassolândia,353040,SP,Sudeste,FIOCRUZ/ASTRAZENECA,424,365,59
Mirassolândia,353040,SP,Sudeste,PFIZER/BIONTECH,2,2,0
Miravânia,314225,MG,Sudeste,BUTANTAN/SINOVAC,1023,531,492
Miravânia,314225,MG,Sudeste,FIOCRUZ/ASTRAZENECA,933,615,318
Miravânia,314225,MG,Sudeste,PFIZER/BIONTECH,34,34,0
Mirim Doce,421085,SC,Sul,FIOCRUZ/ASTRAZENECA,695,649,46
Mirim Doce,421085,SC,Sul,BUTANTAN/SINOVAC,690,373,317
Mirinzal,210680,MA,Nordeste,FIOCRUZ/ASTRAZENECA,6837,5614,1223
Mirinzal,210680,MA,Nordeste,BUTANTAN/SINOVAC,1871,1037,834
Missal,411605,PR,Sul,BUTANTAN/SINOVAC,2805,1448,1357
Missal,411605,PR,Sul,FIOCRUZ/ASTRAZENECA,2311,2185,126
Missal,411605,PR,Sul,PFIZER/BIONTECH,102,102,0
Missão Velha,230840,CE,Nordeste,BUTANTAN/SINOVAC,5719,3034,2685
Missão Velha,230840,CE,Nordeste,FIOCRUZ/ASTRAZENECA,2823,2541,282
Mocajuba,150460,PA,Norte,FIOCRUZ/ASTRAZENECA,4583,3997,586
Mocajuba,150460,PA,Norte,BUTANTAN/SINOVAC,2880,1520,1360
Mococa,353050,SP,Sudeste,BUTANTAN/SINOVAC,17323,9224,8099
Mococa,353050,SP,Sudeste,FIOCRUZ/ASTRAZENECA,15394,14091,1303
Mococa,353050,SP,Sudeste,PFIZER/BIONTECH,556,555,1
Modelo,421090,SC,Sul,FIOCRUZ/ASTRAZENECA,1725,1528,197
Modelo,421090,SC,Sul,BUTANTAN/SINOVAC,1111,558,553
Modelo,421090,SC,Sul,PFIZER/BIONTECH,95,95,0
Moeda,314230,MG,Sudeste,FIOCRUZ/ASTRAZENECA,1289,1177,112
Moeda,314230,MG,Sudeste,BUTANTAN/SINOVAC,1189,608,581
Moema,314240,MG,Sudeste,FIOCRUZ/ASTRAZENECA,1808,1751,57
Moema,314240,MG,Sudeste,BUTANTAN/SINOVAC,1518,862,656
Moema,314240,MG,Sudeste,PFIZER/BIONTECH,117,117,0
Mogeiro,250940,PB,Nordeste,BUTANTAN/SINOVAC,2941,1514,1427
Mogeiro,250940,PB,Nordeste,FIOCRUZ/ASTRAZENECA,2142,1989,153
Mogeiro,250940,PB,Nordeste,PFIZER/BIONTECH,271,271,0
Mogi Das Cruzes,353060,SP,Sudeste,FIOCRUZ/ASTRAZENECA,79974,73743,6231
Mogi Das Cruzes,353060,SP,Sudeste,BUTANTAN/SINOVAC,65539,36891,28648
Mogi Das Cruzes,353060,SP,Sudeste,PFIZER/BIONTECH,7374,7368,6
Mogi Guaçu,353070,SP,Sudeste,FIOCRUZ/ASTRAZENECA,33751,31638,2113
Mogi Guaçu,353070,SP,Sudeste,BUTANTAN/SINOVAC,31221,16401,14820
Mogi Guaçu,353070,SP,Sudeste,PFIZER/BIONTECH,1086,1084,2
Mogi Mirim,353080,SP,Sudeste,FIOCRUZ/ASTRAZENECA,21998,20190,1808
Mogi Mirim,353080,SP,Sudeste,BUTANTAN/SINOVAC,20885,11074,9811
Mogi Mirim,353080,SP,Sudeste,PFIZER/BIONTECH,1018,1018,0
Moiporá,521340,GO,Centro-Oeste,FIOCRUZ/ASTRAZENECA,633,582,51
Moiporá,521340,GO,Centro-Oeste,BUTANTAN/SINOVAC,465,242,223
Moita Bonita,280410,SE,Nordeste,BUTANTAN/SINOVAC,3306,1806,1500
Moita Bonita,280410,SE,Nordeste,FIOCRUZ/ASTRAZENECA,2023,2023,0
Moita Bonita,280410,SE,Nordeste,PFIZER/BIONTECH,299,299,0
Moju,150470,PA,Norte,FIOCRUZ/ASTRAZENECA,14648,12815,1833
Moju,150470,PA,Norte,BUTANTAN/SINOVAC,6738,3733,3005
Mojuí Dos Campos,150475,PA,Norte,FIOCRUZ/ASTRAZENECA,5058,3583,1475
Mojuí Dos Campos,150475,PA,Norte,BUTANTAN/SINOVAC,1466,802,664
Mombaça,230850,CE,Nordeste,BUTANTAN/SINOVAC,8554,4519,4035
Mombaça,230850,CE,Nordeste,FIOCRUZ/ASTRAZENECA,4109,3461,648
Mombuca,353090,SP,Sudeste,BUTANTAN/SINOVAC,1318,732,586
Mombuca,353090,SP,Sudeste,FIOCRUZ/ASTRAZENECA,1230,1170,60
Mombuca,353090,SP,Sudeste,PFIZER/BIONTECH,94,94,0
Monção,210690,MA,Nordeste,FIOCRUZ/ASTRAZENECA,6028,5704,324
Monção,210690,MA,Nordeste,BUTANTAN/SINOVAC,4103,2339,1764
Monções,353100,SP,Sudeste,BUTANTAN/SINOVAC,696,353,343
Monções,353100,SP,Sudeste,FIOCRUZ/ASTRAZENECA,571,511,60
Monções,353100,SP,Sudeste,PFIZER/BIONTECH,18,18,0
Mondaí,421100,SC,Sul,FIOCRUZ/ASTRAZENECA,2628,2414,214
Mondaí,421100,SC,Sul,BUTANTAN/SINOVAC,2302,1214,1088
Mondaí,421100,SC,Sul,PFIZER/BIONTECH,147,147,0
Mongaguá,353110,SP,Sudeste,FIOCRUZ/ASTRAZENECA,7252,7009,243
Mongaguá,353110,SP,Sudeste,BUTANTAN/SINOVAC,5978,3814,2164
Mongaguá,353110,SP,Sudeste,PFIZER/BIONTECH,322,322,0
Monjolos,314250,MG,Sudeste,FIOCRUZ/ASTRAZENECA,610,561,49
Monjolos,314250,MG,Sudeste,BUTANTAN/SINOVAC,578,289,289
Monjolos,314250,MG,Sudeste,PFIZER/BIONTECH,55,55,0
Monsenhor Gil,220640,PI,Nordeste,FIOCRUZ/ASTRAZENECA,2164,1979,185
Monsenhor Gil,220640,PI,Nordeste,BUTANTAN/SINOVAC,1883,973,910
Monsenhor Gil,220640,PI,Nordeste,PFIZER/BIONTECH,40,40,0
Monsenhor Hipólito,220650,PI,Nordeste,BUTANTAN/SINOVAC,1835,936,899
Monsenhor Hipólito,220650,PI,Nordeste,FIOCRUZ/ASTRAZENECA,1589,1436,153
Monsenhor Paulo,314260,MG,Sudeste,FIOCRUZ/ASTRAZENECA,859,825,34
Monsenhor Paulo,314260,MG,Sudeste,BUTANTAN/SINOVAC,705,392,313
Monsenhor Paulo,314260,MG,Sudeste,PFIZER/BIONTECH,92,92,0
Monsenhor Tabosa,230860,CE,Nordeste,BUTANTAN/SINOVAC,7622,4023,3599
Monsenhor Tabosa,230860,CE,Nordeste,FIOCRUZ/ASTRAZENECA,1691,1481,210
Montadas,250950,PB,Nordeste,BUTANTAN/SINOVAC,1318,667,651
Montadas,250950,PB,Nordeste,FIOCRUZ/ASTRAZENECA,927,829,98
Montadas,250950,PB,Nordeste,PFIZER/BIONTECH,66,66,0
Montalvânia,314270,MG,Sudeste,BUTANTAN/SINOVAC,3808,1963,1845
Montalvânia,314270,MG,Sudeste,FIOCRUZ/ASTRAZENECA,2373,2143,230
Montalvânia,314270,MG,Sudeste,PFIZER/BIONTECH,203,203,0
Montanha,320350,ES,Sudeste,BUTANTAN/SINOVAC,5637,3206,2431
Montanha,320350,ES,Sudeste,FIOCRUZ/ASTRAZENECA,3601,3432,169
Montanha,320350,ES,Sudeste,PFIZER/BIONTECH,357,356,1
Montanhas,240770,RN,Nordeste,BUTANTAN/SINOVAC,2926,1638,1288
Montanhas,240770,RN,Nordeste,FIOCRUZ/ASTRAZENECA,2105,1955,150
Montanhas,240770,RN,Nordeste,PFIZER/BIONTECH,185,185,0
Montauri,431235,RS,Sul,BUTANTAN/SINOVAC,543,272,271
Montauri,431235,RS,Sul,FIOCRUZ/ASTRAZENECA,486,435,51
Montauri,431235,RS,Sul,PFIZER/BIONTECH,72,71,1
Monte Alegre,150480,PA,Norte,FIOCRUZ/ASTRAZENECA,12477,9442,3035
Monte Alegre,150480,PA,Norte,BUTANTAN/SINOVAC,2283,1222,1061
Monte Alegre,240780,RN,Nordeste,BUTANTAN/SINOVAC,4249,2141,2108
Monte Alegre,240780,RN,Nordeste,FIOCRUZ/ASTRAZENECA,4021,3681,340
Monte Alegre,240780,RN,Nordeste,PFIZER/BIONTECH,482,481,1
Monte Alegre De Goiás,521350,GO,Centro-Oeste,BUTANTAN/SINOVAC,3834,2125,1709
Monte Alegre De Goiás,521350,GO,Centro-Oeste,FIOCRUZ/ASTRAZENECA,1543,1467,76
Monte Alegre De Minas,314280,MG,Sudeste,BUTANTAN/SINOVAC,4259,2294,1965
Monte Alegre De Minas,314280,MG,Sudeste,FIOCRUZ/ASTRAZENECA,3401,2774,627
Monte Alegre De Minas,314280,MG,Sudeste,PFIZER/BIONTECH,73,73,0
Monte Alegre De Sergipe,280420,SE,Nordeste,BUTANTAN/SINOVAC,2838,1441,1397
Monte Alegre De Sergipe,280420,SE,Nordeste,FIOCRUZ/ASTRAZENECA,1716,1710,6
Monte Alegre De Sergipe,280420,SE,Nordeste,PFIZER/BIONTECH,122,122,0
Monte Alegre Do Piauí,220660,PI,Nordeste,FIOCRUZ/ASTRAZENECA,1814,1698,116
Monte Alegre Do Piauí,220660,PI,Nordeste,BUTANTAN/SINOVAC,1463,753,710
Monte Alegre Do Sul,353120,SP,Sudeste,FIOCRUZ/ASTRAZENECA,2286,2091,195
Monte Alegre Do Sul,353120,SP,Sudeste,BUTANTAN/SINOVAC,2160,1156,1004
Monte Alegre Do Sul,353120,SP,Sudeste,PFIZER/BIONTECH,53,53,0
Monte Alegre Dos Campos,431237,RS,Sul,BUTANTAN/SINOVAC,753,387,366
Monte Alegre Dos Campos,431237,RS,Sul,FIOCRUZ/ASTRAZENECA,707,645,62
Monte Alegre Dos Campos,431237,RS,Sul,PFIZER/BIONTECH,47,47,0
Monte Alto,353130,SP,Sudeste,FIOCRUZ/ASTRAZENECA,12627,11606,1021
Monte Alto,353130,SP,Sudeste,BUTANTAN/SINOVAC,11195,5969,5226
Monte Alto,353130,SP,Sudeste,PFIZER/BIONTECH,419,419,0
Monte Aprazível,353140,SP,Sudeste,BUTANTAN/SINOVAC,6255,3272,2983
Monte Aprazível,353140,SP,Sudeste,FIOCRUZ/ASTRAZENECA,5734,5152,582
Monte Aprazível,353140,SP,Sudeste,PFIZER/BIONTECH,175,175,0
Monte Azul,314290,MG,Sudeste,FIOCRUZ/ASTRAZENECA,5517,5258,259
Monte Azul,314290,MG,Sudeste,BUTANTAN/SINOVAC,4369,2420,1949
Monte Azul,314290,MG,Sudeste,PFIZER/BIONTECH,63,63,0
Monte Azul Paulista,353150,SP,Sudeste,BUTANTAN/SINOVAC,5672,2892,2780
Monte Azul Paulista,353150,SP,Sudeste,FIOCRUZ/ASTRAZENECA,5645,5011,634
Monte Azul Paulista,353150,SP,Sudeste,PFIZER/BIONTECH,320,316,4
Monte Belo,314300,MG,Sudeste,FIOCRUZ/ASTRAZENECA,3555,3294,261
Monte Belo,314300,MG,Sudeste,BUTANTAN/SINOVAC,3008,1514,1494
Monte Belo,314300,MG,Sudeste,PFIZER/BIONTECH,175,175,0
Monte Belo Do Sul,431238,RS,Sul,BUTANTAN/SINOVAC,958,514,444
Monte Belo Do Sul,431238,RS,Sul,FIOCRUZ/ASTRAZENECA,826,696,130
Monte Belo Do Sul,431238,RS,Sul,PFIZER/BIONTECH,106,106,0
Monte Carlo,421105,SC,Sul,FIOCRUZ/ASTRAZENECA,1932,1753,179
Monte Carlo,421105,SC,Sul,BUTANTAN/SINOVAC,1596,856,740
Monte Carmelo,314310,MG,Sudeste,FIOCRUZ/ASTRAZENECA,9169,8003,1166
Monte Carmelo,314310,MG,Sudeste,BUTANTAN/SINOVAC,7816,3947,3869
Monte Carmelo,314310,MG,Sudeste,PFIZER/BIONTECH,1020,1018,2
Monte Castelo,353160,SP,Sudeste,BUTANTAN/SINOVAC,1185,610,575
Monte Castelo,353160,SP,Sudeste,FIOCRUZ/ASTRAZENECA,1047,939,108
Monte Castelo,353160,SP,Sudeste,PFIZER/BIONTECH,127,127,0
Monte Castelo,421110,SC,Sul,FIOCRUZ/ASTRAZENECA,2008,1824,184
Monte Castelo,421110,SC,Sul,BUTANTAN/SINOVAC,1378,743,635
Monte Castelo,421110,SC,Sul,PFIZER/BIONTECH,166,166,0
Monte Das Gameleiras,240790,RN,Nordeste,BUTANTAN/SINOVAC,1062,569,493
Monte Das Gameleiras,240790,RN,Nordeste,FIOCRUZ/ASTRAZENECA,732,669,63
Monte Das Gameleiras,240790,RN,Nordeste,PFIZER/BIONTECH,106,106,0
Monte Do Carmo,171360,TO,Norte,BUTANTAN/SINOVAC,1353,766,587
Monte Do Carmo,171360,TO,Norte,FIOCRUZ/ASTRAZENECA,1057,955,102
Monte Formoso,314315,MG,Sudeste,BUTANTAN/SINOVAC,1119,572,547
Monte Formoso,314315,MG,Sudeste,FIOCRUZ/ASTRAZENECA,602,511,91
Monte Formoso,314315,MG,Sudeste,PFIZER/BIONTECH,46,46,0
Monte Horebe,250960,PB,Nordeste,BUTANTAN/SINOVAC,935,491,444
Monte Horebe,250960,PB,Nordeste,FIOCRUZ/ASTRAZENECA,685,602,83
Monte Horebe,250960,PB,Nordeste,PFIZER/BIONTECH,63,63,0
Monte Mor,353180,SP,Sudeste,FIOCRUZ/ASTRAZENECA,10321,9731,590
Monte Mor,353180,SP,Sudeste,BUTANTAN/SINOVAC,9367,5083,4284
Monte Mor,353180,SP,Sudeste,PFIZER/BIONTECH,1407,1407,0
Monte Negro,110140,RO,Norte,FIOCRUZ/ASTRAZENECA,2926,2845,81
Monte Negro,110140,RO,Norte,BUTANTAN/SINOVAC,2729,1489,1240
Monte Negro,110140,RO,Norte,PFIZER/BIONTECH,144,144,0
Monte Santo,292150,BA,Nordeste,FIOCRUZ/ASTRAZENECA,7337,7317,20
Monte Santo,292150,BA,Nordeste,BUTANTAN/SINOVAC,6515,4775,1740
Monte Santo,292150,BA,Nordeste,PFIZER/BIONTECH,745,745,0
Monte Santo De Minas,314320,MG,Sudeste,BUTANTAN/SINOVAC,5585,2893,2692
Monte Santo De Minas,314320,MG,Sudeste,FIOCRUZ/ASTRAZENECA,4394,3982,412
Monte Santo De Minas,314320,MG,Sudeste,PFIZER/BIONTECH,124,124,0
Monte Santo Do Tocantins,171370,TO,Norte,BUTANTAN/SINOVAC,470,237,233
Monte Santo Do Tocantins,171370,TO,Norte,FIOCRUZ/ASTRAZENECA,342,331,11
Monte Sião,314340,MG,Sudeste,FIOCRUZ/ASTRAZENECA,4246,4047,199
Monte Sião,314340,MG,Sudeste,BUTANTAN/SINOVAC,3928,1983,1945
Monte Sião,314340,MG,Sudeste,PFIZER/BIONTECH,86,86,0
Monteiro,250970,PB,Nordeste,BUTANTAN/SINOVAC,7927,3992,3935
Monteiro,250970,PB,Nordeste,FIOCRUZ/ASTRAZENECA,6932,6242,690
Monteiro,250970,PB,Nordeste,PFIZER/BIONTECH,621,620,1
Monteiro Lobato,353170,SP,Sudeste,BUTANTAN/SINOVAC,1099,571,528
Monteiro Lobato,353170,SP,Sudeste,FIOCRUZ/ASTRAZENECA,654,549,105
Monteiro Lobato,353170,SP,Sudeste,PFIZER/BIONTECH,32,32,0
Monteirópolis,270540,AL,Nordeste,FIOCRUZ/ASTRAZENECA,1502,1355,147
Monteirópolis,270540,AL,Nordeste,BUTANTAN/SINOVAC,1146,586,560
Montenegro,431240,RS,Sul,BUTANTAN/SINOVAC,15761,8165,7596
Montenegro,431240,RS,Sul,FIOCRUZ/ASTRAZENECA,13930,12551,1379
Montenegro,431240,RS,Sul,PFIZER/BIONTECH,229,229,0
Montes Altos,210700,MA,Nordeste,BUTANTAN/SINOVAC,2697,1515,1182
Montes Altos,210700,MA,Nordeste,FIOCRUZ/ASTRAZENECA,1413,1294,119
Montes Claros,314330,MG,Sudeste,BUTANTAN/SINOVAC,74845,39543,35302
Montes Claros,314330,MG,Sudeste,FIOCRUZ/ASTRAZENECA,36937,34254,2683
Montes Claros,314330,MG,Sudeste,PFIZER/BIONTECH,135,135,0
Montes Claros De Goiás,521370,GO,Centro-Oeste,FIOCRUZ/ASTRAZENECA,2375,2238,137
Montes Claros De Goiás,521370,GO,Centro-Oeste,BUTANTAN/SINOVAC,1626,837,789
Montezuma,314345,MG,Sudeste,BUTANTAN/SINOVAC,1435,746,689
Montezuma,314345,MG,Sudeste,FIOCRUZ/ASTRAZENECA,961,877,84
Montezuma,314345,MG,Sudeste,PFIZER/BIONTECH,45,45,0
Montividiu,521375,GO,Centro-Oeste,BUTANTAN/SINOVAC,1709,929,780
Montividiu,521375,GO,Centro-Oeste,FIOCRUZ/ASTRAZENECA,1445,1399,46
Montividiu Do Norte,521377,GO,Centro-Oeste,FIOCRUZ/ASTRAZENECA,941,874,67
Montividiu Do Norte,521377,GO,Centro-Oeste,BUTANTAN/SINOVAC,687,356,331
Morada Nova,230870,CE,Nordeste,BUTANTAN/SINOVAC,11434,6116,5318
Morada Nova,230870,CE,Nordeste,FIOCRUZ/ASTRAZENECA,7044,6125,919
Morada Nova De Minas,314350,MG,Sudeste,FIOCRUZ/ASTRAZENECA,2114,1950,164
Morada Nova De Minas,314350,MG,Sudeste,BUTANTAN/SINOVAC,2044,1025,1019
Morada Nova De Minas,314350,MG,Sudeste,PFIZER/BIONTECH,237,237,0
Moraújo,230880,CE,Nordeste,BUTANTAN/SINOVAC,1634,941,693
Moraújo,230880,CE,Nordeste,FIOCRUZ/ASTRAZENECA,963,877,86
Moreilândia,261430,PE,Nordeste,FIOCRUZ/ASTRAZENECA,2380,2124,256
Moreilândia,261430,PE,Nordeste,BUTANTAN/SINOVAC,2209,1125,1084
Moreilândia,261430,PE,Nordeste,PFIZER/BIONTECH,234,234,0
Moreira Sales,411610,PR,Sul,FIOCRUZ/ASTRAZENECA,3386,3165,221
Moreira Sales,411610,PR,Sul,BUTANTAN/SINOVAC,3198,1612,1586
Moreno,260940,PE,Nordeste,FIOCRUZ/ASTRAZENECA,10014,9413,601
Moreno,260940,PE,Nordeste,BUTANTAN/SINOVAC,8939,4715,4224
Moreno,260940,PE,Nordeste,PFIZER/BIONTECH,299,297,2
Mormaço,431242,RS,Sul,FIOCRUZ/ASTRAZENECA,844,722,122
Mormaço,431242,RS,Sul,BUTANTAN/SINOVAC,810,407,403
Mormaço,431242,RS,Sul,PFIZER/BIONTECH,121,121,0
Morpará,292160,BA,Nordeste,BUTANTAN/SINOVAC,2273,1163,1110
Morpará,292160,BA,Nordeste,FIOCRUZ/ASTRAZENECA,1322,1215,107
Morpará,292160,BA,Nordeste,PFIZER/BIONTECH,11,11,0
Morretes,411620,PR,Sul,FIOCRUZ/ASTRAZENECA,3793,3632,161
Morretes,411620,PR,Sul,BUTANTAN/SINOVAC,3472,1905,1567
Morretes,411620,PR,Sul,PFIZER/BIONTECH,188,188,0
Morrinhos,230890,CE,Nordeste,BUTANTAN/SINOVAC,2062,1516,546
Morrinhos,230890,CE,Nordeste,FIOCRUZ/ASTRAZENECA,1182,1160,22
Morrinhos,230890,CE,Nordeste,PFIZER/BIONTECH,10,10,0
Morrinhos,521380,GO,Centro-Oeste,FIOCRUZ/ASTRAZENECA,11635,10746,889
Morrinhos,521380,GO,Centro-Oeste,BUTANTAN/SINOVAC,9079,4725,4354
Morrinhos,521380,GO,Centro-Oeste,PFIZER/BIONTECH,402,402,0
Morrinhos Do Sul,431244,RS,Sul,BUTANTAN/SINOVAC,1255,777,478
Morrinhos Do Sul,431244,RS,Sul,FIOCRUZ/ASTRAZENECA,977,909,68
Morrinhos Do Sul,431244,RS,Sul,PFIZER/BIONTECH,150,146,4
Morro Agudo,353190,SP,Sudeste,FIOCRUZ/ASTRAZENECA,6648,6248,400
Morro Agudo,353190,SP,Sudeste,BUTANTAN/SINOVAC,5256,2807,2449
Morro Agudo,353190,SP,Sudeste,PFIZER/BIONTECH,422,422,0
Morro Agudo De Goiás,521385,GO,Centro-Oeste,FIOCRUZ/ASTRAZENECA,951,901,50
Morro Agudo De Goiás,521385,GO,Centro-Oeste,BUTANTAN/SINOVAC,546,276,270
Morro Agudo De Goiás,521385,GO,Centro-Oeste,PFIZER/BIONTECH,12,12,0
Morro Cabeça No Tempo,220665,PI,Nordeste,BUTANTAN/SINOVAC,858,495,363
Morro Cabeça No Tempo,220665,PI,Nordeste,FIOCRUZ/ASTRAZENECA,501,392,109
Morro Da Fumaça,421120,SC,Sul,FIOCRUZ/ASTRAZENECA,3798,3608,190
Morro Da Fumaça,421120,SC,Sul,BUTANTAN/SINOVAC,3134,1695,1439
Morro Da Fumaça,421120,SC,Sul,PFIZER/BIONTECH,328,328,0
Morro Da Garça,314360,MG,Sudeste,BUTANTAN/SINOVAC,626,313,313
Morro Da Garça,314360,MG,Sudeste,FIOCRUZ/ASTRAZENECA,500,439,61
Morro Da Garça,314360,MG,Sudeste,PFIZER/BIONTECH,24,24,0
Morro Do Chapéu,292170,BA,Nordeste,FIOCRUZ/ASTRAZENECA,6904,6372,532
Morro Do Chapéu,292170,BA,Nordeste,BUTANTAN/SINOVAC,6136,3130,3006
Morro Do Chapéu,292170,BA,Nordeste,PFIZER/BIONTECH,96,96,0
Morro Do Chapéu Do Piauí,220667,PI,Nordeste,BUTANTAN/SINOVAC,1240,695,545
Morro Do Chapéu Do Piauí,220667,PI,Nordeste,FIOCRUZ/ASTRAZENECA,1084,975,109
Morro Do Chapéu Do Piauí,220667,PI,Nordeste,PFIZER/BIONTECH,63,63,0
Morro Do Pilar,314370,MG,Sudeste,BUTANTAN/SINOVAC,889,480,409
Morro Do Pilar,314370,MG,Sudeste,FIOCRUZ/ASTRAZENECA,640,594,46
Morro Do Pilar,314370,MG,Sudeste,PFIZER/BIONTECH,32,32,0
Morro Grande,421125,SC,Sul,FIOCRUZ/ASTRAZENECA,807,745,62
Morro Grande,421125,SC,Sul,BUTANTAN/SINOVAC,683,348,335
Morro Grande,421125,SC,Sul,PFIZER/BIONTECH,66,66,0
Morro Redondo,431245,RS,Sul,BUTANTAN/SINOVAC,2258,1224,1034
Morro Redondo,431245,RS,Sul,FIOCRUZ/ASTRAZENECA,1857,1736,121
Morro Redondo,431245,RS,Sul,PFIZER/BIONTECH,241,241,0
Morro Reuter,431247,RS,Sul,BUTANTAN/SINOVAC,1841,940,901
Morro Reuter,431247,RS,Sul,FIOCRUZ/ASTRAZENECA,1414,1278,136
Morro Reuter,431247,RS,Sul,PFIZER/BIONTECH,262,262,0
Morros,210710,MA,Nordeste,FIOCRUZ/ASTRAZENECA,3534,3361,173
Morros,210710,MA,Nordeste,BUTANTAN/SINOVAC,2148,1111,1037
Mortugaba,292180,BA,Nordeste,BUTANTAN/SINOVAC,4542,2632,1910
Mortugaba,292180,BA,Nordeste,FIOCRUZ/ASTRAZENECA,3417,2938,479
Mortugaba,292180,BA,Nordeste,PFIZER/BIONTECH,275,275,0
Morungaba,353200,SP,Sudeste,FIOCRUZ/ASTRAZENECA,2609,2454,155
Morungaba,353200,SP,Sudeste,BUTANTAN/SINOVAC,2094,1134,960
Morungaba,353200,SP,Sudeste,PFIZER/BIONTECH,248,248,0
Mossâmedes,521390,GO,Centro-Oeste,FIOCRUZ/ASTRAZENECA,1428,1325,103
Mossâmedes,521390,GO,Centro-Oeste,BUTANTAN/SINOVAC,995,528,467
Mossoró,240800,RN,Nordeste,BUTANTAN/SINOVAC,65124,34478,30646
Mossoró,240800,RN,Nordeste,FIOCRUZ/ASTRAZENECA,63705,57313,6392
Mossoró,240800,RN,Nordeste,PFIZER/BIONTECH,10079,10078,1
Mostardas,431250,RS,Sul,FIOCRUZ/ASTRAZENECA,4145,3713,432
Mostardas,431250,RS,Sul,BUTANTAN/SINOVAC,3780,1950,1830
Mostardas,431250,RS,Sul,PFIZER/BIONTECH,327,326,1
Motuca,353205,SP,Sudeste,FIOCRUZ/ASTRAZENECA,1323,1259,64
Motuca,353205,SP,Sudeste,BUTANTAN/SINOVAC,835,432,403
Motuca,353205,SP,Sudeste,PFIZER/BIONTECH,65,65,0
Mozarlândia,521400,GO,Centro-Oeste,FIOCRUZ/ASTRAZENECA,3528,3423,105
Mozarlândia,521400,GO,Centro-Oeste,BUTANTAN/SINOVAC,2159,1254,905
Muaná,150490,PA,Norte,FIOCRUZ/ASTRAZENECA,6435,6292,143
Muaná,150490,PA,Norte,BUTANTAN/SINOVAC,1603,830,773
Mucajaí,140030,RR,Norte,BUTANTAN/SINOVAC,2907,1518,1389
Mucajaí,140030,RR,Norte,FIOCRUZ/ASTRAZENECA,2270,2141,129
Mucambo,230900,CE,Nordeste,FIOCRUZ/ASTRAZENECA,2452,2213,239
Mucambo,230900,CE,Nordeste,BUTANTAN/SINOVAC,2184,1264,920
Mucambo,230900,CE,Nordeste,PFIZER/BIONTECH,2,1,1
Mucugê,292190,BA,Nordeste,FIOCRUZ/ASTRAZENECA,2031,1752,279
Mucugê,292190,BA,Nordeste,BUTANTAN/SINOVAC,1668,875,793
Mucugê,292190,BA,Nordeste,PFIZER/BIONTECH,129,129,0
Muçum,431260,RS,Sul,BUTANTAN/SINOVAC,1963,986,977
Muçum,431260,RS,Sul,FIOCRUZ/ASTRAZENECA,1273,1112,161
Muçum,431260,RS,Sul,PFIZER/BIONTECH,92,92,0
Mucuri,292200,BA,Nordeste,BUTANTAN/SINOVAC,3269,2325,944
Mucuri,292200,BA,Nordeste,FIOCRUZ/ASTRAZENECA,1306,1246,60
Mucurici,320360,ES,Sudeste,BUTANTAN/SINOVAC,1551,890,661
Mucurici,320360,ES,Sudeste,FIOCRUZ/ASTRAZENECA,1063,1007,56
Mucurici,320360,ES,Sudeste,PFIZER/BIONTECH,143,143,0
Muitos Capões,431261,RS,Sul,FIOCRUZ/ASTRAZENECA,857,823,34
Muitos Capões,431261,RS,Sul,BUTANTAN/SINOVAC,598,302,296
Muitos Capões,431261,RS,Sul,PFIZER/BIONTECH,6,6,0
Muliterno,431262,RS,Sul,FIOCRUZ/ASTRAZENECA,473,412,61
Muliterno,431262,RS,Sul,BUTANTAN/SINOVAC,450,232,218
Muliterno,431262,RS,Sul,PFIZER/BIONTECH,98,98,0
Mulungu,230910,CE,Nordeste,BUTANTAN/SINOVAC,1630,912,718
Mulungu,230910,CE,Nordeste,FIOCRUZ/ASTRAZENECA,1117,1003,114
Mulungu,230910,CE,Nordeste,PFIZER/BIONTECH,33,33,0
Mulungu,250980,PB,Nordeste,BUTANTAN/SINOVAC,2290,1315,975
Mulungu,250980,PB,Nordeste,FIOCRUZ/ASTRAZENECA,886,822,64
Mulungu,250980,PB,Nordeste,PFIZER/BIONTECH,36,36,0
Mulungu Do Morro,292205,BA,Nordeste,FIOCRUZ/ASTRAZENECA,4652,3961,691
Mulungu Do Morro,292205,BA,Nordeste,BUTANTAN/SINOVAC,1907,1004,903
Mulungu Do Morro,292205,BA,Nordeste,PFIZER/BIONTECH,207,207,0
Mundo Novo,292210,BA,Nordeste,FIOCRUZ/ASTRAZENECA,4416,3961,455
Mundo Novo,292210,BA,Nordeste,BUTANTAN/SINOVAC,4323,2203,2120
Mundo Novo,292210,BA,Nordeste,PFIZER/BIONTECH,344,341,3
Mundo Novo,500568,MS,Centro-Oeste,BUTANTAN/SINOVAC,4681,2496,2185
Mundo Novo,500568,MS,Centro-Oeste,FIOCRUZ/ASTRAZENECA,4291,3997,294
Mundo Novo,500568,MS,Centro-Oeste,PFIZER/BIONTECH,426,426,0
Mundo Novo,521405,GO,Centro-Oeste,FIOCRUZ/ASTRAZENECA,1719,1623,96
Mundo Novo,521405,GO,Centro-Oeste,BUTANTAN/SINOVAC,898,489,409
Munhoz,314380,MG,Sudeste,BUTANTAN/SINOVAC,1173,595,578
Munhoz,314380,MG,Sudeste,FIOCRUZ/ASTRAZENECA,994,934,60
Munhoz,314380,MG,Sudeste,PFIZER/BIONTECH,42,42,0
Munhoz De Melo,411630,PR,Sul,FIOCRUZ/ASTRAZENECA,1229,1177,52
Munhoz De Melo,411630,PR,Sul,BUTANTAN/SINOVAC,1144,593,551
Muniz Ferreira,292220,BA,Nordeste,FIOCRUZ/ASTRAZENECA,2081,1905,176
Muniz Ferreira,292220,BA,Nordeste,BUTANTAN/SINOVAC,1547,818,729
Muniz Ferreira,292220,BA,Nordeste,PFIZER/BIONTECH,206,206,0
Muniz Freire,320370,ES,Sudeste,BUTANTAN/SINOVAC,4618,2340,2278
Muniz Freire,320370,ES,Sudeste,FIOCRUZ/ASTRAZENECA,4373,4016,357
Muniz Freire,320370,ES,Sudeste,PFIZER/BIONTECH,752,751,1
Muquém Do São Francisco,292225,BA,Nordeste,FIOCRUZ/ASTRAZENECA,3259,2751,508
Muquém Do São Francisco,292225,BA,Nordeste,BUTANTAN/SINOVAC,1936,1021,915
Muquém Do São Francisco,292225,BA,Nordeste,PFIZER/BIONTECH,97,97,0
Muqui,320380,ES,Sudeste,BUTANTAN/SINOVAC,4143,2353,1790
Muqui,320380,ES,Sudeste,FIOCRUZ/ASTRAZENECA,2844,2762,82
Muqui,320380,ES,Sudeste,PFIZER/BIONTECH,593,593,0
Muriaé,314390,MG,Sudeste,BUTANTAN/SINOVAC,28636,15457,13179
Muriaé,314390,MG,Sudeste,FIOCRUZ/ASTRAZENECA,16336,14946,1390
Muriaé,314390,MG,Sudeste,PFIZER/BIONTECH,386,386,0
Muribeca,280430,SE,Nordeste,BUTANTAN/SINOVAC,1824,987,837
Muribeca,280430,SE,Nordeste,FIOCRUZ/ASTRAZENECA,1278,1200,78
Muribeca,280430,SE,Nordeste,PFIZER/BIONTECH,174,174,0
Murici,270550,AL,Nordeste,FIOCRUZ/ASTRAZENECA,4690,4377,313
Murici,270550,AL,Nordeste,BUTANTAN/SINOVAC,4226,2194,2032
Murici Dos Portelas,220669,PI,Nordeste,BUTANTAN/SINOVAC,1109,561,548
Murici Dos Portelas,220669,PI,Nordeste,FIOCRUZ/ASTRAZENECA,864,807,57
Muricilândia,171395,TO,Norte,FIOCRUZ/ASTRAZENECA,1521,1150,371
Muricilândia,171395,TO,Norte,BUTANTAN/SINOVAC,728,401,327
Muritiba,292230,BA,Nordeste,FIOCRUZ/ASTRAZENECA,5847,5382,465
Muritiba,292230,BA,Nordeste,BUTANTAN/SINOVAC,5068,2648,2420
Muritiba,292230,BA,Nordeste,PFIZER/BIONTECH,639,638,1
Murutinga Do Sul,353210,SP,Sudeste,BUTANTAN/SINOVAC,2086,1234,852
Murutinga Do Sul,353210,SP,Sudeste,FIOCRUZ/ASTRAZENECA,1562,1398,164
Murutinga Do Sul,353210,SP,Sudeste,PFIZER/BIONTECH,129,128,1
Mutuípe,292240,BA,Nordeste,BUTANTAN/SINOVAC,3596,1838,1758
Mutuípe,292240,BA,Nordeste,FIOCRUZ/ASTRAZENECA,2295,2172,123
Mutuípe,292240,BA,Nordeste,PFIZER/BIONTECH,95,95,0
Mutum,314400,MG,Sudeste,BUTANTAN/SINOVAC,6345,3424,2921
Mutum,314400,MG,Sudeste,FIOCRUZ/ASTRAZENECA,5165,4825,340
Mutum,314400,MG,Sudeste,PFIZER/BIONTECH,99,99,0
Mutunópolis,521410,GO,Centro-Oeste,FIOCRUZ/ASTRAZENECA,1245,1167,78
Mutunópolis,521410,GO,Centro-Oeste,BUTANTAN/SINOVAC,790,426,364
Mutunópolis,521410,GO,Centro-Oeste,PFIZER/BIONTECH,1,1,0
Muzambinho,314410,MG,Sudeste,FIOCRUZ/ASTRAZENECA,5305,4845,460
Muzambinho,314410,MG,Sudeste,BUTANTAN/SINOVAC,4816,2438,2378
Muzambinho,314410,MG,Sudeste,PFIZER/BIONTECH,356,356,0
Nacip Raydan,314420,MG,Sudeste,BUTANTAN/SINOVAC,825,415,410
Nacip Raydan,314420,MG,Sudeste,FIOCRUZ/ASTRAZENECA,471,439,32
Nantes,353215,SP,Sudeste,FIOCRUZ/ASTRAZENECA,1086,1045,41
Nantes,353215,SP,Sudeste,BUTANTAN/SINOVAC,707,410,297
Nantes,353215,SP,Sudeste,PFIZER/BIONTECH,126,126,0
Nanuque,314430,MG,Sudeste,BUTANTAN/SINOVAC,7712,4167,3545
Nanuque,314430,MG,Sudeste,FIOCRUZ/ASTRAZENECA,5941,5672,269
Nanuque,314430,MG,Sudeste,PFIZER/BIONTECH,624,622,2
Não-Me-Toque,431265,RS,Sul,FIOCRUZ/ASTRAZENECA,4909,4419,490
Não-Me-Toque,431265,RS,Sul,BUTANTAN/SINOVAC,4675,2435,2240
Não-Me-Toque,431265,RS,Sul,PFIZER/BIONTECH,479,479,0
Naque,314435,MG,Sudeste,FIOCRUZ/ASTRAZENECA,1365,1071,294
Naque,314435,MG,Sudeste,BUTANTAN/SINOVAC,1084,561,523
Naque,314435,MG,Sudeste,PFIZER/BIONTECH,111,111,0
Narandiba,353220,SP,Sudeste,FIOCRUZ/ASTRAZENECA,2275,2063,212
Narandiba,353220,SP,Sudeste,BUTANTAN/SINOVAC,1445,764,681
Narandiba,353220,SP,Sudeste,PFIZER/BIONTECH,85,85,0
Natal,240810,RN,Nordeste,BUTANTAN/SINOVAC,203189,108601,94588
Natal,240810,RN,Nordeste,FIOCRUZ/ASTRAZENECA,152213,131805,20408
Natal,240810,RN,Nordeste,PFIZER/BIONTECH,30439,30402,37
Natalândia,314437,MG,Sudeste,FIOCRUZ/ASTRAZENECA,887,766,121
Natalândia,314437,MG,Sudeste,BUTANTAN/SINOVAC,646,324,322
Natalândia,314437,MG,Sudeste,PFIZER/BIONTECH,139,138,1
Natércia,314440,MG,Sudeste,BUTANTAN/SINOVAC,1919,997,922
Natércia,314440,MG,Sudeste,FIOCRUZ/ASTRAZENECA,927,784,143
Natividade,171420,TO,Norte,BUTANTAN/SINOVAC,1778,906,872
Natividade,171420,TO,Norte,FIOCRUZ/ASTRAZENECA,1716,1646,70
Natividade,330310,RJ,Sudeste,BUTANTAN/SINOVAC,2187,1285,902
Natividade,330310,RJ,Sudeste,FIOCRUZ/ASTRAZENECA,811,745,66
Natividade Da Serra,353230,SP,Sudeste,BUTANTAN/SINOVAC,1468,861,607
Natividade Da Serra,353230,SP,Sudeste,FIOCRUZ/ASTRAZENECA,1020,989,31
Natividade Da Serra,353230,SP,Sudeste,PFIZER/BIONTECH,70,70,0
Natuba,250990,PB,Nordeste,BUTANTAN/SINOVAC,2162,1064,1098
Natuba,250990,PB,Nordeste,FIOCRUZ/ASTRAZENECA,1379,1203,176
Natuba,250990,PB,Nordeste,PFIZER/BIONTECH,117,117,0
Navegantes,421130,SC,Sul,FIOCRUZ/ASTRAZENECA,14349,13698,651
Navegantes,421130,SC,Sul,BUTANTAN/SINOVAC,6783,3997,2786
Navegantes,421130,SC,Sul,PFIZER/BIONTECH,417,416,1
Naviraí,500570,MS,Centro-Oeste,BUTANTAN/SINOVAC,9653,5036,4617
Naviraí,500570,MS,Centro-Oeste,FIOCRUZ/ASTRAZENECA,9293,8327,966
Naviraí,500570,MS,Centro-Oeste,PFIZER/BIONTECH,768,767,1
Nazaré,171430,TO,Norte,FIOCRUZ/ASTRAZENECA,1192,1169,23
Nazaré,171430,TO,Norte,BUTANTAN/SINOVAC,970,498,472
Nazaré,292250,BA,Nordeste,FIOCRUZ/ASTRAZENECA,4283,3856,427
Nazaré,292250,BA,Nordeste,BUTANTAN/SINOVAC,4238,2255,1983
Nazaré,292250,BA,Nordeste,PFIZER/BIONTECH,324,323,1
Nazaré Da Mata,260950,PE,Nordeste,FIOCRUZ/ASTRAZENECA,7163,6811,352
Nazaré Da Mata,260950,PE,Nordeste,BUTANTAN/SINOVAC,6464,3455,3009
Nazaré Da Mata,260950,PE,Nordeste,PFIZER/BIONTECH,164,164,0
Nazaré Do Piauí,220670,PI,Nordeste,BUTANTAN/SINOVAC,2050,1222,828
Nazaré Do Piauí,220670,PI,Nordeste,FIOCRUZ/ASTRAZENECA,959,826,133
Nazaré Paulista,353240,SP,Sudeste,FIOCRUZ/ASTRAZENECA,3632,3362,270
Nazaré Paulista,353240,SP,Sudeste,BUTANTAN/SINOVAC,3577,1863,1714
Nazaré Paulista,353240,SP,Sudeste,PFIZER/BIONTECH,494,494,0
Nazareno,314450,MG,Sudeste,FIOCRUZ/ASTRAZENECA,2092,1981,111
Nazareno,314450,MG,Sudeste,BUTANTAN/SINOVAC,1699,873,826
Nazareno,314450,MG,Sudeste,PFIZER/BIONTECH,36,36,0
Nazarezinho,251000,PB,Nordeste,BUTANTAN/SINOVAC,1925,969,956
Nazarezinho,251000,PB,Nordeste,FIOCRUZ/ASTRAZENECA,1432,1303,129
Nazarezinho,251000,PB,Nordeste,PFIZER/BIONTECH,130,130,0
Nazária,220672,PI,Nordeste,BUTANTAN/SINOVAC,1049,678,371
Nazária,220672,PI,Nordeste,FIOCRUZ/ASTRAZENECA,1005,951,54
Nazário,521440,GO,Centro-Oeste,FIOCRUZ/ASTRAZENECA,2341,2214,127
Nazário,521440,GO,Centro-Oeste,BUTANTAN/SINOVAC,1818,940,878
Nazário,521440,GO,Centro-Oeste,PFIZER/BIONTECH,113,113,0
Neópolis,280440,SE,Nordeste,BUTANTAN/SINOVAC,3671,1917,1754
Neópolis,280440,SE,Nordeste,FIOCRUZ/ASTRAZENECA,2271,2098,173
Neópolis,280440,SE,Nordeste,PFIZER/BIONTECH,79,79,0
Nepomuceno,314460,MG,Sudeste,BUTANTAN/SINOVAC,5394,2717,2677
Nepomuceno,314460,MG,Sudeste,FIOCRUZ/ASTRAZENECA,4761,4394,367
Nepomuceno,314460,MG,Sudeste,PFIZER/BIONTECH,298,298,0
Nerópolis,521450,GO,Centro-Oeste,FIOCRUZ/ASTRAZENECA,5282,4839,443
Nerópolis,521450,GO,Centro-Oeste,BUTANTAN/SINOVAC,4294,2216,2078
Neves Paulista,353250,SP,Sudeste,FIOCRUZ/ASTRAZENECA,2793,2513,280
Neves Paulista,353250,SP,Sudeste,BUTANTAN/SINOVAC,2355,1405,950
Neves Paulista,353250,SP,Sudeste,PFIZER/BIONTECH,83,83,0
Nhamundá,130300,AM,Norte,FIOCRUZ/ASTRAZENECA,6718,6102,616
Nhamundá,130300,AM,Norte,BUTANTAN/SINOVAC,3165,1820,1345
Nhandeara,353260,SP,Sudeste,BUTANTAN/SINOVAC,3227,1623,1604
Nhandeara,353260,SP,Sudeste,FIOCRUZ/ASTRAZENECA,2959,2676,283
Nhandeara,353260,SP,Sudeste,PFIZER/BIONTECH,100,100,0
Nicolau Vergueiro,431267,RS,Sul,BUTANTAN/SINOVAC,625,395,230
Nicolau Vergueiro,431267,RS,Sul,FIOCRUZ/ASTRAZENECA,551,512,39
Nicolau Vergueiro,431267,RS,Sul,PFIZER/BIONTECH,82,82,0
Nilo Peçanha,292260,BA,Nordeste,BUTANTAN/SINOVAC,1367,746,621
Nilo Peçanha,292260,BA,Nordeste,FIOCRUZ/ASTRAZENECA,779,727,52
Nilo Peçanha,292260,BA,Nordeste,PFIZER/BIONTECH,6,6,0
Nilópolis,330320,RJ,Sudeste,BUTANTAN/SINOVAC,44675,24207,20468
Nilópolis,330320,RJ,Sudeste,FIOCRUZ/ASTRAZENECA,23720,20476,3244
Nilópolis,330320,RJ,Sudeste,PFIZER/BIONTECH,4285,4275,10
Nina Rodrigues,210720,MA,Nordeste,FIOCRUZ/ASTRAZENECA,1982,1890,92
Nina Rodrigues,210720,MA,Nordeste,BUTANTAN/SINOVAC,1202,614,588
Ninheira,314465,MG,Sudeste,BUTANTAN/SINOVAC,1987,1029,958
Ninheira,314465,MG,Sudeste,FIOCRUZ/ASTRAZENECA,1438,1327,111
Ninheira,314465,MG,Sudeste,PFIZER/BIONTECH,130,130,0
Nioaque,500580,MS,Centro-Oeste,FIOCRUZ/ASTRAZENECA,4346,3819,527
Nioaque,500580,MS,Centro-Oeste,BUTANTAN/SINOVAC,4269,2195,2074
Nioaque,500580,MS,Centro-Oeste,PFIZER/BIONTECH,494,493,1
Nipoã,353270,SP,Sudeste,BUTANTAN/SINOVAC,992,492,500
Nipoã,353270,SP,Sudeste,FIOCRUZ/ASTRAZENECA,833,755,78
Niquelândia,521460,GO,Centro-Oeste,FIOCRUZ/ASTRAZENECA,10080,9435,645
Niquelândia,521460,GO,Centro-Oeste,BUTANTAN/SINOVAC,9092,5572,3520
Nísia Floresta,240820,RN,Nordeste,FIOCRUZ/ASTRAZENECA,4092,3931,161
Nísia Floresta,240820,RN,Nordeste,BUTANTAN/SINOVAC,3870,2034,1836
Nísia Floresta,240820,RN,Nordeste,PFIZER/BIONTECH,765,765,0
Niterói,330330,RJ,Sudeste,BUTANTAN/SINOVAC,136847,75746,61101
Niterói,330330,RJ,Sudeste,FIOCRUZ/ASTRAZENECA,116517,106347,10170
Niterói,330330,RJ,Sudeste,PFIZER/BIONTECH,6766,6761,5
Nobres,510590,MT,Centro-Oeste,BUTANTAN/SINOVAC,3003,1556,1447
Nobres,510590,MT,Centro-Oeste,FIOCRUZ/ASTRAZENECA,2686,2577,109
Nobres,510590,MT,Centro-Oeste,PFIZER/BIONTECH,194,193,1
Nonoai,431270,RS,Sul,BUTANTAN/SINOVAC,4636,2496,2140
Nonoai,431270,RS,Sul,FIOCRUZ/ASTRAZENECA,3264,3002,262
Nonoai,431270,RS,Sul,PFIZER/BIONTECH,385,384,1
Nordestina,292265,BA,Nordeste,FIOCRUZ/ASTRAZENECA,4205,3398,807
Nordestina,292265,BA,Nordeste,BUTANTAN/SINOVAC,2704,1442,1262
Nordestina,292265,BA,Nordeste,PFIZER/BIONTECH,380,380,0
Normandia,140040,RR,Norte,BUTANTAN/SINOVAC,5359,3196,2163
Normandia,140040,RR,Norte,FIOCRUZ/ASTRAZENECA,639,639,0
Nortelândia,510600,MT,Centro-Oeste,BUTANTAN/SINOVAC,1381,699,682
Nortelândia,510600,MT,Centro-Oeste,FIOCRUZ/ASTRAZENECA,1067,947,120
Nortelândia,510600,MT,Centro-Oeste,PFIZER/BIONTECH,21,21,0
Nossa Senhora Aparecida,280445,SE,Nordeste,BUTANTAN/SINOVAC,2344,1290,1054
Nossa Senhora Aparecida,280445,SE,Nordeste,FIOCRUZ/ASTRAZENECA,1120,1118,2
Nossa Senhora Aparecida,280445,SE,Nordeste,PFIZER/BIONTECH,42,42,0
Nossa Senhora Da Glória,280450,SE,Nordeste,FIOCRUZ/ASTRAZENECA,5486,5283,203
Nossa Senhora Da Glória,280450,SE,Nordeste,BUTANTAN/SINOVAC,4295,2349,1946
Nossa Senhora Da Glória,280450,SE,Nordeste,PFIZER/BIONTECH,162,162,0
Nossa Senhora Das Dores,280460,SE,Nordeste,BUTANTAN/SINOVAC,6972,3892,3080
Nossa Senhora Das Dores,280460,SE,Nordeste,FIOCRUZ/ASTRAZENECA,4375,4368,7
Nossa Senhora Das Dores,280460,SE,Nordeste,PFIZER/BIONTECH,565,565,0
Nossa Senhora Das Graças,411640,PR,Sul,BUTANTAN/SINOVAC,972,508,464
Nossa Senhora Das Graças,411640,PR,Sul,FIOCRUZ/ASTRAZENECA,942,920,22
Nossa Senhora De Lourdes,280470,SE,Nordeste,BUTANTAN/SINOVAC,1451,744,707
Nossa Senhora De Lourdes,280470,SE,Nordeste,FIOCRUZ/ASTRAZENECA,1225,1169,56
Nossa Senhora De Lourdes,280470,SE,Nordeste,PFIZER/BIONTECH,142,142,0
Nossa Senhora De Nazaré,220675,PI,Nordeste,FIOCRUZ/ASTRAZENECA,1296,1183,113
Nossa Senhora De Nazaré,220675,PI,Nordeste,BUTANTAN/SINOVAC,1064,545,519
Nossa Senhora De Nazaré,220675,PI,Nordeste,PFIZER/BIONTECH,105,105,0
Nossa Senhora Do Livramento,510610,MT,Centro-Oeste,FIOCRUZ/ASTRAZENECA,6643,3785,2858
Nossa Senhora Do Livramento,510610,MT,Centro-Oeste,BUTANTAN/SINOVAC,2799,1447,1352
Nossa Senhora Do Socorro,280480,SE,Nordeste,BUTANTAN/SINOVAC,24375,12680,11695
Nossa Senhora Do Socorro,280480,SE,Nordeste,FIOCRUZ/ASTRAZENECA,9298,8876,422
Nossa Senhora Dos Remédios,220680,PI,Nordeste,FIOCRUZ/ASTRAZENECA,1394,1300,94
Nossa Senhora Dos Remédios,220680,PI,Nordeste,BUTANTAN/SINOVAC,1169,596,573
Nossa Senhora Dos Remédios,220680,PI,Nordeste,PFIZER/BIONTECH,130,130,0
Nova Aliança,353280,SP,Sudeste,BUTANTAN/SINOVAC,1672,908,764
Nova Aliança,353280,SP,Sudeste,FIOCRUZ/ASTRAZENECA,1632,1470,162
Nova Aliança,353280,SP,Sudeste,PFIZER/BIONTECH,185,185,0
Nova Aliança Do Ivaí,411650,PR,Sul,FIOCRUZ/ASTRAZENECA,547,513,34
Nova Aliança Do Ivaí,411650,PR,Sul,BUTANTAN/SINOVAC,423,249,174
Nova Aliança Do Ivaí,411650,PR,Sul,PFIZER/BIONTECH,12,12,0
Nova Alvorada,431275,RS,Sul,BUTANTAN/SINOVAC,948,483,465
Nova Alvorada,431275,RS,Sul,FIOCRUZ/ASTRAZENECA,935,807,128
Nova Alvorada,431275,RS,Sul,PFIZER/BIONTECH,96,96,0
Nova Alvorada Do Sul,500600,MS,Centro-Oeste,FIOCRUZ/ASTRAZENECA,4001,3360,641
Nova Alvorada Do Sul,500600,MS,Centro-Oeste,BUTANTAN/SINOVAC,2012,1135,877
Nova Alvorada Do Sul,500600,MS,Centro-Oeste,PFIZER/BIONTECH,334,333,1
Nova América,521470,GO,Centro-Oeste,FIOCRUZ/ASTRAZENECA,943,853,90
Nova América,521470,GO,Centro-Oeste,BUTANTAN/SINOVAC,848,440,408
Nova América,521470,GO,Centro-Oeste,PFIZER/BIONTECH,6,6,0
Nova América Da Colina,411660,PR,Sul,FIOCRUZ/ASTRAZENECA,991,927,64
Nova América Da Colina,411660,PR,Sul,BUTANTAN/SINOVAC,706,369,337
Nova Andradina,500620,MS,Centro-Oeste,FIOCRUZ/ASTRAZENECA,13802,11531,2271
Nova Andradina,500620,MS,Centro-Oeste,BUTANTAN/SINOVAC,11055,5840,5215
Nova Andradina,500620,MS,Centro-Oeste,PFIZER/BIONTECH,1845,1844,1
Nova Araçá,431280,RS,Sul,FIOCRUZ/ASTRAZENECA,1227,1031,196
Nova Araçá,431280,RS,Sul,BUTANTAN/SINOVAC,1008,521,487
Nova Araçá,431280,RS,Sul,PFIZER/BIONTECH,150,150,0
Nova Aurora,411670,PR,Sul,FIOCRUZ/ASTRAZENECA,3124,2924,200
Nova Aurora,411670,PR,Sul,BUTANTAN/SINOVAC,2746,1440,1306
Nova Aurora,411670,PR,Sul,PFIZER/BIONTECH,154,154,0
Nova Aurora,521480,GO,Centro-Oeste,FIOCRUZ/ASTRAZENECA,820,692,128
Nova Aurora,521480,GO,Centro-Oeste,BUTANTAN/SINOVAC,483,243,240
Nova Aurora,521480,GO,Centro-Oeste,PFIZER/BIONTECH,6,6,0
Nova Bandeirantes,510615,MT,Centro-Oeste,BUTANTAN/SINOVAC,1709,979,730
Nova Bandeirantes,510615,MT,Centro-Oeste,FIOCRUZ/ASTRAZENECA,1380,1316,64
Nova Bandeirantes,510615,MT,Centro-Oeste,PFIZER/BIONTECH,69,69,0
Nova Bassano,431290,RS,Sul,BUTANTAN/SINOVAC,2776,1418,1358
Nova Bassano,431290,RS,Sul,FIOCRUZ/ASTRAZENECA,2599,2239,360
Nova Bassano,431290,RS,Sul,PFIZER/BIONTECH,226,226,0
Nova Belém,314467,MG,Sudeste,BUTANTAN/SINOVAC,790,399,391
Nova Belém,314467,MG,Sudeste,FIOCRUZ/ASTRAZENECA,716,647,69
Nova Belém,314467,MG,Sudeste,PFIZER/BIONTECH,83,83,0
Nova Boa Vista,431295,RS,Sul,BUTANTAN/SINOVAC,869,438,431
Nova Boa Vista,431295,RS,Sul,FIOCRUZ/ASTRAZENECA,520,470,50
Nova Boa Vista,431295,RS,Sul,PFIZER/BIONTECH,63,63,0
Nova Brasilândia,510620,MT,Centro-Oeste,BUTANTAN/SINOVAC,856,487,369
Nova Brasilândia,510620,MT,Centro-Oeste,FIOCRUZ/ASTRAZENECA,729,674,55
Nova Brasilândia D'Oeste,110014,RO,Norte,BUTANTAN/SINOVAC,3170,1650,1520
Nova Brasilândia D'Oeste,110014,RO,Norte,FIOCRUZ/ASTRAZENECA,2301,2207,94
Nova Brasilândia D'Oeste,110014,RO,Norte,PFIZER/BIONTECH,83,83,0
Nova Bréscia,431300,RS,Sul,BUTANTAN/SINOVAC,1352,679,673
Nova Bréscia,431300,RS,Sul,FIOCRUZ/ASTRAZENECA,988,838,150
Nova Bréscia,431300,RS,Sul,PFIZER/BIONTECH,125,125,0
Nova Campina,353282,SP,Sudeste,FIOCRUZ/ASTRAZENECA,1623,1541,82
Nova Campina,353282,SP,Sudeste,BUTANTAN/SINOVAC,1237,616,621
Nova Campina,353282,SP,Sudeste,PFIZER/BIONTECH,38,38,0
Nova Canaã,292270,BA,Nordeste,BUTANTAN/SINOVAC,4138,2450,1688
Nova Canaã,292270,BA,Nordeste,FIOCRUZ/ASTRAZENECA,1926,1761,165
Nova Canaã,292270,BA,Nordeste,PFIZER/BIONTECH,6,6,0
Nova Canaã Do Norte,510621,MT,Centro-Oeste,BUTANTAN/SINOVAC,2129,1087,1042
Nova Canaã Do Norte,510621,MT,Centro-Oeste,FIOCRUZ/ASTRAZENECA,2073,1995,78
Nova Canaã Do Norte,510621,MT,Centro-Oeste,PFIZER/BIONTECH,138,138,0
Nova Canaã Paulista,353284,SP,Sudeste,FIOCRUZ/ASTRAZENECA,1182,1077,105
Nova Canaã Paulista,353284,SP,Sudeste,BUTANTAN/SINOVAC,1167,666,501
Nova Canaã Paulista,353284,SP,Sudeste,PFIZER/BIONTECH,106,106,0
Nova Candelária,431301,RS,Sul,BUTANTAN/SINOVAC,881,445,436
Nova Candelária,431301,RS,Sul,FIOCRUZ/ASTRAZENECA,824,785,39
Nova Candelária,431301,RS,Sul,PFIZER/BIONTECH,110,110,0
Nova Cantu,411680,PR,Sul,FIOCRUZ/ASTRAZENECA,1742,1644,98
Nova Cantu,411680,PR,Sul,BUTANTAN/SINOVAC,1251,657,594
Nova Castilho,353286,SP,Sudeste,BUTANTAN/SINOVAC,688,319,369
Nova Castilho,353286,SP,Sudeste,FIOCRUZ/ASTRAZENECA,438,411,27
Nova Castilho,353286,SP,Sudeste,PFIZER/BIONTECH,68,68,0
Nova Colinas,210725,MA,Nordeste,FIOCRUZ/ASTRAZENECA,951,875,76
Nova Colinas,210725,MA,Nordeste,BUTANTAN/SINOVAC,947,487,460
Nova Crixás,521483,GO,Centro-Oeste,FIOCRUZ/ASTRAZENECA,2315,2251,64
Nova Crixás,521483,GO,Centro-Oeste,BUTANTAN/SINOVAC,2094,1087,1007
Nova Cruz,240830,RN,Nordeste,FIOCRUZ/ASTRAZENECA,7118,6526,592
Nova Cruz,240830,RN,Nordeste,BUTANTAN/SINOVAC,6541,3450,3091
Nova Cruz,240830,RN,Nordeste,PFIZER/BIONTECH,581,580,1
Nova Era,314470,MG,Sudeste,BUTANTAN/SINOVAC,3780,1931,1849
Nova Era,314470,MG,Sudeste,FIOCRUZ/ASTRAZENECA,3734,3404,330
Nova Era,314470,MG,Sudeste,PFIZER/BIONTECH,316,316,0
Nova Erechim,421140,SC,Sul,FIOCRUZ/ASTRAZENECA,1141,1042,99
Nova Erechim,421140,SC,Sul,BUTANTAN/SINOVAC,1000,511,489
Nova Esperança,411690,PR,Sul,BUTANTAN/SINOVAC,9049,5327,3722
Nova Esperança,411690,PR,Sul,FIOCRUZ/ASTRAZENECA,7713,7194,519
Nova Esperança,411690,PR,Sul,PFIZER/BIONTECH,307,307,0
Nova Esperança Do Piriá,150495,PA,Norte,FIOCRUZ/ASTRAZENECA,2798,2577,221
Nova Esperança Do Piriá,150495,PA,Norte,BUTANTAN/SINOVAC,1475,760,715
Nova Esperança Do Sudoeste,411695,PR,Sul,FIOCRUZ/ASTRAZENECA,1788,1692,96
Nova Esperança Do Sudoeste,411695,PR,Sul,BUTANTAN/SINOVAC,1138,593,545
Nova Esperança Do Sudoeste,411695,PR,Sul,PFIZER/BIONTECH,30,30,0
Nova Esperança Do Sul,431303,RS,Sul,FIOCRUZ/ASTRAZENECA,1428,1321,107
Nova Esperança Do Sul,431303,RS,Sul,BUTANTAN/SINOVAC,1282,642,640
Nova Esperança Do Sul,431303,RS,Sul,PFIZER/BIONTECH,214,214,0
Nova Europa,353290,SP,Sudeste,FIOCRUZ/ASTRAZENECA,2119,1974,145
Nova Europa,353290,SP,Sudeste,BUTANTAN/SINOVAC,1844,1000,844
Nova Europa,353290,SP,Sudeste,PFIZER/BIONTECH,210,210,0
Nova Fátima,292273,BA,Nordeste,BUTANTAN/SINOVAC,1906,986,920
Nova Fátima,292273,BA,Nordeste,FIOCRUZ/ASTRAZENECA,1731,1504,227
Nova Fátima,292273,BA,Nordeste,PFIZER/BIONTECH,186,186,0
Nova Fátima,411700,PR,Sul,FIOCRUZ/ASTRAZENECA,2093,1999,94
Nova Fátima,411700,PR,Sul,BUTANTAN/SINOVAC,1838,950,888
Nova Floresta,251010,PB,Nordeste,BUTANTAN/SINOVAC,2548,1287,1261
Nova Floresta,251010,PB,Nordeste,FIOCRUZ/ASTRAZENECA,1921,1736,185
Nova Floresta,251010,PB,Nordeste,PFIZER/BIONTECH,234,234,0
Nova Friburgo,330340,RJ,Sudeste,BUTANTAN/SINOVAC,23391,13843,9548
Nova Friburgo,330340,RJ,Sudeste,FIOCRUZ/ASTRAZENECA,16008,15599,409
Nova Friburgo,330340,RJ,Sudeste,PFIZER/BIONTECH,3,3,0
Nova Glória,521486,GO,Centro-Oeste,FIOCRUZ/ASTRAZENECA,2616,2445,171
Nova Glória,521486,GO,Centro-Oeste,BUTANTAN/SINOVAC,1528,781,747
Nova Granada,353300,SP,Sudeste,FIOCRUZ/ASTRAZENECA,4490,4083,407
Nova Granada,353300,SP,Sudeste,BUTANTAN/SINOVAC,4296,2283,2013
Nova Granada,353300,SP,Sudeste,PFIZER/BIONTECH,452,452,0
Nova Guarita,510880,MT,Centro-Oeste,BUTANTAN/SINOVAC,1262,735,527
Nova Guarita,510880,MT,Centro-Oeste,FIOCRUZ/ASTRAZENECA,1162,1096,66
Nova Guarita,510880,MT,Centro-Oeste,PFIZER/BIONTECH,64,64,0
Nova Guataporanga,353310,SP,Sudeste,FIOCRUZ/ASTRAZENECA,1053,966,87
Nova Guataporanga,353310,SP,Sudeste,BUTANTAN/SINOVAC,671,336,335
Nova Guataporanga,353310,SP,Sudeste,PFIZER/BIONTECH,73,73,0
Nova Hartz,431306,RS,Sul,FIOCRUZ/ASTRAZENECA,4337,4144,193
Nova Hartz,431306,RS,Sul,BUTANTAN/SINOVAC,3307,1679,1628
Nova Hartz,431306,RS,Sul,PFIZER/BIONTECH,670,670,0
Nova Ibiá,292275,BA,Nordeste,FIOCRUZ/ASTRAZENECA,1260,1153,107
Nova Ibiá,292275,BA,Nordeste,BUTANTAN/SINOVAC,1098,637,461
Nova Iguaçu,330350,RJ,Sudeste,BUTANTAN/SINOVAC,144283,79883,64400
Nova Iguaçu,330350,RJ,Sudeste,FIOCRUZ/ASTRAZENECA,71510,63196,8314
Nova Iguaçu,330350,RJ,Sudeste,PFIZER/BIONTECH,4366,4333,33
Nova Iguaçu De Goiás,521487,GO,Centro-Oeste,FIOCRUZ/ASTRAZENECA,986,886,100
Nova Iguaçu De Goiás,521487,GO,Centro-Oeste,BUTANTAN/SINOVAC,438,232,206
Nova Independência,353320,SP,Sudeste,BUTANTAN/SINOVAC,1168,731,437
Nova Independência,353320,SP,Sudeste,FIOCRUZ/ASTRAZENECA,808,726,82
Nova Independência,353320,SP,Sudeste,PFIZER/BIONTECH,94,94,0
Nova Iorque,210730,MA,Nordeste,BUTANTAN/SINOVAC,1133,637,496
Nova Iorque,210730,MA,Nordeste,FIOCRUZ/ASTRAZENECA,927,853,74
Nova Ipixuna,150497,PA,Norte,FIOCRUZ/ASTRAZENECA,2197,1912,285
Nova Ipixuna,150497,PA,Norte,BUTANTAN/SINOVAC,970,546,424
Nova Itaberaba,421145,SC,Sul,BUTANTAN/SINOVAC,1115,648,467
Nova Itaberaba,421145,SC,Sul,FIOCRUZ/ASTRAZENECA,779,727,52
Nova Itarana,292280,BA,Nordeste,FIOCRUZ/ASTRAZENECA,1873,1713,160
Nova Itarana,292280,BA,Nordeste,BUTANTAN/SINOVAC,1440,762,678
Nova Lacerda,510618,MT,Centro-Oeste,BUTANTAN/SINOVAC,815,405,410
Nova Lacerda,510618,MT,Centro-Oeste,FIOCRUZ/ASTRAZENECA,769,720,49
Nova Lacerda,510618,MT,Centro-Oeste,PFIZER/BIONTECH,12,12,0
Nova Laranjeiras,411705,PR,Sul,BUTANTAN/SINOVAC,4809,2486,2323
Nova Laranjeiras,411705,PR,Sul,FIOCRUZ/ASTRAZENECA,2046,1922,124
Nova Lima,314480,MG,Sudeste,BUTANTAN/SINOVAC,23621,12361,11260
Nova Lima,314480,MG,Sudeste,FIOCRUZ/ASTRAZENECA,20771,18762,2009
Nova Lima,314480,MG,Sudeste,PFIZER/BIONTECH,1962,1960,2
Nova Londrina,411710,PR,Sul,FIOCRUZ/ASTRAZENECA,3982,3723,259
Nova Londrina,411710,PR,Sul,BUTANTAN/SINOVAC,2959,1554,1405
Nova Luzitânia,353330,SP,Sudeste,BUTANTAN/SINOVAC,1054,573,481
Nova Luzitânia,353330,SP,Sudeste,FIOCRUZ/ASTRAZENECA,682,600,82
Nova Luzitânia,353330,SP,Sudeste,PFIZER/BIONTECH,59,59,0
Nova Mamoré,110033,RO,Norte,BUTANTAN/SINOVAC,3847,1993,1854
Nova Mamoré,110033,RO,Norte,FIOCRUZ/ASTRAZENECA,3566,3365,201
Nova Mamoré,110033,RO,Norte,PFIZER/BIONTECH,58,58,0
Nova Marilândia,510885,MT,Centro-Oeste,BUTANTAN/SINOVAC,637,324,313
Nova Marilândia,510885,MT,Centro-Oeste,FIOCRUZ/ASTRAZENECA,410,374,36
Nova Maringá,510890,MT,Centro-Oeste,BUTANTAN/SINOVAC,894,447,447
Nova Maringá,510890,MT,Centro-Oeste,FIOCRUZ/ASTRAZENECA,536,477,59
Nova Maringá,510890,MT,Centro-Oeste,PFIZER/BIONTECH,22,22,0
Nova Módica,314490,MG,Sudeste,BUTANTAN/SINOVAC,895,462,433
Nova Módica,314490,MG,Sudeste,FIOCRUZ/ASTRAZENECA,778,732,46
Nova Módica,314490,MG,Sudeste,PFIZER/BIONTECH,61,61,0
Nova Monte Verde,510895,MT,Centro-Oeste,BUTANTAN/SINOVAC,1703,881,822
Nova Monte Verde,510895,MT,Centro-Oeste,FIOCRUZ/ASTRAZENECA,1183,1128,55
Nova Monte Verde,510895,MT,Centro-Oeste,PFIZER/BIONTECH,1,1,0
Nova Mutum,510622,MT,Centro-Oeste,FIOCRUZ/ASTRAZENECA,4422,4051,371
Nova Mutum,510622,MT,Centro-Oeste,BUTANTAN/SINOVAC,3394,1772,1622
Nova Mutum,510622,MT,Centro-Oeste,PFIZER/BIONTECH,397,397,0
Nova Nazaré,510617,MT,Centro-Oeste,BUTANTAN/SINOVAC,666,336,330
Nova Nazaré,510617,MT,Centro-Oeste,FIOCRUZ/ASTRAZENECA,458,408,50
Nova Nazaré,510617,MT,Centro-Oeste,PFIZER/BIONTECH,89,89,0
Nova Odessa,353340,SP,Sudeste,FIOCRUZ/ASTRAZENECA,14101,13446,655
Nova Odessa,353340,SP,Sudeste,BUTANTAN/SINOVAC,10494,5101,5393
Nova Odessa,353340,SP,Sudeste,PFIZER/BIONTECH,880,880,0
Nova Olímpia,411720,PR,Sul,FIOCRUZ/ASTRAZENECA,1678,1553,125
Nova Olímpia,411720,PR,Sul,BUTANTAN/SINOVAC,1583,836,747
Nova Olímpia,510623,MT,Centro-Oeste,BUTANTAN/SINOVAC,2551,1376,1175
Nova Olímpia,510623,MT,Centro-Oeste,FIOCRUZ/ASTRAZENECA,1717,1638,79
Nova Olímpia,510623,MT,Centro-Oeste,PFIZER/BIONTECH,44,44,0
Nova Olinda,171488,TO,Norte,BUTANTAN/SINOVAC,1873,983,890
Nova Olinda,171488,TO,Norte,FIOCRUZ/ASTRAZENECA,1400,1323,77
Nova Olinda,230920,CE,Nordeste,BUTANTAN/SINOVAC,934,730,204
Nova Olinda,230920,CE,Nordeste,FIOCRUZ/ASTRAZENECA,225,223,2
Nova Olinda,251020,PB,Nordeste,BUTANTAN/SINOVAC,1443,725,718
Nova Olinda,251020,PB,Nordeste,FIOCRUZ/ASTRAZENECA,1090,998,92
Nova Olinda,251020,PB,Nordeste,PFIZER/BIONTECH,93,93,0
Nova Olinda Do Maranhão,210735,MA,Nordeste,FIOCRUZ/ASTRAZENECA,5445,4657,788
Nova Olinda Do Maranhão,210735,MA,Nordeste,BUTANTAN/SINOVAC,3405,1887,1518
Nova Olinda Do Norte,130310,AM,Norte,BUTANTAN/SINOVAC,1419,1000,419
Nova Olinda Do Norte,130310,AM,Norte,FIOCRUZ/ASTRAZENECA,1380,1380,0
Nova Pádua,431308,RS,Sul,BUTANTAN/SINOVAC,942,479,463
Nova Pádua,431308,RS,Sul,FIOCRUZ/ASTRAZENECA,785,633,152
Nova Pádua,431308,RS,Sul,PFIZER/BIONTECH,101,101,0
Nova Palma,431310,RS,Sul,BUTANTAN/SINOVAC,1888,958,930
Nova Palma,431310,RS,Sul,FIOCRUZ/ASTRAZENECA,1827,1651,176
Nova Palma,431310,RS,Sul,PFIZER/BIONTECH,221,221,0
Nova Palmeira,251030,PB,Nordeste,BUTANTAN/SINOVAC,1275,639,636
Nova Palmeira,251030,PB,Nordeste,FIOCRUZ/ASTRAZENECA,946,850,96
Nova Palmeira,251030,PB,Nordeste,PFIZER/BIONTECH,88,88,0
Nova Petrópolis,431320,RS,Sul,BUTANTAN/SINOVAC,6289,3193,3096
Nova Petrópolis,431320,RS,Sul,FIOCRUZ/ASTRAZENECA,5492,4616,876
Nova Petrópolis,431320,RS,Sul,PFIZER/BIONTECH,686,686,0
Nova Ponte,314500,MG,Sudeste,FIOCRUZ/ASTRAZENECA,2414,2266,148
Nova Ponte,314500,MG,Sudeste,BUTANTAN/SINOVAC,2075,1114,961
Nova Ponte,314500,MG,Sudeste,PFIZER/BIONTECH,261,261,0
Nova Porteirinha,314505,MG,Sudeste,FIOCRUZ/ASTRAZENECA,1487,1381,106
Nova Porteirinha,314505,MG,Sudeste,BUTANTAN/SINOVAC,1237,626,611
Nova Porteirinha,314505,MG,Sudeste,PFIZER/BIONTECH,90,90,0
Nova Prata,431330,RS,Sul,FIOCRUZ/ASTRAZENECA,5984,5507,477
Nova Prata,431330,RS,Sul,BUTANTAN/SINOVAC,5864,2967,2897
Nova Prata,431330,RS,Sul,PFIZER/BIONTECH,660,659,1
Nova Prata Do Iguaçu,411725,PR,Sul,BUTANTAN/SINOVAC,2363,1204,1159
Nova Prata Do Iguaçu,411725,PR,Sul,FIOCRUZ/ASTRAZENECA,2343,2188,155
Nova Prata Do Iguaçu,411725,PR,Sul,PFIZER/BIONTECH,138,138,0
Nova Ramada,431333,RS,Sul,BUTANTAN/SINOVAC,688,347,341
Nova Ramada,431333,RS,Sul,FIOCRUZ/ASTRAZENECA,679,588,91
Nova Ramada,431333,RS,Sul,PFIZER/BIONTECH,96,96,0
Nova Redenção,292285,BA,Nordeste,BUTANTAN/SINOVAC,1293,766,527
Nova Redenção,292285,BA,Nordeste,FIOCRUZ/ASTRAZENECA,549,548,1
Nova Resende,314510,MG,Sudeste,BUTANTAN/SINOVAC,3072,1557,1515
Nova Resende,314510,MG,Sudeste,FIOCRUZ/ASTRAZENECA,2825,2601,224
Nova Resende,314510,MG,Sudeste,PFIZER/BIONTECH,125,125,0
Nova Roma,521490,GO,Centro-Oeste,FIOCRUZ/ASTRAZENECA,1000,863,137
Nova Roma,521490,GO,Centro-Oeste,BUTANTAN/SINOVAC,266,147,119
Nova Roma Do Sul,431335,RS,Sul,BUTANTAN/SINOVAC,1086,550,536
Nova Roma Do Sul,431335,RS,Sul,FIOCRUZ/ASTRAZENECA,1024,848,176
Nova Roma Do Sul,431335,RS,Sul,PFIZER/BIONTECH,140,140,0
Nova Rosalândia,171500,TO,Norte,BUTANTAN/SINOVAC,951,497,454
Nova Rosalândia,171500,TO,Norte,FIOCRUZ/ASTRAZENECA,892,862,30
Nova Russas,230930,CE,Nordeste,BUTANTAN/SINOVAC,6503,3369,3134
Nova Russas,230930,CE,Nordeste,FIOCRUZ/ASTRAZENECA,2915,2343,572
Nova Santa Bárbara,411721,PR,Sul,FIOCRUZ/ASTRAZENECA,1491,1415,76
Nova Santa Bárbara,411721,PR,Sul,BUTANTAN/SINOVAC,1417,754,663
Nova Santa Helena,510619,MT,Centro-Oeste,BUTANTAN/SINOVAC,655,336,319
Nova Santa Helena,510619,MT,Centro-Oeste,FIOCRUZ/ASTRAZENECA,411,399,12
Nova Santa Helena,510619,MT,Centro-Oeste,PFIZER/BIONTECH,12,12,0
Nova Santa Rita,220795,PI,Nordeste,FIOCRUZ/ASTRAZENECA,744,636,108
Nova Santa Rita,220795,PI,Nordeste,BUTANTAN/SINOVAC,659,346,313
Nova Santa Rita,220795,PI,Nordeste,PFIZER/BIONTECH,36,36,0
Nova Santa Rita,431337,RS,Sul,FIOCRUZ/ASTRAZENECA,6381,6116,265
Nova Santa Rita,431337,RS,Sul,BUTANTAN/SINOVAC,5121,2610,2511
Nova Santa Rita,431337,RS,Sul,PFIZER/BIONTECH,939,938,1
Nova Santa Rosa,411722,PR,Sul,BUTANTAN/SINOVAC,2548,1318,1230
Nova Santa Rosa,411722,PR,Sul,FIOCRUZ/ASTRAZENECA,1731,1608,123
Nova Serrana,314520,MG,Sudeste,FIOCRUZ/ASTRAZENECA,8169,7612,557
Nova Serrana,314520,MG,Sudeste,BUTANTAN/SINOVAC,7743,3917,3826
Nova Serrana,314520,MG,Sudeste,PFIZER/BIONTECH,2073,2071,2
Nova Soure,292290,BA,Nordeste,BUTANTAN/SINOVAC,5016,2653,2363
Nova Soure,292290,BA,Nordeste,FIOCRUZ/ASTRAZENECA,4721,3980,741
Nova Soure,292290,BA,Nordeste,PFIZER/BIONTECH,348,348,0
Nova Tebas,411727,PR,Sul,FIOCRUZ/ASTRAZENECA,1697,1586,111
Nova Tebas,411727,PR,Sul,BUTANTAN/SINOVAC,1578,816,762
Nova Tebas,411727,PR,Sul,PFIZER/BIONTECH,6,6,0
Nova Timboteua,150500,PA,Norte,FIOCRUZ/ASTRAZENECA,3707,2874,833
Nova Timboteua,150500,PA,Norte,BUTANTAN/SINOVAC,2732,1437,1295
Nova Timboteua,150500,PA,Norte,PFIZER/BIONTECH,1,1,0
Nova Trento,421150,SC,Sul,BUTANTAN/SINOVAC,4418,2236,2182
Nova Trento,421150,SC,Sul,FIOCRUZ/ASTRAZENECA,3812,3591,221
Nova Trento,421150,SC,Sul,PFIZER/BIONTECH,2,2,0
Nova Ubiratã,510624,MT,Centro-Oeste,FIOCRUZ/ASTRAZENECA,1211,1089,122
Nova Ubiratã,510624,MT,Centro-Oeste,BUTANTAN/SINOVAC,1203,619,584
Nova Ubiratã,510624,MT,Centro-Oeste,PFIZER/BIONTECH,60,59,1
Nova União,110143,RO,Norte,FIOCRUZ/ASTRAZENECA,1741,1693,48
Nova União,110143,RO,Norte,BUTANTAN/SINOVAC,1414,847,567
Nova União,110143,RO,Norte,PFIZER/BIONTECH,108,108,0
Nova União,313660,MG,Sudeste,FIOCRUZ/ASTRAZENECA,1395,1252,143
Nova União,313660,MG,Sudeste,BUTANTAN/SINOVAC,1379,694,685
Nova União,313660,MG,Sudeste,PFIZER/BIONTECH,48,48,0
Nova Venécia,320390,ES,Sudeste,BUTANTAN/SINOVAC,11523,6051,5472
Nova Venécia,320390,ES,Sudeste,FIOCRUZ/ASTRAZENECA,9926,9460,466
Nova Venécia,320390,ES,Sudeste,PFIZER/BIONTECH,1645,1644,1
Nova Veneza,421160,SC,Sul,BUTANTAN/SINOVAC,3317,1714,1603
Nova Veneza,421160,SC,Sul,FIOCRUZ/ASTRAZENECA,3147,2941,206
Nova Veneza,421160,SC,Sul,PFIZER/BIONTECH,230,230,0
Nova Veneza,521500,GO,Centro-Oeste,FIOCRUZ/ASTRAZENECA,1912,1753,159
Nova Veneza,521500,GO,Centro-Oeste,BUTANTAN/SINOVAC,1628,841,787
Nova Viçosa,292300,BA,Nordeste,FIOCRUZ/ASTRAZENECA,2374,2313,61
Nova Viçosa,292300,BA,Nordeste,BUTANTAN/SINOVAC,1814,888,926
Nova Viçosa,292300,BA,Nordeste,PFIZER/BIONTECH,42,34,8
Nova Xavantina,510625,MT,Centro-Oeste,FIOCRUZ/ASTRAZENECA,4313,4161,152
Nova Xavantina,510625,MT,Centro-Oeste,BUTANTAN/SINOVAC,3992,2045,1947
Nova Xavantina,510625,MT,Centro-Oeste,PFIZER/BIONTECH,144,144,0
Novais,353325,SP,Sudeste,FIOCRUZ/ASTRAZENECA,1072,950,122
Novais,353325,SP,Sudeste,BUTANTAN/SINOVAC,1032,527,505
Novais,353325,SP,Sudeste,PFIZER/BIONTECH,34,34,0
Novo Acordo,171510,TO,Norte,BUTANTAN/SINOVAC,884,496,388
Novo Acordo,171510,TO,Norte,FIOCRUZ/ASTRAZENECA,571,536,35
Novo Airão,130320,AM,Norte,FIOCRUZ/ASTRAZENECA,3084,2551,533
Novo Airão,130320,AM,Norte,BUTANTAN/SINOVAC,1838,1044,794
Novo Alegre,171515,TO,Norte,FIOCRUZ/ASTRAZENECA,532,497,35
Novo Alegre,171515,TO,Norte,BUTANTAN/SINOVAC,489,245,244
Novo Aripuanã,130330,AM,Norte,FIOCRUZ/ASTRAZENECA,3465,2705,760
Novo Aripuanã,130330,AM,Norte,BUTANTAN/SINOVAC,2188,1189,999
Novo Barreiro,431349,RS,Sul,FIOCRUZ/ASTRAZENECA,1304,1200,104
Novo Barreiro,431349,RS,Sul,BUTANTAN/SINOVAC,1239,653,586
Novo Barreiro,431349,RS,Sul,PFIZER/BIONTECH,153,153,0
Novo Brasil,521520,GO,Centro-Oeste,FIOCRUZ/ASTRAZENECA,913,833,80
Novo Brasil,521520,GO,Centro-Oeste,BUTANTAN/SINOVAC,810,405,405
Novo Brasil,521520,GO,Centro-Oeste,PFIZER/BIONTECH,18,18,0
Novo Cabrais,431339,RS,Sul,FIOCRUZ/ASTRAZENECA,1174,1044,130
Novo Cabrais,431339,RS,Sul,BUTANTAN/SINOVAC,1113,594,519
Novo Cabrais,431339,RS,Sul,PFIZER/BIONTECH,167,166,1
Novo Cruzeiro,314530,MG,Sudeste,BUTANTAN/SINOVAC,4599,2365,2234
Novo Cruzeiro,314530,MG,Sudeste,FIOCRUZ/ASTRAZENECA,2946,2682,264
Novo Cruzeiro,314530,MG,Sudeste,PFIZER/BIONTECH,567,567,0
Novo Gama,521523,GO,Centro-Oeste,FIOCRUZ/ASTRAZENECA,12297,11663,634
Novo Gama,521523,GO,Centro-Oeste,BUTANTAN/SINOVAC,9069,4660,4409
Novo Hamburgo,431340,RS,Sul,BUTANTAN/SINOVAC,68752,35260,33492
Novo Hamburgo,431340,RS,Sul,FIOCRUZ/ASTRAZENECA,54804,50240,4564
Novo Hamburgo,431340,RS,Sul,PFIZER/BIONTECH,2581,2581,0
Novo Horizonte,292303,BA,Nordeste,BUTANTAN/SINOVAC,2054,1161,893
Novo Horizonte,292303,BA,Nordeste,FIOCRUZ/ASTRAZENECA,1241,1151,90
Novo Horizonte,353350,SP,Sudeste,FIOCRUZ/ASTRAZENECA,9230,8429,801
Novo Horizonte,353350,SP,Sudeste,BUTANTAN/SINOVAC,9006,4656,4350
Novo Horizonte,353350,SP,Sudeste,PFIZER/BIONTECH,727,727,0
Novo Horizonte,421165,SC,Sul,FIOCRUZ/ASTRAZENECA,732,678,54
Novo Horizonte,421165,SC,Sul,BUTANTAN/SINOVAC,638,344,294
Novo Horizonte Do Norte,510627,MT,Centro-Oeste,BUTANTAN/SINOVAC,874,446,428
Novo Horizonte Do Norte,510627,MT,Centro-Oeste,FIOCRUZ/ASTRAZENECA,689,638,51
Novo Horizonte Do Norte,510627,MT,Centro-Oeste,PFIZER/BIONTECH,48,48,0
Novo Horizonte Do Oeste,110050,RO,Norte,BUTANTAN/SINOVAC,1683,876,807
Novo Horizonte Do Oeste,110050,RO,Norte,FIOCRUZ/ASTRAZENECA,901,880,21
Novo Horizonte Do Sul,500625,MS,Centro-Oeste,BUTANTAN/SINOVAC,1034,535,499
Novo Horizonte Do Sul,500625,MS,Centro-Oeste,FIOCRUZ/ASTRAZENECA,1008,848,160
Novo Horizonte Do Sul,500625,MS,Centro-Oeste,PFIZER/BIONTECH,119,119,0
Novo Itacolomi,411729,PR,Sul,FIOCRUZ/ASTRAZENECA,1003,937,66
Novo Itacolomi,411729,PR,Sul,BUTANTAN/SINOVAC,774,400,374
Novo Jardim,171525,TO,Norte,FIOCRUZ/ASTRAZENECA,481,453,28
Novo Jardim,171525,TO,Norte,BUTANTAN/SINOVAC,398,200,198
Novo Lino,270560,AL,Nordeste,BUTANTAN/SINOVAC,1460,726,734
Novo Lino,270560,AL,Nordeste,FIOCRUZ/ASTRAZENECA,1428,1298,130
Novo Machado,431342,RS,Sul,BUTANTAN/SINOVAC,1122,574,548
Novo Machado,431342,RS,Sul,FIOCRUZ/ASTRAZENECA,1023,944,79
Novo Machado,431342,RS,Sul,PFIZER/BIONTECH,125,124,1
Novo Mundo,510626,MT,Centro-Oeste,BUTANTAN/SINOVAC,1808,1071,737
Novo Mundo,510626,MT,Centro-Oeste,FIOCRUZ/ASTRAZENECA,1310,1058,252
Novo Mundo,510626,MT,Centro-Oeste,PFIZER/BIONTECH,52,52,0
Novo Oriente,230940,CE,Nordeste,BUTANTAN/SINOVAC,4713,2774,1939
Novo Oriente,230940,CE,Nordeste,FIOCRUZ/ASTRAZENECA,2619,2410,209
Novo Oriente De Minas,314535,MG,Sudeste,BUTANTAN/SINOVAC,2406,1280,1126
Novo Oriente De Minas,314535,MG,Sudeste,FIOCRUZ/ASTRAZENECA,675,610,65
Novo Oriente De Minas,314535,MG,Sudeste,PFIZER/BIONTECH,155,155,0
Novo Oriente Do Piauí,220690,PI,Nordeste,BUTANTAN/SINOVAC,1335,678,657
Novo Oriente Do Piauí,220690,PI,Nordeste,FIOCRUZ/ASTRAZENECA,1068,961,107
Novo Planalto,521525,GO,Centro-Oeste,FIOCRUZ/ASTRAZENECA,1177,1113,64
Novo Planalto,521525,GO,Centro-Oeste,BUTANTAN/SINOVAC,682,346,336
Novo Progresso,150503,PA,Norte,FIOCRUZ/ASTRAZENECA,2761,2422,339
Novo Progresso,150503,PA,Norte,BUTANTAN/SINOVAC,2339,1248,1091
Novo Repartimento,150506,PA,Norte,FIOCRUZ/ASTRAZENECA,5785,5361,424
Novo Repartimento,150506,PA,Norte,BUTANTAN/SINOVAC,1967,1084,883
Novo Santo Antônio,220695,PI,Nordeste,FIOCRUZ/ASTRAZENECA,745,696,49
Novo Santo Antônio,220695,PI,Nordeste,BUTANTAN/SINOVAC,678,360,318
Novo Santo Antônio,220695,PI,Nordeste,PFIZER/BIONTECH,77,77,0
Novo Santo Antônio,510631,MT,Centro-Oeste,FIOCRUZ/ASTRAZENECA,482,428,54
Novo Santo Antônio,510631,MT,Centro-Oeste,BUTANTAN/SINOVAC,401,201,200
Novo Santo Antônio,510631,MT,Centro-Oeste,PFIZER/BIONTECH,15,15,0
Novo São Joaquim,510628,MT,Centro-Oeste,BUTANTAN/SINOVAC,934,472,462
Novo São Joaquim,510628,MT,Centro-Oeste,FIOCRUZ/ASTRAZENECA,809,773,36
Novo São Joaquim,510628,MT,Centro-Oeste,PFIZER/BIONTECH,6,6,0
Novo Tiradentes,431344,RS,Sul,BUTANTAN/SINOVAC,813,409,404
Novo Tiradentes,431344,RS,Sul,FIOCRUZ/ASTRAZENECA,524,495,29
Novo Tiradentes,431344,RS,Sul,PFIZER/BIONTECH,96,96,0
Novo Triunfo,292305,BA,Nordeste,FIOCRUZ/ASTRAZENECA,2533,2299,234
Novo Triunfo,292305,BA,Nordeste,BUTANTAN/SINOVAC,2069,1084,985
Novo Triunfo,292305,BA,Nordeste,PFIZER/BIONTECH,154,154,0
Novo Xingu,431346,RS,Sul,FIOCRUZ/ASTRAZENECA,574,523,51
Novo Xingu,431346,RS,Sul,BUTANTAN/SINOVAC,545,273,272
Novo Xingu,431346,RS,Sul,PFIZER/BIONTECH,66,65,1
Novorizonte,314537,MG,Sudeste,BUTANTAN/SINOVAC,1509,1038,471
Novorizonte,314537,MG,Sudeste,FIOCRUZ/ASTRAZENECA,285,284,1
Nuporanga,353360,SP,Sudeste,FIOCRUZ/ASTRAZENECA,1942,1806,136
Nuporanga,353360,SP,Sudeste,BUTANTAN/SINOVAC,1862,945,917
Nuporanga,353360,SP,Sudeste,PFIZER/BIONTECH,57,57,0
Óbidos,150510,PA,Norte,FIOCRUZ/ASTRAZENECA,17884,13562,4322
Óbidos,150510,PA,Norte,BUTANTAN/SINOVAC,3025,1725,1300
Ocara,230945,CE,Nordeste,BUTANTAN/SINOVAC,4036,2087,1949
Ocara,230945,CE,Nordeste,FIOCRUZ/ASTRAZENECA,2058,1830,228
Ocara,230945,CE,Nordeste,PFIZER/BIONTECH,2,1,1
Ocauçu,353370,SP,Sudeste,FIOCRUZ/ASTRAZENECA,1218,1116,102
Ocauçu,353370,SP,Sudeste,BUTANTAN/SINOVAC,1055,529,526
Ocauçu,353370,SP,Sudeste,PFIZER/BIONTECH,105,105,0
Oeiras,220700,PI,Nordeste,FIOCRUZ/ASTRAZENECA,8526,7416,1110
Oeiras,220700,PI,Nordeste,BUTANTAN/SINOVAC,6283,3177,3106
Oeiras,220700,PI,Nordeste,PFIZER/BIONTECH,25,25,0
Oeiras Do Pará,150520,PA,Norte,FIOCRUZ/ASTRAZENECA,4391,3995,396
Oeiras Do Pará,150520,PA,Norte,BUTANTAN/SINOVAC,2617,1412,1205
Oiapoque,160050,AP,Norte,BUTANTAN/SINOVAC,7814,4310,3504
Oiapoque,160050,AP,Norte,FIOCRUZ/ASTRAZENECA,750,662,88
Olaria,314540,MG,Sudeste,FIOCRUZ/ASTRAZENECA,703,663,40
Olaria,314540,MG,Sudeste,BUTANTAN/SINOVAC,615,310,305
Olaria,314540,MG,Sudeste,PFIZER/BIONTECH,47,47,0
Óleo,353380,SP,Sudeste,BUTANTAN/SINOVAC,869,441,428
Óleo,353380,SP,Sudeste,FIOCRUZ/ASTRAZENECA,655,600,55
Olho D'Água,251040,PB,Nordeste,BUTANTAN/SINOVAC,1510,763,747
Olho D'Água,251040,PB,Nordeste,FIOCRUZ/ASTRAZENECA,838,794,44
Olho D'Água,251040,PB,Nordeste,PFIZER/BIONTECH,72,72,0
Olho D'Água Das Cunhãs,210740,MA,Nordeste,FIOCRUZ/ASTRAZENECA,4507,4254,253
Olho D'Água Das Cunhãs,210740,MA,Nordeste,BUTANTAN/SINOVAC,3184,1697,1487
Olho D'Água Das Flores,270570,AL,Nordeste,FIOCRUZ/ASTRAZENECA,5012,4735,277
Olho D'Água Das Flores,270570,AL,Nordeste,BUTANTAN/SINOVAC,3402,1781,1621
Olho D'Água Do Casado,270580,AL,Nordeste,FIOCRUZ/ASTRAZENECA,1924,1792,132
Olho D'Água Do Casado,270580,AL,Nordeste,BUTANTAN/SINOVAC,1205,664,541
Olho D'Água Do Piauí,220710,PI,Nordeste,BUTANTAN/SINOVAC,687,353,334
Olho D'Água Do Piauí,220710,PI,Nordeste,FIOCRUZ/ASTRAZENECA,504,462,42
Olho D'Água Do Piauí,220710,PI,Nordeste,PFIZER/BIONTECH,61,61,0
Olho D'Água Grande,270590,AL,Nordeste,BUTANTAN/SINOVAC,882,454,428
Olho D'Água Grande,270590,AL,Nordeste,FIOCRUZ/ASTRAZENECA,746,715,31
Olho-D'Água Do Borges,240840,RN,Nordeste,BUTANTAN/SINOVAC,1656,898,758
Olho-D'Água Do Borges,240840,RN,Nordeste,FIOCRUZ/ASTRAZENECA,1468,1368,100
Olho-D'Água Do Borges,240840,RN,Nordeste,PFIZER/BIONTECH,95,95,0
Olhos-D'Água,314545,MG,Sudeste,FIOCRUZ/ASTRAZENECA,1371,1282,89
Olhos-D'Água,314545,MG,Sudeste,BUTANTAN/SINOVAC,734,389,345
Olhos-D'Água,314545,MG,Sudeste,PFIZER/BIONTECH,63,63,0
Olímpia,353390,SP,Sudeste,BUTANTAN/SINOVAC,13335,7178,6157
Olímpia,353390,SP,Sudeste,FIOCRUZ/ASTRAZENECA,12230,11148,1082
Olímpia,353390,SP,Sudeste,PFIZER/BIONTECH,861,861,0
Olímpio Noronha,314550,MG,Sudeste,FIOCRUZ/ASTRAZENECA,869,812,57
Olímpio Noronha,314550,MG,Sudeste,BUTANTAN/SINOVAC,641,325,316
Olímpio Noronha,314550,MG,Sudeste,PFIZER/BIONTECH,18,18,0
Olinda,260960,PE,Nordeste,BUTANTAN/SINOVAC,68216,35246,32970
Olinda,260960,PE,Nordeste,FIOCRUZ/ASTRAZENECA,34395,29122,5273
Olinda,260960,PE,Nordeste,PFIZER/BIONTECH,4264,4249,15
Olinda Nova Do Maranhão,210745,MA,Nordeste,FIOCRUZ/ASTRAZENECA,3052,2919,133
Olinda Nova Do Maranhão,210745,MA,Nordeste,BUTANTAN/SINOVAC,1759,923,836
Olindina,292310,BA,Nordeste,FIOCRUZ/ASTRAZENECA,4815,4395,420
Olindina,292310,BA,Nordeste,BUTANTAN/SINOVAC,4469,2265,2204
Olindina,292310,BA,Nordeste,PFIZER/BIONTECH,229,227,2
Olivedos,251050,PB,Nordeste,BUTANTAN/SINOVAC,911,463,448
Olivedos,251050,PB,Nordeste,FIOCRUZ/ASTRAZENECA,631,546,85
Olivedos,251050,PB,Nordeste,PFIZER/BIONTECH,47,47,0
Oliveira,314560,MG,Sudeste,BUTANTAN/SINOVAC,9349,4890,4459
Oliveira,314560,MG,Sudeste,FIOCRUZ/ASTRAZENECA,8195,7443,752
Oliveira,314560,MG,Sudeste,PFIZER/BIONTECH,921,921,0
Oliveira De Fátima,171550,TO,Norte,BUTANTAN/SINOVAC,269,135,134
Oliveira De Fátima,171550,TO,Norte,FIOCRUZ/ASTRAZENECA,232,213,19
Oliveira Dos Brejinhos,292320,BA,Nordeste,BUTANTAN/SINOVAC,4687,2518,2169
Oliveira Dos Brejinhos,292320,BA,Nordeste,FIOCRUZ/ASTRAZENECA,4001,3886,115
Oliveira Fortes,314570,MG,Sudeste,FIOCRUZ/ASTRAZENECA,466,447,19
Oliveira Fortes,314570,MG,Sudeste,BUTANTAN/SINOVAC,444,248,196
Olivença,270600,AL,Nordeste,FIOCRUZ/ASTRAZENECA,2005,1774,231
Olivença,270600,AL,Nordeste,BUTANTAN/SINOVAC,1867,946,921
Onça De Pitangui,314580,MG,Sudeste,FIOCRUZ/ASTRAZENECA,563,536,27
Onça De Pitangui,314580,MG,Sudeste,BUTANTAN/SINOVAC,532,330,202
Onça De Pitangui,314580,MG,Sudeste,PFIZER/BIONTECH,34,34,0
Onda Verde,353400,SP,Sudeste,FIOCRUZ/ASTRAZENECA,1316,1210,106
Onda Verde,353400,SP,Sudeste,BUTANTAN/SINOVAC,1121,587,534
Onda Verde,353400,SP,Sudeste,PFIZER/BIONTECH,53,53,0
Oratórios,314585,MG,Sudeste,FIOCRUZ/ASTRAZENECA,1308,1230,78
Oratórios,314585,MG,Sudeste,BUTANTAN/SINOVAC,1296,682,614
Oratórios,314585,MG,Sudeste,PFIZER/BIONTECH,64,64,0
Oriente,353410,SP,Sudeste,BUTANTAN/SINOVAC,1612,861,751
Oriente,353410,SP,Sudeste,FIOCRUZ/ASTRAZENECA,1538,1365,173
Oriente,353410,SP,Sudeste,PFIZER/BIONTECH,201,201,0
Orindiúva,353420,SP,Sudeste,FIOCRUZ/ASTRAZENECA,1580,1477,103
Orindiúva,353420,SP,Sudeste,BUTANTAN/SINOVAC,983,531,452
Orindiúva,353420,SP,Sudeste,PFIZER/BIONTECH,219,219,0
Oriximiná,150530,PA,Norte,FIOCRUZ/ASTRAZENECA,17006,14883,2123
Oriximiná,150530,PA,Norte,BUTANTAN/SINOVAC,5816,3340,2476
Orizânia,314587,MG,Sudeste,FIOCRUZ/ASTRAZENECA,1323,1244,79
Orizânia,314587,MG,Sudeste,BUTANTAN/SINOVAC,1202,628,574
Orizânia,314587,MG,Sudeste,PFIZER/BIONTECH,16,16,0
Orizona,521530,GO,Centro-Oeste,FIOCRUZ/ASTRAZENECA,4926,4574,352
Orizona,521530,GO,Centro-Oeste,BUTANTAN/SINOVAC,3645,2030,1615
Orlândia,353430,SP,Sudeste,BUTANTAN/SINOVAC,9157,4874,4283
Orlândia,353430,SP,Sudeste,FIOCRUZ/ASTRAZENECA,7423,6656,767
Orlândia,353430,SP,Sudeste,PFIZER/BIONTECH,318,318,0
Orleans,421170,SC,Sul,FIOCRUZ/ASTRAZENECA,6461,5930,531
Orleans,421170,SC,Sul,BUTANTAN/SINOVAC,4828,2653,2175
Orleans,421170,SC,Sul,PFIZER/BIONTECH,471,471,0
Orobó,260970,PE,Nordeste,FIOCRUZ/ASTRAZENECA,5487,4935,552
Orobó,260970,PE,Nordeste,BUTANTAN/SINOVAC,4191,2167,2024
Orobó,260970,PE,Nordeste,PFIZER/BIONTECH,163,163,0
Orocó,260980,PE,Nordeste,FIOCRUZ/ASTRAZENECA,4766,4407,359
Orocó,260980,PE,Nordeste,BUTANTAN/SINOVAC,2177,1116,1061
Orocó,260980,PE,Nordeste,PFIZER/BIONTECH,132,132,0
Orós,230950,CE,Nordeste,BUTANTAN/SINOVAC,4144,2461,1683
Orós,230950,CE,Nordeste,FIOCRUZ/ASTRAZENECA,2459,2202,257
Orós,230950,CE,Nordeste,PFIZER/BIONTECH,33,33,0
Ortigueira,411730,PR,Sul,FIOCRUZ/ASTRAZENECA,5473,5249,224
Ortigueira,411730,PR,Sul,BUTANTAN/SINOVAC,4873,2687,2186
Osasco,353440,SP,Sudeste,FIOCRUZ/ASTRAZENECA,147248,135475,11773
Osasco,353440,SP,Sudeste,BUTANTAN/SINOVAC,123860,68213,55647
Osasco,353440,SP,Sudeste,PFIZER/BIONTECH,10986,10958,28
Oscar Bressane,353450,SP,Sudeste,BUTANTAN/SINOVAC,922,517,405
Oscar Bressane,353450,SP,Sudeste,FIOCRUZ/ASTRAZENECA,679,588,91
Oscar Bressane,353450,SP,Sudeste,PFIZER/BIONTECH,60,60,0
Osório,431350,RS,Sul,FIOCRUZ/ASTRAZENECA,13518,12510,1008
Osório,431350,RS,Sul,BUTANTAN/SINOVAC,13401,6932,6469
Osório,431350,RS,Sul,PFIZER/BIONTECH,1197,1197,0
Osvaldo Cruz,353460,SP,Sudeste,BUTANTAN/SINOVAC,9264,4770,4494
Osvaldo Cruz,353460,SP,Sudeste,FIOCRUZ/ASTRAZENECA,7827,7021,806
Osvaldo Cruz,353460,SP,Sudeste,PFIZER/BIONTECH,355,355,0
Otacílio Costa,421175,SC,Sul,FIOCRUZ/ASTRAZENECA,4914,4560,354
Otacílio Costa,421175,SC,Sul,BUTANTAN/SINOVAC,3255,1849,1406
Otacílio Costa,421175,SC,Sul,PFIZER/BIONTECH,170,170,0
Ourém,150540,PA,Norte,FIOCRUZ/ASTRAZENECA,3070,2183,887
Ourém,150540,PA,Norte,BUTANTAN/SINOVAC,2096,1076,1020
Ouriçangas,292330,BA,Nordeste,BUTANTAN/SINOVAC,1871,1083,788
Ouriçangas,292330,BA,Nordeste,FIOCRUZ/ASTRAZENECA,1864,1777,87
Ouriçangas,292330,BA,Nordeste,PFIZER/BIONTECH,186,185,1
Ouricuri,260990,PE,Nordeste,BUTANTAN/SINOVAC,12316,6534,5782
Ouricuri,260990,PE,Nordeste,FIOCRUZ/ASTRAZENECA,11023,10180,843
Ouricuri,260990,PE,Nordeste,PFIZER/BIONTECH,1447,1370,77
Ourilândia Do Norte,150543,PA,Norte,BUTANTAN/SINOVAC,3181,1741,1440
Ourilândia Do Norte,150543,PA,Norte,FIOCRUZ/ASTRAZENECA,1810,1639,171
Ourinhos,353470,SP,Sudeste,FIOCRUZ/ASTRAZENECA,29109,27162,1947
Ourinhos,353470,SP,Sudeste,BUTANTAN/SINOVAC,27066,14438,12628
Ourinhos,353470,SP,Sudeste,PFIZER/BIONTECH,2747,2747,0
Ourizona,411740,PR,Sul,FIOCRUZ/ASTRAZENECA,1416,1344,72
Ourizona,411740,PR,Sul,BUTANTAN/SINOVAC,910,473,437
Ourizona,411740,PR,Sul,PFIZER/BIONTECH,17,16,1
Ouro,421180,SC,Sul,FIOCRUZ/ASTRAZENECA,1851,1755,96
Ouro,421180,SC,Sul,BUTANTAN/SINOVAC,1796,937,859
Ouro,421180,SC,Sul,PFIZER/BIONTECH,90,89,1
Ouro Branco,240850,RN,Nordeste,BUTANTAN/SINOVAC,1187,578,609
Ouro Branco,240850,RN,Nordeste,FIOCRUZ/ASTRAZENECA,1031,931,100
Ouro Branco,240850,RN,Nordeste,PFIZER/BIONTECH,119,119,0
Ouro Branco,270610,AL,Nordeste,BUTANTAN/SINOVAC,2093,1150,943
Ouro Branco,270610,AL,Nordeste,FIOCRUZ/ASTRAZENECA,1945,1710,235
Ouro Branco,314590,MG,Sudeste,BUTANTAN/SINOVAC,3602,2250,1352
Ouro Branco,314590,MG,Sudeste,FIOCRUZ/ASTRAZENECA,1241,962,279
Ouro Fino,314600,MG,Sudeste,BUTANTAN/SINOVAC,6457,3777,2680
Ouro Fino,314600,MG,Sudeste,FIOCRUZ/ASTRAZENECA,6006,5714,292
Ouro Fino,314600,MG,Sudeste,PFIZER/BIONTECH,99,99,0
Ouro Preto,314610,MG,Sudeste,BUTANTAN/SINOVAC,15351,7786,7565
Ouro Preto,314610,MG,Sudeste,FIOCRUZ/ASTRAZENECA,14905,14033,872
Ouro Preto,314610,MG,Sudeste,PFIZER/BIONTECH,2387,2382,5
Ouro Preto Do Oeste,110015,RO,Norte,BUTANTAN/SINOVAC,5995,3508,2487
Ouro Preto Do Oeste,110015,RO,Norte,FIOCRUZ/ASTRAZENECA,5664,5472,192
Ouro Preto Do Oeste,110015,RO,Norte,PFIZER/BIONTECH,617,616,1
Ouro Velho,251060,PB,Nordeste,BUTANTAN/SINOVAC,822,427,395
Ouro Velho,251060,PB,Nordeste,FIOCRUZ/ASTRAZENECA,666,616,50
Ouro Velho,251060,PB,Nordeste,PFIZER/BIONTECH,72,72,0
Ouro Verde,353480,SP,Sudeste,BUTANTAN/SINOVAC,2326,1232,1094
Ouro Verde,353480,SP,Sudeste,FIOCRUZ/ASTRAZENECA,2281,1893,388
Ouro Verde,353480,SP,Sudeste,PFIZER/BIONTECH,50,49,1
Ouro Verde,421185,SC,Sul,BUTANTAN/SINOVAC,569,309,260
Ouro Verde,421185,SC,Sul,FIOCRUZ/ASTRAZENECA,526,464,62
Ouro Verde,421185,SC,Sul,PFIZER/BIONTECH,7,7,0
Ouro Verde De Goiás,521540,GO,Centro-Oeste,FIOCRUZ/ASTRAZENECA,1182,1108,74
Ouro Verde De Goiás,521540,GO,Centro-Oeste,BUTANTAN/SINOVAC,740,436,304
Ouro Verde De Minas,314620,MG,Sudeste,BUTANTAN/SINOVAC,1459,847,612
Ouro Verde De Minas,314620,MG,Sudeste,FIOCRUZ/ASTRAZENECA,1120,1105,15
Ouro Verde Do Oeste,411745,PR,Sul,FIOCRUZ/ASTRAZENECA,1325,1244,81
Ouro Verde Do Oeste,411745,PR,Sul,BUTANTAN/SINOVAC,1181,603,578
Ouro Verde Do Oeste,411745,PR,Sul,PFIZER/BIONTECH,11,11,0
Ouroeste,353475,SP,Sudeste,FIOCRUZ/ASTRAZENECA,2689,2473,216
Ouroeste,353475,SP,Sudeste,BUTANTAN/SINOVAC,2608,1376,1232
Ouroeste,353475,SP,Sudeste,PFIZER/BIONTECH,238,238,0
Ourolândia,292335,BA,Nordeste,FIOCRUZ/ASTRAZENECA,2690,2273,417
Ourolândia,292335,BA,Nordeste,BUTANTAN/SINOVAC,2399,1337,1062
Ouvidor,521550,GO,Centro-Oeste,FIOCRUZ/ASTRAZENECA,2185,1884,301
Ouvidor,521550,GO,Centro-Oeste,BUTANTAN/SINOVAC,1240,624,616
Ouvidor,521550,GO,Centro-Oeste,PFIZER/BIONTECH,90,90,0
Pacaembu,353490,SP,Sudeste,BUTANTAN/SINOVAC,4220,2382,1838
Pacaembu,353490,SP,Sudeste,FIOCRUZ/ASTRAZENECA,2585,2233,352
Pacaembu,353490,SP,Sudeste,PFIZER/BIONTECH,112,112,0
Pacajá,150548,PA,Norte,FIOCRUZ/ASTRAZENECA,4080,3119,961
Pacajá,150548,PA,Norte,BUTANTAN/SINOVAC,3550,1927,1623
Pacajus,230960,CE,Nordeste,BUTANTAN/SINOVAC,9695,5039,4656
Pacajus,230960,CE,Nordeste,FIOCRUZ/ASTRAZENECA,5226,4666,560
Pacaraima,140045,RR,Norte,BUTANTAN/SINOVAC,6163,3453,2710
Pacaraima,140045,RR,Norte,FIOCRUZ/ASTRAZENECA,820,818,2
Pacatuba,230970,CE,Nordeste,BUTANTAN/SINOVAC,9380,4812,4568
Pacatuba,230970,CE,Nordeste,FIOCRUZ/ASTRAZENECA,6167,5474,693
Pacatuba,280490,SE,Nordeste,FIOCRUZ/ASTRAZENECA,2427,2283,144
Pacatuba,280490,SE,Nordeste,BUTANTAN/SINOVAC,2218,1136,1082
Pacatuba,280490,SE,Nordeste,PFIZER/BIONTECH,261,261,0
Paço Do Lumiar,210750,MA,Nordeste,FIOCRUZ/ASTRAZENECA,44028,42938,1090
Paço Do Lumiar,210750,MA,Nordeste,BUTANTAN/SINOVAC,11937,6044,5893
Paço Do Lumiar,210750,MA,Nordeste,PFIZER/BIONTECH,534,533,1
Pacoti,230980,CE,Nordeste,BUTANTAN/SINOVAC,1512,814,698
Pacoti,230980,CE,Nordeste,FIOCRUZ/ASTRAZENECA,821,751,70
Pacoti,230980,CE,Nordeste,PFIZER/BIONTECH,1,1,0
Pacujá,230990,CE,Nordeste,BUTANTAN/SINOVAC,1296,683,613
Pacujá,230990,CE,Nordeste,FIOCRUZ/ASTRAZENECA,840,778,62
Padre Bernardo,521560,GO,Centro-Oeste,FIOCRUZ/ASTRAZENECA,7015,5951,1064
Padre Bernardo,521560,GO,Centro-Oeste,BUTANTAN/SINOVAC,3544,1848,1696
Padre Carvalho,314625,MG,Sudeste,FIOCRUZ/ASTRAZENECA,883,846,37
Padre Carvalho,314625,MG,Sudeste,BUTANTAN/SINOVAC,796,422,374
Padre Carvalho,314625,MG,Sudeste,PFIZER/BIONTECH,18,18,0
Padre Marcos,220720,PI,Nordeste,BUTANTAN/SINOVAC,1286,652,634
Padre Marcos,220720,PI,Nordeste,FIOCRUZ/ASTRAZENECA,634,537,97
Padre Paraíso,314630,MG,Sudeste,BUTANTAN/SINOVAC,4112,2157,1955
Padre Paraíso,314630,MG,Sudeste,FIOCRUZ/ASTRAZENECA,2347,2135,212
Paes Landim,220730,PI,Nordeste,BUTANTAN/SINOVAC,986,524,462
Paes Landim,220730,PI,Nordeste,FIOCRUZ/ASTRAZENECA,738,684,54
Pai Pedro,314655,MG,Sudeste,FIOCRUZ/ASTRAZENECA,1548,1505,43
Pai Pedro,314655,MG,Sudeste,BUTANTAN/SINOVAC,1062,544,518
Pai Pedro,314655,MG,Sudeste,PFIZER/BIONTECH,25,25,0
Paial,421187,SC,Sul,BUTANTAN/SINOVAC,613,320,293
Paial,421187,SC,Sul,FIOCRUZ/ASTRAZENECA,469,419,50
Paiçandu,411750,PR,Sul,FIOCRUZ/ASTRAZENECA,8558,8082,476
Paiçandu,411750,PR,Sul,BUTANTAN/SINOVAC,7630,3930,3700
Paiçandu,411750,PR,Sul,PFIZER/BIONTECH,54,54,0
Paim Filho,431360,RS,Sul,BUTANTAN/SINOVAC,1362,687,675
Paim Filho,431360,RS,Sul,FIOCRUZ/ASTRAZENECA,1255,1040,215
Paim Filho,431360,RS,Sul,PFIZER/BIONTECH,157,157,0
Paineiras,314640,MG,Sudeste,BUTANTAN/SINOVAC,1362,695,667
Paineiras,314640,MG,Sudeste,FIOCRUZ/ASTRAZENECA,1187,1085,102
Paineiras,314640,MG,Sudeste,PFIZER/BIONTECH,77,77,0
Painel,421189,SC,Sul,FIOCRUZ/ASTRAZENECA,879,806,73
Painel,421189,SC,Sul,BUTANTAN/SINOVAC,631,359,272
Pains,314650,MG,Sudeste,BUTANTAN/SINOVAC,2851,1573,1278
Pains,314650,MG,Sudeste,FIOCRUZ/ASTRAZENECA,2138,1939,199
Pains,314650,MG,Sudeste,PFIZER/BIONTECH,292,292,0
Paiva,314660,MG,Sudeste,FIOCRUZ/ASTRAZENECA,652,496,156
Paiva,314660,MG,Sudeste,BUTANTAN/SINOVAC,493,262,231
Paiva,314660,MG,Sudeste,PFIZER/BIONTECH,30,30,0
Pajeú Do Piauí,220735,PI,Nordeste,BUTANTAN/SINOVAC,926,477,449
Pajeú Do Piauí,220735,PI,Nordeste,FIOCRUZ/ASTRAZENECA,505,450,55
Palestina,270620,AL,Nordeste,FIOCRUZ/ASTRAZENECA,1450,1351,99
Palestina,270620,AL,Nordeste,BUTANTAN/SINOVAC,913,475,438
Palestina,353500,SP,Sudeste,BUTANTAN/SINOVAC,3446,1795,1651
Palestina,353500,SP,Sudeste,FIOCRUZ/ASTRAZENECA,2246,1991,255
Palestina De Goiás,521565,GO,Centro-Oeste,BUTANTAN/SINOVAC,742,416,326
Palestina De Goiás,521565,GO,Centro-Oeste,FIOCRUZ/ASTRAZENECA,707,662,45
Palestina Do Pará,150549,PA,Norte,FIOCRUZ/ASTRAZENECA,955,877,78
Palestina Do Pará,150549,PA,Norte,BUTANTAN/SINOVAC,419,227,192
Palhano,231000,CE,Nordeste,BUTANTAN/SINOVAC,1955,1006,949
Palhano,231000,CE,Nordeste,FIOCRUZ/ASTRAZENECA,1719,1541,178
Palhano,231000,CE,Nordeste,PFIZER/BIONTECH,1,1,0
Palhoça,421190,SC,Sul,FIOCRUZ/ASTRAZENECA,32608,28986,3622
Palhoça,421190,SC,Sul,BUTANTAN/SINOVAC,29320,16156,13164
Palhoça,421190,SC,Sul,PFIZER/BIONTECH,12862,12862,0
Palma,314670,MG,Sudeste,BUTANTAN/SINOVAC,1492,917,575
Palma,314670,MG,Sudeste,FIOCRUZ/ASTRAZENECA,861,819,42
Palma Sola,421200,SC,Sul,FIOCRUZ/ASTRAZENECA,1840,1693,147
Palma Sola,421200,SC,Sul,BUTANTAN/SINOVAC,1573,848,725
Palma Sola,421200,SC,Sul,PFIZER/BIONTECH,152,152,0
Palmácia,231010,CE,Nordeste,BUTANTAN/SINOVAC,2553,1316,1237
Palmácia,231010,CE,Nordeste,FIOCRUZ/ASTRAZENECA,1839,1627,212
Palmácia,231010,CE,Nordeste,PFIZER/BIONTECH,35,35,0
Palmares,261000,PE,Nordeste,BUTANTAN/SINOVAC,11291,5828,5463
Palmares,261000,PE,Nordeste,FIOCRUZ/ASTRAZENECA,9026,8388,638
Palmares,261000,PE,Nordeste,PFIZER/BIONTECH,486,483,3
Palmares Do Sul,431365,RS,Sul,BUTANTAN/SINOVAC,4505,2409,2096
Palmares Do Sul,431365,RS,Sul,FIOCRUZ/ASTRAZENECA,3148,2961,187
Palmares Do Sul,431365,RS,Sul,PFIZER/BIONTECH,281,281,0
Palmares Paulista,353510,SP,Sudeste,FIOCRUZ/ASTRAZENECA,1793,1682,111
Palmares Paulista,353510,SP,Sudeste,BUTANTAN/SINOVAC,1453,746,707
Palmares Paulista,353510,SP,Sudeste,PFIZER/BIONTECH,93,93,0
Palmas,172100,TO,Norte,BUTANTAN/SINOVAC,38584,20439,18145
Palmas,172100,TO,Norte,FIOCRUZ/ASTRAZENECA,34348,33147,1201
Palmas,172100,TO,Norte,PFIZER/BIONTECH,18551,18531,20
Palmas,411760,PR,Sul,FIOCRUZ/ASTRAZENECA,10001,9228,773
Palmas,411760,PR,Sul,BUTANTAN/SINOVAC,6805,3603,3202
Palmas,411760,PR,Sul,PFIZER/BIONTECH,478,476,2
Palmas De Monte Alto,292340,BA,Nordeste,FIOCRUZ/ASTRAZENECA,6176,5838,338
Palmas De Monte Alto,292340,BA,Nordeste,BUTANTAN/SINOVAC,3999,2092,1907
Palmas De Monte Alto,292340,BA,Nordeste,PFIZER/BIONTECH,67,67,0
Palmeira,411770,PR,Sul,BUTANTAN/SINOVAC,6040,3109,2931
Palmeira,411770,PR,Sul,FIOCRUZ/ASTRAZENECA,4871,4572,299
Palmeira,421205,SC,Sul,FIOCRUZ/ASTRAZENECA,756,644,112
Palmeira,421205,SC,Sul,BUTANTAN/SINOVAC,674,370,304
Palmeira,421205,SC,Sul,PFIZER/BIONTECH,6,6,0
Palmeira D'Oeste,353520,SP,Sudeste,FIOCRUZ/ASTRAZENECA,3227,2941,286
Palmeira D'Oeste,353520,SP,Sudeste,BUTANTAN/SINOVAC,2945,1579,1366
Palmeira D'Oeste,353520,SP,Sudeste,PFIZER/BIONTECH,198,198,0
Palmeira Das Missões,431370,RS,Sul,FIOCRUZ/ASTRAZENECA,9243,8410,833
Palmeira Das Missões,431370,RS,Sul,BUTANTAN/SINOVAC,8500,4311,4189
Palmeira Das Missões,431370,RS,Sul,PFIZER/BIONTECH,1367,1367,0
Palmeira Do Piauí,220740,PI,Nordeste,BUTANTAN/SINOVAC,881,447,434
Palmeira Do Piauí,220740,PI,Nordeste,FIOCRUZ/ASTRAZENECA,852,771,81
Palmeira Dos Índios,270630,AL,Nordeste,FIOCRUZ/ASTRAZENECA,17056,14621,2435
Palmeira Dos Índios,270630,AL,Nordeste,BUTANTAN/SINOVAC,15834,8326,7508
Palmeira Dos Índios,270630,AL,Nordeste,PFIZER/BIONTECH,1238,1223,15
Palmeirais,220750,PI,Nordeste,BUTANTAN/SINOVAC,2296,1467,829
Palmeirais,220750,PI,Nordeste,FIOCRUZ/ASTRAZENECA,1783,1767,16
Palmeirândia,210760,MA,Nordeste,FIOCRUZ/ASTRAZENECA,4680,4399,281
Palmeirândia,210760,MA,Nordeste,BUTANTAN/SINOVAC,3310,1807,1503
Palmeirante,171570,TO,Norte,BUTANTAN/SINOVAC,928,474,454
Palmeirante,171570,TO,Norte,FIOCRUZ/ASTRAZENECA,651,634,17
Palmeiras,292350,BA,Nordeste,FIOCRUZ/ASTRAZENECA,2836,2532,304
Palmeiras,292350,BA,Nordeste,BUTANTAN/SINOVAC,2694,1524,1170
Palmeiras,292350,BA,Nordeste,PFIZER/BIONTECH,29,29,0
Palmeiras De Goiás,521570,GO,Centro-Oeste,FIOCRUZ/ASTRAZENECA,7283,6761,522
Palmeiras De Goiás,521570,GO,Centro-Oeste,BUTANTAN/SINOVAC,5541,2853,2688
Palmeiras De Goiás,521570,GO,Centro-Oeste,PFIZER/BIONTECH,381,381,0
Palmeiras Do Tocantins,171380,TO,Norte,BUTANTAN/SINOVAC,997,517,480
Palmeiras Do Tocantins,171380,TO,Norte,FIOCRUZ/ASTRAZENECA,619,579,40
Palmeirina,261010,PE,Nordeste,BUTANTAN/SINOVAC,1305,665,640
Palmeirina,261010,PE,Nordeste,FIOCRUZ/ASTRAZENECA,1063,1001,62
Palmeirina,261010,PE,Nordeste,PFIZER/BIONTECH,126,125,1
Palmeirópolis,171575,TO,Norte,FIOCRUZ/ASTRAZENECA,1582,1537,45
Palmeirópolis,171575,TO,Norte,BUTANTAN/SINOVAC,1501,756,745
Palmelo,521580,GO,Centro-Oeste,FIOCRUZ/ASTRAZENECA,938,783,155
Palmelo,521580,GO,Centro-Oeste,BUTANTAN/SINOVAC,613,314,299
Palmelo,521580,GO,Centro-Oeste,PFIZER/BIONTECH,18,18,0
Palminópolis,521590,GO,Centro-Oeste,FIOCRUZ/ASTRAZENECA,1074,986,88
Palminópolis,521590,GO,Centro-Oeste,BUTANTAN/SINOVAC,899,460,439
Palminópolis,521590,GO,Centro-Oeste,PFIZER/BIONTECH,48,48,0
Palmital,353530,SP,Sudeste,BUTANTAN/SINOVAC,6502,3488,3014
Palmital,353530,SP,Sudeste,FIOCRUZ/ASTRAZENECA,5361,4874,487
Palmital,353530,SP,Sudeste,PFIZER/BIONTECH,533,533,0
Palmital,411780,PR,Sul,FIOCRUZ/ASTRAZENECA,3512,3384,128
Palmital,411780,PR,Sul,BUTANTAN/SINOVAC,2771,1447,1324
Palmital,411780,PR,Sul,PFIZER/BIONTECH,119,119,0
Palmitinho,431380,RS,Sul,BUTANTAN/SINOVAC,2308,1180,1128
Palmitinho,431380,RS,Sul,FIOCRUZ/ASTRAZENECA,1976,1786,190
Palmitinho,431380,RS,Sul,PFIZER/BIONTECH,285,285,0
Palmitos,421210,SC,Sul,FIOCRUZ/ASTRAZENECA,4398,4038,360
Palmitos,421210,SC,Sul,BUTANTAN/SINOVAC,4343,2284,2059
Palmitos,421210,SC,Sul,PFIZER/BIONTECH,413,413,0
Palmópolis,314675,MG,Sudeste,BUTANTAN/SINOVAC,1546,829,717
Palmópolis,314675,MG,Sudeste,FIOCRUZ/ASTRAZENECA,1071,980,91
Palmópolis,314675,MG,Sudeste,PFIZER/BIONTECH,212,212,0
Palotina,411790,PR,Sul,BUTANTAN/SINOVAC,6350,3333,3017
Palotina,411790,PR,Sul,FIOCRUZ/ASTRAZENECA,5453,5076,377
Palotina,411790,PR,Sul,PFIZER/BIONTECH,15,15,0
Panamá,521600,GO,Centro-Oeste,FIOCRUZ/ASTRAZENECA,723,689,34
Panamá,521600,GO,Centro-Oeste,BUTANTAN/SINOVAC,634,333,301
Panambi,431390,RS,Sul,BUTANTAN/SINOVAC,9168,4694,4474
Panambi,431390,RS,Sul,FIOCRUZ/ASTRAZENECA,6136,5588,548
Panambi,431390,RS,Sul,PFIZER/BIONTECH,503,503,0
Pancas,320400,ES,Sudeste,BUTANTAN/SINOVAC,5800,3137,2663
Pancas,320400,ES,Sudeste,FIOCRUZ/ASTRAZENECA,4335,4141,194
Pancas,320400,ES,Sudeste,PFIZER/BIONTECH,702,701,1
Panelas,261020,PE,Nordeste,BUTANTAN/SINOVAC,4944,2780,2164
Panelas,261020,PE,Nordeste,FIOCRUZ/ASTRAZENECA,4109,3785,324
Panelas,261020,PE,Nordeste,PFIZER/BIONTECH,187,187,0
Panorama,353540,SP,Sudeste,FIOCRUZ/ASTRAZENECA,4013,3783,230
Panorama,353540,SP,Sudeste,BUTANTAN/SINOVAC,3433,1694,1739
Panorama,353540,SP,Sudeste,PFIZER/BIONTECH,309,309,0
Pantano Grande,431395,RS,Sul,BUTANTAN/SINOVAC,3237,1957,1280
Pantano Grande,431395,RS,Sul,FIOCRUZ/ASTRAZENECA,2583,2403,180
Pantano Grande,431395,RS,Sul,PFIZER/BIONTECH,347,347,0
Pão De Açúcar,270640,AL,Nordeste,FIOCRUZ/ASTRAZENECA,4652,4321,331
Pão De Açúcar,270640,AL,Nordeste,BUTANTAN/SINOVAC,3580,1870,1710
Papagaios,314690,MG,Sudeste,BUTANTAN/SINOVAC,2202,1121,1081
Papagaios,314690,MG,Sudeste,FIOCRUZ/ASTRAZENECA,1947,1761,186
Papagaios,314690,MG,Sudeste,PFIZER/BIONTECH,6,6,0
Papanduva,421220,SC,Sul,FIOCRUZ/ASTRAZENECA,4134,3893,241
Papanduva,421220,SC,Sul,BUTANTAN/SINOVAC,3149,1714,1435
Papanduva,421220,SC,Sul,PFIZER/BIONTECH,302,302,0
Paquetá,220755,PI,Nordeste,FIOCRUZ/ASTRAZENECA,1234,908,326
Paquetá,220755,PI,Nordeste,BUTANTAN/SINOVAC,925,480,445
Pará De Minas,314710,MG,Sudeste,FIOCRUZ/ASTRAZENECA,16664,15540,1124
Pará De Minas,314710,MG,Sudeste,BUTANTAN/SINOVAC,16588,8441,8147
Pará De Minas,314710,MG,Sudeste,PFIZER/BIONTECH,1826,1824,2
Paracambi,330360,RJ,Sudeste,BUTANTAN/SINOVAC,8890,4517,4373
Paracambi,330360,RJ,Sudeste,FIOCRUZ/ASTRAZENECA,7225,6844,381
Paracatu,314700,MG,Sudeste,FIOCRUZ/ASTRAZENECA,16728,15716,1012
Paracatu,314700,MG,Sudeste,BUTANTAN/SINOVAC,14421,7577,6844
Paracatu,314700,MG,Sudeste,PFIZER/BIONTECH,1467,1467,0
Paracuru,231020,CE,Nordeste,BUTANTAN/SINOVAC,5728,2961,2767
Paracuru,231020,CE,Nordeste,FIOCRUZ/ASTRAZENECA,2862,2659,203
Paragominas,150550,PA,Norte,FIOCRUZ/ASTRAZENECA,21391,20397,994
Paragominas,150550,PA,Norte,BUTANTAN/SINOVAC,12765,7453,5312
Paraguaçu,314720,MG,Sudeste,BUTANTAN/SINOVAC,4777,2482,2295
Paraguaçu,314720,MG,Sudeste,FIOCRUZ/ASTRAZENECA,3518,3283,235
Paraguaçu Paulista,353550,SP,Sudeste,FIOCRUZ/ASTRAZENECA,11346,10626,720
Paraguaçu Paulista,353550,SP,Sudeste,BUTANTAN/SINOVAC,8822,4912,3910
Paraguaçu Paulista,353550,SP,Sudeste,PFIZER/BIONTECH,683,681,2
Paraí,431400,RS,Sul,FIOCRUZ/ASTRAZENECA,1971,1825,146
Paraí,431400,RS,Sul,BUTANTAN/SINOVAC,1853,936,917
Paraí,431400,RS,Sul,PFIZER/BIONTECH,98,98,0
Paraíba Do Sul,330370,RJ,Sudeste,BUTANTAN/SINOVAC,10885,5672,5213
Paraíba Do Sul,330370,RJ,Sudeste,FIOCRUZ/ASTRAZENECA,9342,8691,651
Paraibano,210770,MA,Nordeste,FIOCRUZ/ASTRAZENECA,3918,3723,195
Paraibano,210770,MA,Nordeste,BUTANTAN/SINOVAC,3278,1755,1523
Paraibuna,353560,SP,Sudeste,BUTANTAN/SINOVAC,5102,3036,2066
Paraibuna,353560,SP,Sudeste,FIOCRUZ/ASTRAZENECA,3832,3528,304
Paraibuna,353560,SP,Sudeste,PFIZER/BIONTECH,279,279,0
Paraipaba,231025,CE,Nordeste,BUTANTAN/SINOVAC,3801,1916,1885
Paraipaba,231025,CE,Nordeste,FIOCRUZ/ASTRAZENECA,1434,1076,358
Paraíso,353570,SP,Sudeste,BUTANTAN/SINOVAC,1549,820,729
Paraíso,353570,SP,Sudeste,FIOCRUZ/ASTRAZENECA,1548,1414,134
Paraíso,353570,SP,Sudeste,PFIZER/BIONTECH,60,60,0
Paraíso,421223,SC,Sul,FIOCRUZ/ASTRAZENECA,1316,1222,94
Paraíso,421223,SC,Sul,BUTANTAN/SINOVAC,1024,553,471
Paraíso,421223,SC,Sul,PFIZER/BIONTECH,18,18,0
Paraíso Das Águas,500627,MS,Centro-Oeste,BUTANTAN/SINOVAC,1172,596,576
Paraíso Das Águas,500627,MS,Centro-Oeste,FIOCRUZ/ASTRAZENECA,1139,1058,81
Paraíso Das Águas,500627,MS,Centro-Oeste,PFIZER/BIONTECH,126,126,0
Paraíso Do Norte,411800,PR,Sul,FIOCRUZ/ASTRAZENECA,2964,2769,195
Paraíso Do Norte,411800,PR,Sul,BUTANTAN/SINOVAC,2562,1445,1117
Paraíso Do Norte,411800,PR,Sul,PFIZER/BIONTECH,470,470,0
Paraíso Do Sul,431402,RS,Sul,BUTANTAN/SINOVAC,2146,1101,1045
Paraíso Do Sul,431402,RS,Sul,FIOCRUZ/ASTRAZENECA,2140,1855,285
Paraíso Do Sul,431402,RS,Sul,PFIZER/BIONTECH,193,193,0
Paraíso Do Tocantins,171610,TO,Norte,BUTANTAN/SINOVAC,8148,4170,3978
Paraíso Do Tocantins,171610,TO,Norte,FIOCRUZ/ASTRAZENECA,6363,5876,487
Paraíso Do Tocantins,171610,TO,Norte,PFIZER/BIONTECH,2459,2459,0
Paraisópolis,314730,MG,Sudeste,BUTANTAN/SINOVAC,2143,1330,813
Paraisópolis,314730,MG,Sudeste,FIOCRUZ/ASTRAZENECA,2098,2092,6
Paraisópolis,314730,MG,Sudeste,PFIZER/BIONTECH,35,35,0
Parambu,231030,CE,Nordeste,BUTANTAN/SINOVAC,7507,4238,3269
Parambu,231030,CE,Nordeste,FIOCRUZ/ASTRAZENECA,4409,3395,1014
Paramirim,292360,BA,Nordeste,FIOCRUZ/ASTRAZENECA,5930,5150,780
Paramirim,292360,BA,Nordeste,BUTANTAN/SINOVAC,5150,2641,2509
Paramirim,292360,BA,Nordeste,PFIZER/BIONTECH,387,387,0
Paramoti,231040,CE,Nordeste,BUTANTAN/SINOVAC,1822,912,910
Paramoti,231040,CE,Nordeste,FIOCRUZ/ASTRAZENECA,1073,871,202
Paraná,240860,RN,Nordeste,BUTANTAN/SINOVAC,1277,646,631
Paraná,240860,RN,Nordeste,FIOCRUZ/ASTRAZENECA,1058,998,60
Paraná,240860,RN,Nordeste,PFIZER/BIONTECH,78,78,0
Paranã,171620,TO,Norte,BUTANTAN/SINOVAC,2023,1043,980
Paranã,171620,TO,Norte,FIOCRUZ/ASTRAZENECA,1999,1746,253
Paranacity,411810,PR,Sul,FIOCRUZ/ASTRAZENECA,2283,2158,125
Paranacity,411810,PR,Sul,BUTANTAN/SINOVAC,1988,1017,971
Paranacity,411810,PR,Sul,PFIZER/BIONTECH,49,49,0
Paranaguá,411820,PR,Sul,FIOCRUZ/ASTRAZENECA,54054,52492,1562
Paranaguá,411820,PR,Sul,BUTANTAN/SINOVAC,27285,15773,11512
Paranaguá,411820,PR,Sul,PFIZER/BIONTECH,7259,7259,0
Paranaíba,500630,MS,Centro-Oeste,FIOCRUZ/ASTRAZENECA,11337,10411,926
Paranaíba,500630,MS,Centro-Oeste,BUTANTAN/SINOVAC,10887,5827,5060
Paranaíba,500630,MS,Centro-Oeste,PFIZER/BIONTECH,1343,1343,0
Paranaiguara,521630,GO,Centro-Oeste,FIOCRUZ/ASTRAZENECA,2693,2532,161
Paranaiguara,521630,GO,Centro-Oeste,BUTANTAN/SINOVAC,2264,1149,1115
Paranaiguara,521630,GO,Centro-Oeste,PFIZER/BIONTECH,40,40,0
Paranaíta,510629,MT,Centro-Oeste,FIOCRUZ/ASTRAZENECA,2430,2324,106
Paranaíta,510629,MT,Centro-Oeste,BUTANTAN/SINOVAC,1693,883,810
Paranaíta,510629,MT,Centro-Oeste,PFIZER/BIONTECH,268,268,0
Paranapanema,353580,SP,Sudeste,FIOCRUZ/ASTRAZENECA,4720,4474,246
Paranapanema,353580,SP,Sudeste,BUTANTAN/SINOVAC,3686,1961,1725
Paranapanema,353580,SP,Sudeste,PFIZER/BIONTECH,446,445,1
Paranapoema,411830,PR,Sul,FIOCRUZ/ASTRAZENECA,747,712,35
Paranapoema,411830,PR,Sul,BUTANTAN/SINOVAC,529,266,263
Paranapuã,353590,SP,Sudeste,FIOCRUZ/ASTRAZENECA,1054,962,92
Paranapuã,353590,SP,Sudeste,BUTANTAN/SINOVAC,990,537,453
Paranapuã,353590,SP,Sudeste,PFIZER/BIONTECH,116,116,0
Paranatama,261030,PE,Nordeste,FIOCRUZ/ASTRAZENECA,2607,2420,187
Paranatama,261030,PE,Nordeste,BUTANTAN/SINOVAC,2329,1223,1106
Paranatama,261030,PE,Nordeste,PFIZER/BIONTECH,385,385,0
Paranatinga,510630,MT,Centro-Oeste,BUTANTAN/SINOVAC,4582,2361,2221
Paranatinga,510630,MT,Centro-Oeste,FIOCRUZ/ASTRAZENECA,3591,3337,254
Paranatinga,510630,MT,Centro-Oeste,PFIZER/BIONTECH,48,48,0
Paranavaí,411840,PR,Sul,FIOCRUZ/ASTRAZENECA,22228,20109,2119
Paranavaí,411840,PR,Sul,BUTANTAN/SINOVAC,20018,10717,9301
Paranavaí,411840,PR,Sul,PFIZER/BIONTECH,4803,4800,3
Paranhos,500635,MS,Centro-Oeste,BUTANTAN/SINOVAC,7300,3838,3462
Paranhos,500635,MS,Centro-Oeste,FIOCRUZ/ASTRAZENECA,2258,2143,115
Paranhos,500635,MS,Centro-Oeste,PFIZER/BIONTECH,355,355,0
Paraopeba,314740,MG,Sudeste,FIOCRUZ/ASTRAZENECA,5427,5117,310
Paraopeba,314740,MG,Sudeste,BUTANTAN/SINOVAC,3909,2057,1852
Paraopeba,314740,MG,Sudeste,PFIZER/BIONTECH,162,162,0
Parapuã,353600,SP,Sudeste,FIOCRUZ/ASTRAZENECA,5170,4797,373
Parapuã,353600,SP,Sudeste,BUTANTAN/SINOVAC,4558,2511,2047
Parapuã,353600,SP,Sudeste,PFIZER/BIONTECH,244,244,0
Parari,251065,PB,Nordeste,BUTANTAN/SINOVAC,551,281,270
Parari,251065,PB,Nordeste,FIOCRUZ/ASTRAZENECA,469,429,40
Parari,251065,PB,Nordeste,PFIZER/BIONTECH,47,47,0
Paratinga,292370,BA,Nordeste,FIOCRUZ/ASTRAZENECA,8279,7943,336
Paratinga,292370,BA,Nordeste,BUTANTAN/SINOVAC,6962,3561,3401
Paratinga,292370,BA,Nordeste,PFIZER/BIONTECH,80,80,0
Paraty,330380,RJ,Sudeste,BUTANTAN/SINOVAC,4953,3513,1440
Paraty,330380,RJ,Sudeste,FIOCRUZ/ASTRAZENECA,4446,4186,260
Paraú,240870,RN,Nordeste,BUTANTAN/SINOVAC,902,511,391
Paraú,240870,RN,Nordeste,FIOCRUZ/ASTRAZENECA,742,697,45
Paraú,240870,RN,Nordeste,PFIZER/BIONTECH,36,36,0
Parauapebas,150553,PA,Norte,FIOCRUZ/ASTRAZENECA,25578,23939,1639
Parauapebas,150553,PA,Norte,BUTANTAN/SINOVAC,10131,7044,3087
Paraúna,521640,GO,Centro-Oeste,FIOCRUZ/ASTRAZENECA,3165,2951,214
Paraúna,521640,GO,Centro-Oeste,BUTANTAN/SINOVAC,1808,1065,743
Parazinho,240880,RN,Nordeste,BUTANTAN/SINOVAC,1107,574,533
Parazinho,240880,RN,Nordeste,FIOCRUZ/ASTRAZENECA,870,811,59
Parazinho,240880,RN,Nordeste,PFIZER/BIONTECH,184,184,0
Pardinho,353610,SP,Sudeste,FIOCRUZ/ASTRAZENECA,1444,1244,200
Pardinho,353610,SP,Sudeste,BUTANTAN/SINOVAC,1304,691,613
Pardinho,353610,SP,Sudeste,PFIZER/BIONTECH,48,48,0
Pareci Novo,431403,RS,Sul,BUTANTAN/SINOVAC,1048,554,494
Pareci Novo,431403,RS,Sul,FIOCRUZ/ASTRAZENECA,868,809,59
Pareci Novo,431403,RS,Sul,PFIZER/BIONTECH,150,150,0
Parecis,110145,RO,Norte,BUTANTAN/SINOVAC,949,508,441
Parecis,110145,RO,Norte,FIOCRUZ/ASTRAZENECA,943,904,39
Parecis,110145,RO,Norte,PFIZER/BIONTECH,79,79,0
Parelhas,240890,RN,Nordeste,FIOCRUZ/ASTRAZENECA,4302,3880,422
Parelhas,240890,RN,Nordeste,BUTANTAN/SINOVAC,4180,2188,1992
Parelhas,240890,RN,Nordeste,PFIZER/BIONTECH,443,440,3
Pariconha,270642,AL,Nordeste,BUTANTAN/SINOVAC,5902,3080,2822
Pariconha,270642,AL,Nordeste,FIOCRUZ/ASTRAZENECA,1581,1365,216
Parintins,130340,AM,Norte,FIOCRUZ/ASTRAZENECA,17584,14796,2788
Parintins,130340,AM,Norte,BUTANTAN/SINOVAC,10757,6568,4189
Parintins,130340,AM,Norte,PFIZER/BIONTECH,13,10,3
Paripiranga,292380,BA,Nordeste,FIOCRUZ/ASTRAZENECA,6412,6393,19
Paripiranga,292380,BA,Nordeste,BUTANTAN/SINOVAC,4250,2657,1593
Paripiranga,292380,BA,Nordeste,PFIZER/BIONTECH,33,32,1
Paripueira,270644,AL,Nordeste,BUTANTAN/SINOVAC,2035,1134,901
Paripueira,270644,AL,Nordeste,FIOCRUZ/ASTRAZENECA,1852,1627,225
Pariquera-Açu,353620,SP,Sudeste,BUTANTAN/SINOVAC,5671,2958,2713
Pariquera-Açu,353620,SP,Sudeste,FIOCRUZ/ASTRAZENECA,4822,4412,410
Pariquera-Açu,353620,SP,Sudeste,PFIZER/BIONTECH,342,341,1
Parisi,353625,SP,Sudeste,BUTANTAN/SINOVAC,737,404,333
Parisi,353625,SP,Sudeste,FIOCRUZ/ASTRAZENECA,599,526,73
Parisi,353625,SP,Sudeste,PFIZER/BIONTECH,58,58,0
Parnaguá,220760,PI,Nordeste,FIOCRUZ/ASTRAZENECA,1761,1641,120
Parnaguá,220760,PI,Nordeste,BUTANTAN/SINOVAC,1386,722,664
Parnaíba,220770,PI,Nordeste,BUTANTAN/SINOVAC,23282,11990,11292
Parnaíba,220770,PI,Nordeste,FIOCRUZ/ASTRAZENECA,22029,20196,1833
Parnaíba,220770,PI,Nordeste,PFIZER/BIONTECH,3470,3469,1
Parnamirim,240325,RN,Nordeste,FIOCRUZ/ASTRAZENECA,45829,41868,3961
Parnamirim,240325,RN,Nordeste,BUTANTAN/SINOVAC,45354,24550,20804
Parnamirim,240325,RN,Nordeste,PFIZER/BIONTECH,8941,8933,8
Parnamirim,261040,PE,Nordeste,FIOCRUZ/ASTRAZENECA,4355,3584,771
Parnamirim,261040,PE,Nordeste,BUTANTAN/SINOVAC,4081,2113,1968
Parnamirim,261040,PE,Nordeste,PFIZER/BIONTECH,123,123,0
Parnarama,210780,MA,Nordeste,FIOCRUZ/ASTRAZENECA,6778,6341,437
Parnarama,210780,MA,Nordeste,BUTANTAN/SINOVAC,4992,2617,2375
Parobé,431405,RS,Sul,FIOCRUZ/ASTRAZENECA,13121,12469,652
Parobé,431405,RS,Sul,BUTANTAN/SINOVAC,10050,5226,4824
Parobé,431405,RS,Sul,PFIZER/BIONTECH,741,741,0
Passa E Fica,240910,RN,Nordeste,BUTANTAN/SINOVAC,2590,1324,1266
Passa E Fica,240910,RN,Nordeste,FIOCRUZ/ASTRAZENECA,2298,2076,222
Passa E Fica,240910,RN,Nordeste,PFIZER/BIONTECH,353,353,0
Passa Quatro,314760,MG,Sudeste,BUTANTAN/SINOVAC,2821,1469,1352
Passa Quatro,314760,MG,Sudeste,FIOCRUZ/ASTRAZENECA,2610,2515,95
Passa Quatro,314760,MG,Sudeste,PFIZER/BIONTECH,14,14,0
Passa Sete,431406,RS,Sul,BUTANTAN/SINOVAC,1271,643,628
Passa Sete,431406,RS,Sul,FIOCRUZ/ASTRAZENECA,1096,1001,95
Passa Sete,431406,RS,Sul,PFIZER/BIONTECH,142,142,0
Passa Tempo,314770,MG,Sudeste,BUTANTAN/SINOVAC,2126,1160,966
Passa Tempo,314770,MG,Sudeste,FIOCRUZ/ASTRAZENECA,1570,1455,115
Passa Tempo,314770,MG,Sudeste,PFIZER/BIONTECH,25,25,0
Passa-Vinte,314780,MG,Sudeste,FIOCRUZ/ASTRAZENECA,725,661,64
Passa-Vinte,314780,MG,Sudeste,BUTANTAN/SINOVAC,639,325,314
Passa-Vinte,314780,MG,Sudeste,PFIZER/BIONTECH,7,7,0
Passabém,314750,MG,Sudeste,BUTANTAN/SINOVAC,648,333,315
Passabém,314750,MG,Sudeste,FIOCRUZ/ASTRAZENECA,614,494,120
Passabém,314750,MG,Sudeste,PFIZER/BIONTECH,40,40,0
Passagem,240920,RN,Nordeste,BUTANTAN/SINOVAC,787,400,387
Passagem,240920,RN,Nordeste,FIOCRUZ/ASTRAZENECA,434,406,28
Passagem,240920,RN,Nordeste,PFIZER/BIONTECH,67,67,0
Passagem,251070,PB,Nordeste,BUTANTAN/SINOVAC,624,327,297
Passagem,251070,PB,Nordeste,FIOCRUZ/ASTRAZENECA,397,346,51
Passagem,251070,PB,Nordeste,PFIZER/BIONTECH,12,12,0
Passagem Franca,210790,MA,Nordeste,FIOCRUZ/ASTRAZENECA,4816,4559,257
Passagem Franca,210790,MA,Nordeste,BUTANTAN/SINOVAC,2936,1542,1394
Passagem Franca Do Piauí,220775,PI,Nordeste,BUTANTAN/SINOVAC,937,491,446
Passagem Franca Do Piauí,220775,PI,Nordeste,FIOCRUZ/ASTRAZENECA,374,325,49
Passagem Franca Do Piauí,220775,PI,Nordeste,PFIZER/BIONTECH,94,94,0
Passira,261050,PE,Nordeste,FIOCRUZ/ASTRAZENECA,7771,7252,519
Passira,261050,PE,Nordeste,BUTANTAN/SINOVAC,5521,2815,2706
Passira,261050,PE,Nordeste,PFIZER/BIONTECH,196,195,1
Passo De Camaragibe,270650,AL,Nordeste,FIOCRUZ/ASTRAZENECA,2308,2166,142
Passo De Camaragibe,270650,AL,Nordeste,BUTANTAN/SINOVAC,1894,1037,857
Passo De Torres,421225,SC,Sul,FIOCRUZ/ASTRAZENECA,1923,1817,106
Passo De Torres,421225,SC,Sul,BUTANTAN/SINOVAC,1739,921,818
Passo De Torres,421225,SC,Sul,PFIZER/BIONTECH,250,250,0
Passo Do Sobrado,431407,RS,Sul,BUTANTAN/SINOVAC,1712,870,842
Passo Do Sobrado,431407,RS,Sul,FIOCRUZ/ASTRAZENECA,1562,1439,123
Passo Do Sobrado,431407,RS,Sul,PFIZER/BIONTECH,117,117,0
Passo Fundo,431410,RS,Sul,FIOCRUZ/ASTRAZENECA,60918,53286,7632
Passo Fundo,431410,RS,Sul,BUTANTAN/SINOVAC,51033,25896,25137
Passo Fundo,431410,RS,Sul,PFIZER/BIONTECH,6917,6902,15
Passos,314790,MG,Sudeste,BUTANTAN/SINOVAC,24082,12781,11301
Passos,314790,MG,Sudeste,FIOCRUZ/ASTRAZENECA,18433,17502,931
Passos,314790,MG,Sudeste,PFIZER/BIONTECH,1287,1283,4
Passos Maia,421227,SC,Sul,FIOCRUZ/ASTRAZENECA,1229,1149,80
Passos Maia,421227,SC,Sul,BUTANTAN/SINOVAC,813,463,350
Passos Maia,421227,SC,Sul,PFIZER/BIONTECH,63,58,5
Pastos Bons,210800,MA,Nordeste,FIOCRUZ/ASTRAZENECA,3500,3285,215
Pastos Bons,210800,MA,Nordeste,BUTANTAN/SINOVAC,2884,1549,1335
Patis,314795,MG,Sudeste,BUTANTAN/SINOVAC,950,502,448
Patis,314795,MG,Sudeste,FIOCRUZ/ASTRAZENECA,282,239,43
Pato Bragado,411845,PR,Sul,FIOCRUZ/ASTRAZENECA,1210,1113,97
Pato Bragado,411845,PR,Sul,BUTANTAN/SINOVAC,1122,577,545
Pato Bragado,411845,PR,Sul,PFIZER/BIONTECH,28,28,0
Pato Branco,411850,PR,Sul,BUTANTAN/SINOVAC,18490,9650,8840
Pato Branco,411850,PR,Sul,FIOCRUZ/ASTRAZENECA,17546,16150,1396
Pato Branco,411850,PR,Sul,PFIZER/BIONTECH,3933,3929,4
Patos,251080,PB,Nordeste,BUTANTAN/SINOVAC,27154,13951,13203
Patos,251080,PB,Nordeste,FIOCRUZ/ASTRAZENECA,15213,13654,1559
Patos,251080,PB,Nordeste,PFIZER/BIONTECH,1604,1603,1
Patos De Minas,314800,MG,Sudeste,FIOCRUZ/ASTRAZENECA,35272,31667,3605
Patos De Minas,314800,MG,Sudeste,BUTANTAN/SINOVAC,35174,18168,17006
Patos De Minas,314800,MG,Sudeste,PFIZER/BIONTECH,3110,3101,9
Patos Do Piauí,220777,PI,Nordeste,FIOCRUZ/ASTRAZENECA,1315,1214,101
Patos Do Piauí,220777,PI,Nordeste,BUTANTAN/SINOVAC,1222,620,602
Patos Do Piauí,220777,PI,Nordeste,PFIZER/BIONTECH,66,66,0
Patrocínio,314810,MG,Sudeste,BUTANTAN/SINOVAC,16998,8673,8325
Patrocínio,314810,MG,Sudeste,FIOCRUZ/ASTRAZENECA,16172,14809,1363
Patrocínio,314810,MG,Sudeste,PFIZER/BIONTECH,1170,1170,0
Patrocínio Do Muriaé,314820,MG,Sudeste,BUTANTAN/SINOVAC,1559,835,724
Patrocínio Do Muriaé,314820,MG,Sudeste,FIOCRUZ/ASTRAZENECA,1304,1231,73
Patrocínio Do Muriaé,314820,MG,Sudeste,PFIZER/BIONTECH,82,82,0
Patrocínio Paulista,353630,SP,Sudeste,FIOCRUZ/ASTRAZENECA,3177,2883,294
Patrocínio Paulista,353630,SP,Sudeste,BUTANTAN/SINOVAC,3066,1631,1435
Patrocínio Paulista,353630,SP,Sudeste,PFIZER/BIONTECH,259,259,0
Patu,240930,RN,Nordeste,BUTANTAN/SINOVAC,2388,1269,1119
Patu,240930,RN,Nordeste,FIOCRUZ/ASTRAZENECA,2339,2120,219
Patu,240930,RN,Nordeste,PFIZER/BIONTECH,345,344,1
Paty Do Alferes,330385,RJ,Sudeste,FIOCRUZ/ASTRAZENECA,5058,4710,348
Paty Do Alferes,330385,RJ,Sudeste,BUTANTAN/SINOVAC,5018,2821,2197
Paty Do Alferes,330385,RJ,Sudeste,PFIZER/BIONTECH,315,315,0
Pau Brasil,292390,BA,Nordeste,BUTANTAN/SINOVAC,3223,1974,1249
Pau Brasil,292390,BA,Nordeste,FIOCRUZ/ASTRAZENECA,1689,1532,157
Pau Brasil,292390,BA,Nordeste,PFIZER/BIONTECH,21,21,0
Pau D'Arco,150555,PA,Norte,FIOCRUZ/ASTRAZENECA,945,823,122
Pau D'Arco,150555,PA,Norte,BUTANTAN/SINOVAC,910,489,421
Pau D'Arco,171630,TO,Norte,BUTANTAN/SINOVAC,942,489,453
Pau D'Arco,171630,TO,Norte,FIOCRUZ/ASTRAZENECA,628,598,30
Pau D'Arco Do Piauí,220779,PI,Nordeste,BUTANTAN/SINOVAC,720,365,355
Pau D'Arco Do Piauí,220779,PI,Nordeste,FIOCRUZ/ASTRAZENECA,481,460,21
Pau Dos Ferros,240940,RN,Nordeste,BUTANTAN/SINOVAC,5286,2682,2604
Pau Dos Ferros,240940,RN,Nordeste,FIOCRUZ/ASTRAZENECA,5188,4491,697
Pau Dos Ferros,240940,RN,Nordeste,PFIZER/BIONTECH,820,820,0
Paudalho,261060,PE,Nordeste,FIOCRUZ/ASTRAZENECA,10997,10371,626
Paudalho,261060,PE,Nordeste,BUTANTAN/SINOVAC,8247,4335,3912
Paudalho,261060,PE,Nordeste,PFIZER/BIONTECH,720,720,0
Pauini,130350,AM,Norte,BUTANTAN/SINOVAC,2715,1633,1082
Pauini,130350,AM,Norte,FIOCRUZ/ASTRAZENECA,828,653,175
Paula Cândido,314830,MG,Sudeste,FIOCRUZ/ASTRAZENECA,2314,2121,193
Paula Cândido,314830,MG,Sudeste,BUTANTAN/SINOVAC,2110,1095,1015
Paula Cândido,314830,MG,Sudeste,PFIZER/BIONTECH,93,93,0
Paula Freitas,411860,PR,Sul,FIOCRUZ/ASTRAZENECA,1551,1456,95
Paula Freitas,411860,PR,Sul,BUTANTAN/SINOVAC,1140,588,552
Paula Freitas,411860,PR,Sul,PFIZER/BIONTECH,29,29,0
Paulicéia,353640,SP,Sudeste,FIOCRUZ/ASTRAZENECA,1895,1772,123
Paulicéia,353640,SP,Sudeste,BUTANTAN/SINOVAC,1344,619,725
Paulicéia,353640,SP,Sudeste,PFIZER/BIONTECH,163,163,0
Paulínia,353650,SP,Sudeste,FIOCRUZ/ASTRAZENECA,20857,19881,976
Paulínia,353650,SP,Sudeste,BUTANTAN/SINOVAC,16959,8810,8149
Paulínia,353650,SP,Sudeste,PFIZER/BIONTECH,1561,1560,1
Paulino Neves,210805,MA,Nordeste,FIOCRUZ/ASTRAZENECA,2859,2687,172
Paulino Neves,210805,MA,Nordeste,BUTANTAN/SINOVAC,2106,1124,982
Paulista,251090,PB,Nordeste,BUTANTAN/SINOVAC,2741,1381,1360
Paulista,251090,PB,Nordeste,FIOCRUZ/ASTRAZENECA,2387,2183,204
Paulista,251090,PB,Nordeste,PFIZER/BIONTECH,41,41,0
Paulista,261070,PE,Nordeste,BUTANTAN/SINOVAC,52044,27890,24154
Paulista,261070,PE,Nordeste,FIOCRUZ/ASTRAZENECA,29289,25134,4155
Paulista,261070,PE,Nordeste,PFIZER/BIONTECH,451,446,5
Paulistana,220780,PI,Nordeste,FIOCRUZ/ASTRAZENECA,4805,3517,1288
Paulistana,220780,PI,Nordeste,BUTANTAN/SINOVAC,2931,1477,1454
Paulistânia,353657,SP,Sudeste,BUTANTAN/SINOVAC,533,265,268
Paulistânia,353657,SP,Sudeste,FIOCRUZ/ASTRAZENECA,425,389,36
Paulistânia,353657,SP,Sudeste,PFIZER/BIONTECH,54,54,0
Paulistas,314840,MG,Sudeste,BUTANTAN/SINOVAC,1192,608,584
Paulistas,314840,MG,Sudeste,FIOCRUZ/ASTRAZENECA,1138,1022,116
Paulistas,314840,MG,Sudeste,PFIZER/BIONTECH,39,39,0
Paulo Afonso,292400,BA,Nordeste,FIOCRUZ/ASTRAZENECA,25492,22193,3299
Paulo Afonso,292400,BA,Nordeste,BUTANTAN/SINOVAC,18573,9729,8844
Paulo Afonso,292400,BA,Nordeste,PFIZER/BIONTECH,1473,1473,0
Paulo Bento,431413,RS,Sul,BUTANTAN/SINOVAC,796,403,393
Paulo Bento,431413,RS,Sul,FIOCRUZ/ASTRAZENECA,683,592,91
Paulo Bento,431413,RS,Sul,PFIZER/BIONTECH,36,36,0
Paulo De Faria,353660,SP,Sudeste,BUTANTAN/SINOVAC,2675,1477,1198
Paulo De Faria,353660,SP,Sudeste,FIOCRUZ/ASTRAZENECA,2048,1861,187
Paulo De Faria,353660,SP,Sudeste,PFIZER/BIONTECH,66,66,0
Paulo Frontin,411870,PR,Sul,FIOCRUZ/ASTRAZENECA,1763,1678,85
Paulo Frontin,411870,PR,Sul,BUTANTAN/SINOVAC,1448,738,710
Paulo Frontin,411870,PR,Sul,PFIZER/BIONTECH,42,42,0
Paulo Jacinto,270660,AL,Nordeste,BUTANTAN/SINOVAC,1531,769,762
Paulo Jacinto,270660,AL,Nordeste,FIOCRUZ/ASTRAZENECA,1522,1294,228
Paulo Lopes,421230,SC,Sul,FIOCRUZ/ASTRAZENECA,1740,1621,119
Paulo Lopes,421230,SC,Sul,BUTANTAN/SINOVAC,1505,856,649
Paulo Lopes,421230,SC,Sul,PFIZER/BIONTECH,103,103,0
Paulo Ramos,210810,MA,Nordeste,FIOCRUZ/ASTRAZENECA,3898,3687,211
Paulo Ramos,210810,MA,Nordeste,BUTANTAN/SINOVAC,2618,1447,1171
Pavão,314850,MG,Sudeste,BUTANTAN/SINOVAC,1267,911,356
Pavão,314850,MG,Sudeste,FIOCRUZ/ASTRAZENECA,428,389,39
Paverama,431415,RS,Sul,BUTANTAN/SINOVAC,2486,1254,1232
Paverama,431415,RS,Sul,FIOCRUZ/ASTRAZENECA,1868,1647,221
Paverama,431415,RS,Sul,PFIZER/BIONTECH,210,210,0
Pavussu,220785,PI,Nordeste,BUTANTAN/SINOVAC,848,433,415
Pavussu,220785,PI,Nordeste,FIOCRUZ/ASTRAZENECA,578,516,62
Pavussu,220785,PI,Nordeste,PFIZER/BIONTECH,78,78,0
Pé De Serra,292405,BA,Nordeste,BUTANTAN/SINOVAC,2865,1527,1338
Pé De Serra,292405,BA,Nordeste,FIOCRUZ/ASTRAZENECA,2302,2035,267
Pé De Serra,292405,BA,Nordeste,PFIZER/BIONTECH,42,42,0
Peabiru,411880,PR,Sul,FIOCRUZ/ASTRAZENECA,3845,3697,148
Peabiru,411880,PR,Sul,BUTANTAN/SINOVAC,2677,1361,1316
Peçanha,314860,MG,Sudeste,FIOCRUZ/ASTRAZENECA,3348,2963,385
Peçanha,314860,MG,Sudeste,BUTANTAN/SINOVAC,3200,1615,1585
Peçanha,314860,MG,Sudeste,PFIZER/BIONTECH,283,283,0
Pederneiras,353670,SP,Sudeste,FIOCRUZ/ASTRAZENECA,8561,7822,739
Pederneiras,353670,SP,Sudeste,BUTANTAN/SINOVAC,8233,4078,4155
Pederneiras,353670,SP,Sudeste,PFIZER/BIONTECH,740,739,1
Pedra,261080,PE,Nordeste,FIOCRUZ/ASTRAZENECA,3199,2935,264
Pedra,261080,PE,Nordeste,BUTANTAN/SINOVAC,3131,1702,1429
Pedra,261080,PE,Nordeste,PFIZER/BIONTECH,180,180,0
Pedra Azul,314870,MG,Sudeste,BUTANTAN/SINOVAC,5186,2633,2553
Pedra Azul,314870,MG,Sudeste,FIOCRUZ/ASTRAZENECA,4133,3722,411
Pedra Azul,314870,MG,Sudeste,PFIZER/BIONTECH,53,52,1
Pedra Bela,353680,SP,Sudeste,FIOCRUZ/ASTRAZENECA,1493,1376,117
Pedra Bela,353680,SP,Sudeste,BUTANTAN/SINOVAC,1450,733,717
Pedra Bela,353680,SP,Sudeste,PFIZER/BIONTECH,158,158,0
Pedra Bonita,314875,MG,Sudeste,FIOCRUZ/ASTRAZENECA,1187,1091,96
Pedra Bonita,314875,MG,Sudeste,BUTANTAN/SINOVAC,998,507,491
Pedra Bonita,314875,MG,Sudeste,PFIZER/BIONTECH,135,135,0
Pedra Branca,231050,CE,Nordeste,BUTANTAN/SINOVAC,7105,3898,3207
Pedra Branca,231050,CE,Nordeste,FIOCRUZ/ASTRAZENECA,3906,3487,419
Pedra Branca,251100,PB,Nordeste,BUTANTAN/SINOVAC,931,506,425
Pedra Branca,251100,PB,Nordeste,FIOCRUZ/ASTRAZENECA,710,649,61
Pedra Branca,251100,PB,Nordeste,PFIZER/BIONTECH,62,62,0
Pedra Branca Do Amapari,160015,AP,Norte,BUTANTAN/SINOVAC,2559,1379,1180
Pedra Branca Do Amapari,160015,AP,Norte,FIOCRUZ/ASTRAZENECA,1502,1338,164
Pedra Branca Do Amapari,160015,AP,Norte,PFIZER/BIONTECH,234,221,13
Pedra Do Anta,314880,MG,Sudeste,BUTANTAN/SINOVAC,1101,567,534
Pedra Do Anta,314880,MG,Sudeste,FIOCRUZ/ASTRAZENECA,927,823,104
Pedra Do Indaiá,314890,MG,Sudeste,BUTANTAN/SINOVAC,1011,553,458
Pedra Do Indaiá,314890,MG,Sudeste,FIOCRUZ/ASTRAZENECA,434,396,38
Pedra Do Indaiá,314890,MG,Sudeste,PFIZER/BIONTECH,17,17,0
Pedra Dourada,314900,MG,Sudeste,FIOCRUZ/ASTRAZENECA,497,446,51
Pedra Dourada,314900,MG,Sudeste,BUTANTAN/SINOVAC,467,239,228
Pedra Dourada,314900,MG,Sudeste,PFIZER/BIONTECH,6,6,0
Pedra Grande,240950,RN,Nordeste,BUTANTAN/SINOVAC,797,366,431
Pedra Grande,240950,RN,Nordeste,FIOCRUZ/ASTRAZENECA,656,645,11
Pedra Grande,240950,RN,Nordeste,PFIZER/BIONTECH,94,94,0
Pedra Lavrada,251110,PB,Nordeste,BUTANTAN/SINOVAC,1959,997,962
Pedra Lavrada,251110,PB,Nordeste,FIOCRUZ/ASTRAZENECA,1455,1314,141
Pedra Lavrada,251110,PB,Nordeste,PFIZER/BIONTECH,75,75,0
Pedra Mole,280500,SE,Nordeste,BUTANTAN/SINOVAC,740,390,350
Pedra Mole,280500,SE,Nordeste,FIOCRUZ/ASTRAZENECA,424,424,0
Pedra Mole,280500,SE,Nordeste,PFIZER/BIONTECH,82,82,0
Pedra Preta,240960,RN,Nordeste,BUTANTAN/SINOVAC,640,347,293
Pedra Preta,240960,RN,Nordeste,FIOCRUZ/ASTRAZENECA,577,549,28
Pedra Preta,240960,RN,Nordeste,PFIZER/BIONTECH,149,149,0
Pedra Preta,510637,MT,Centro-Oeste,BUTANTAN/SINOVAC,2523,1581,942
Pedra Preta,510637,MT,Centro-Oeste,FIOCRUZ/ASTRAZENECA,1956,1892,64
Pedralva,314910,MG,Sudeste,BUTANTAN/SINOVAC,2634,1388,1246
Pedralva,314910,MG,Sudeste,FIOCRUZ/ASTRAZENECA,1990,1831,159
Pedralva,314910,MG,Sudeste,PFIZER/BIONTECH,5,5,0
Pedranópolis,353690,SP,Sudeste,FIOCRUZ/ASTRAZENECA,881,781,100
Pedranópolis,353690,SP,Sudeste,BUTANTAN/SINOVAC,760,394,366
Pedranópolis,353690,SP,Sudeste,PFIZER/BIONTECH,61,61,0
Pedrão,292410,BA,Nordeste,FIOCRUZ/ASTRAZENECA,1516,1475,41
Pedrão,292410,BA,Nordeste,BUTANTAN/SINOVAC,1294,799,495
Pedrão,292410,BA,Nordeste,PFIZER/BIONTECH,78,78,0
Pedras Altas,431417,RS,Sul,FIOCRUZ/ASTRAZENECA,918,899,19
Pedras Altas,431417,RS,Sul,BUTANTAN/SINOVAC,422,216,206
Pedras Altas,431417,RS,Sul,PFIZER/BIONTECH,61,61,0
Pedras De Fogo,251120,PB,Nordeste,BUTANTAN/SINOVAC,4881,2566,2315
Pedras De Fogo,251120,PB,Nordeste,FIOCRUZ/ASTRAZENECA,4257,3919,338
Pedras De Fogo,251120,PB,Nordeste,PFIZER/BIONTECH,146,146,0
Pedras De Maria Da Cruz,314915,MG,Sudeste,BUTANTAN/SINOVAC,1699,855,844
Pedras De Maria Da Cruz,314915,MG,Sudeste,FIOCRUZ/ASTRAZENECA,1561,1439,122
Pedras De Maria Da Cruz,314915,MG,Sudeste,PFIZER/BIONTECH,1,1,0
Pedras Grandes,421240,SC,Sul,FIOCRUZ/ASTRAZENECA,1354,1259,95
Pedras Grandes,421240,SC,Sul,BUTANTAN/SINOVAC,1128,582,546
Pedras Grandes,421240,SC,Sul,PFIZER/BIONTECH,129,129,0
Pedregulho,353700,SP,Sudeste,BUTANTAN/SINOVAC,3679,1902,1777
Pedregulho,353700,SP,Sudeste,FIOCRUZ/ASTRAZENECA,3607,3311,296
Pedregulho,353700,SP,Sudeste,PFIZER/BIONTECH,469,469,0
Pedreira,353710,SP,Sudeste,BUTANTAN/SINOVAC,10017,5126,4891
Pedreira,353710,SP,Sudeste,FIOCRUZ/ASTRAZENECA,8552,7754,798
Pedreira,353710,SP,Sudeste,PFIZER/BIONTECH,487,487,0
Pedreiras,210820,MA,Nordeste,FIOCRUZ/ASTRAZENECA,8790,8128,662
Pedreiras,210820,MA,Nordeste,BUTANTAN/SINOVAC,6348,3404,2944
Pedreiras,210820,MA,Nordeste,PFIZER/BIONTECH,106,106,0
Pedrinhas,280510,SE,Nordeste,BUTANTAN/SINOVAC,1519,809,710
Pedrinhas,280510,SE,Nordeste,FIOCRUZ/ASTRAZENECA,1299,1211,88
Pedrinhas,280510,SE,Nordeste,PFIZER/BIONTECH,83,83,0
Pedrinhas Paulista,353715,SP,Sudeste,FIOCRUZ/ASTRAZENECA,868,789,79
Pedrinhas Paulista,353715,SP,Sudeste,BUTANTAN/SINOVAC,741,352,389
Pedrinhas Paulista,353715,SP,Sudeste,PFIZER/BIONTECH,95,95,0
Pedrinópolis,314920,MG,Sudeste,FIOCRUZ/ASTRAZENECA,989,894,95
Pedrinópolis,314920,MG,Sudeste,BUTANTAN/SINOVAC,965,492,473
Pedrinópolis,314920,MG,Sudeste,PFIZER/BIONTECH,23,23,0
Pedro Afonso,171650,TO,Norte,FIOCRUZ/ASTRAZENECA,2314,2212,102
Pedro Afonso,171650,TO,Norte,BUTANTAN/SINOVAC,1920,989,931
Pedro Alexandre,292420,BA,Nordeste,BUTANTAN/SINOVAC,1984,1055,929
Pedro Alexandre,292420,BA,Nordeste,FIOCRUZ/ASTRAZENECA,1588,1482,106
Pedro Alexandre,292420,BA,Nordeste,PFIZER/BIONTECH,23,23,0
Pedro Avelino,240970,RN,Nordeste,FIOCRUZ/ASTRAZENECA,7909,7382,527
Pedro Avelino,240970,RN,Nordeste,BUTANTAN/SINOVAC,6574,3497,3077
Pedro Avelino,240970,RN,Nordeste,PFIZER/BIONTECH,799,798,1
Pedro Canário,320405,ES,Sudeste,BUTANTAN/SINOVAC,4772,2780,1992
Pedro Canário,320405,ES,Sudeste,FIOCRUZ/ASTRAZENECA,4013,3877,136
Pedro Canário,320405,ES,Sudeste,PFIZER/BIONTECH,474,474,0
Pedro De Toledo,353720,SP,Sudeste,BUTANTAN/SINOVAC,3866,2042,1824
Pedro De Toledo,353720,SP,Sudeste,FIOCRUZ/ASTRAZENECA,3736,3519,217
Pedro De Toledo,353720,SP,Sudeste,PFIZER/BIONTECH,54,54,0
Pedro Do Rosário,210825,MA,Nordeste,FIOCRUZ/ASTRAZENECA,6391,5666,725
Pedro Do Rosário,210825,MA,Nordeste,BUTANTAN/SINOVAC,2479,1282,1197
Pedro Gomes,500640,MS,Centro-Oeste,FIOCRUZ/ASTRAZENECA,2562,2211,351
Pedro Gomes,500640,MS,Centro-Oeste,BUTANTAN/SINOVAC,2147,1083,1064
Pedro Gomes,500640,MS,Centro-Oeste,PFIZER/BIONTECH,226,226,0
Pedro Ii,220790,PI,Nordeste,BUTANTAN/SINOVAC,7207,4441,2766
Pedro Ii,220790,PI,Nordeste,FIOCRUZ/ASTRAZENECA,5275,4856,419
Pedro Ii,220790,PI,Nordeste,PFIZER/BIONTECH,238,238,0
Pedro Laurentino,220793,PI,Nordeste,FIOCRUZ/ASTRAZENECA,614,575,39
Pedro Laurentino,220793,PI,Nordeste,BUTANTAN/SINOVAC,521,284,237
Pedro Leopoldo,314930,MG,Sudeste,BUTANTAN/SINOVAC,9879,5494,4385
Pedro Leopoldo,314930,MG,Sudeste,FIOCRUZ/ASTRAZENECA,9002,8413,589
Pedro Leopoldo,314930,MG,Sudeste,PFIZER/BIONTECH,1062,1062,0
Pedro Osório,431420,RS,Sul,BUTANTAN/SINOVAC,2594,1303,1291
Pedro Osório,431420,RS,Sul,FIOCRUZ/ASTRAZENECA,1960,1793,167
Pedro Osório,431420,RS,Sul,PFIZER/BIONTECH,118,118,0
Pedro Régis,251272,PB,Nordeste,BUTANTAN/SINOVAC,1412,727,685
Pedro Régis,251272,PB,Nordeste,FIOCRUZ/ASTRAZENECA,992,905,87
Pedro Régis,251272,PB,Nordeste,PFIZER/BIONTECH,89,89,0
Pedro Teixeira,314940,MG,Sudeste,FIOCRUZ/ASTRAZENECA,544,478,66
Pedro Teixeira,314940,MG,Sudeste,BUTANTAN/SINOVAC,469,244,225
Pedro Teixeira,314940,MG,Sudeste,PFIZER/BIONTECH,36,36,0
Pedro Velho,240980,RN,Nordeste,BUTANTAN/SINOVAC,2733,1429,1304
Pedro Velho,240980,RN,Nordeste,FIOCRUZ/ASTRAZENECA,2691,2456,235
Pedro Velho,240980,RN,Nordeste,PFIZER/BIONTECH,205,205,0
Peixe,171660,TO,Norte,BUTANTAN/SINOVAC,2429,1342,1087
Peixe,171660,TO,Norte,FIOCRUZ/ASTRAZENECA,1457,1404,53
Peixe-Boi,150560,PA,Norte,BUTANTAN/SINOVAC,1189,670,519
Peixe-Boi,150560,PA,Norte,FIOCRUZ/ASTRAZENECA,1167,925,242
Peixoto De Azevedo,510642,MT,Centro-Oeste,FIOCRUZ/ASTRAZENECA,5458,4968,490
Peixoto De Azevedo,510642,MT,Centro-Oeste,BUTANTAN/SINOVAC,5104,2667,2437
Peixoto De Azevedo,510642,MT,Centro-Oeste,PFIZER/BIONTECH,324,324,0
Pejuçara,431430,RS,Sul,BUTANTAN/SINOVAC,1127,622,505
Pejuçara,431430,RS,Sul,FIOCRUZ/ASTRAZENECA,981,871,110
Pejuçara,431430,RS,Sul,PFIZER/BIONTECH,158,158,0
Pelotas,431440,RS,Sul,BUTANTAN/SINOVAC,111754,60330,51424
Pelotas,431440,RS,Sul,FIOCRUZ/ASTRAZENECA,69023,63674,5349
Pelotas,431440,RS,Sul,PFIZER/BIONTECH,6053,5933,120
Penaforte,231060,CE,Nordeste,BUTANTAN/SINOVAC,1577,878,699
Penaforte,231060,CE,Nordeste,FIOCRUZ/ASTRAZENECA,898,781,117
Penaforte,231060,CE,Nordeste,PFIZER/BIONTECH,42,42,0
Penalva,210830,MA,Nordeste,FIOCRUZ/ASTRAZENECA,5866,5597,269
Penalva,210830,MA,Nordeste,BUTANTAN/SINOVAC,4125,2164,1961
Penápolis,353730,SP,Sudeste,FIOCRUZ/ASTRAZENECA,16211,14567,1644
Penápolis,353730,SP,Sudeste,BUTANTAN/SINOVAC,15236,8186,7050
Penápolis,353730,SP,Sudeste,PFIZER/BIONTECH,1470,1465,5
Pendências,240990,RN,Nordeste,BUTANTAN/SINOVAC,2504,1228,1276
Pendências,240990,RN,Nordeste,FIOCRUZ/ASTRAZENECA,2329,2113,216
Pendências,240990,RN,Nordeste,PFIZER/BIONTECH,382,382,0
Penedo,270670,AL,Nordeste,FIOCRUZ/ASTRAZENECA,13896,12916,980
Penedo,270670,AL,Nordeste,BUTANTAN/SINOVAC,10854,5627,5227
Penedo,270670,AL,Nordeste,PFIZER/BIONTECH,1675,1675,0
Penha,421250,SC,Sul,BUTANTAN/SINOVAC,6484,3342,3142
Penha,421250,SC,Sul,FIOCRUZ/ASTRAZENECA,6482,6333,149
Penha,421250,SC,Sul,PFIZER/BIONTECH,447,447,0
Pentecoste,231070,CE,Nordeste,BUTANTAN/SINOVAC,2478,2031,447
Pentecoste,231070,CE,Nordeste,FIOCRUZ/ASTRAZENECA,1114,1110,4
Pequeri,314950,MG,Sudeste,FIOCRUZ/ASTRAZENECA,971,896,75
Pequeri,314950,MG,Sudeste,BUTANTAN/SINOVAC,701,357,344
Pequeri,314950,MG,Sudeste,PFIZER/BIONTECH,22,21,1
Pequi,314960,MG,Sudeste,BUTANTAN/SINOVAC,1094,550,544
Pequi,314960,MG,Sudeste,FIOCRUZ/ASTRAZENECA,1079,977,102
Pequi,314960,MG,Sudeste,PFIZER/BIONTECH,53,53,0
Pequizeiro,171665,TO,Norte,BUTANTAN/SINOVAC,981,492,489
Pequizeiro,171665,TO,Norte,FIOCRUZ/ASTRAZENECA,942,899,43
Perdigão,314970,MG,Sudeste,BUTANTAN/SINOVAC,1212,751,461
Perdigão,314970,MG,Sudeste,FIOCRUZ/ASTRAZENECA,595,595,0
Perdizes,314980,MG,Sudeste,BUTANTAN/SINOVAC,679,423,256
Perdizes,314980,MG,Sudeste,FIOCRUZ/ASTRAZENECA,636,633,3
Perdizes,314980,MG,Sudeste,PFIZER/BIONTECH,113,113,0
Perdões,314990,MG,Sudeste,FIOCRUZ/ASTRAZENECA,3954,3866,88
Perdões,314990,MG,Sudeste,BUTANTAN/SINOVAC,3151,2167,984
Perdões,314990,MG,Sudeste,PFIZER/BIONTECH,125,125,0
Pereira Barreto,353740,SP,Sudeste,FIOCRUZ/ASTRAZENECA,7855,7188,667
Pereira Barreto,353740,SP,Sudeste,BUTANTAN/SINOVAC,6742,3438,3304
Pereira Barreto,353740,SP,Sudeste,PFIZER/BIONTECH,155,155,0
Pereiras,353750,SP,Sudeste,FIOCRUZ/ASTRAZENECA,2188,2008,180
Pereiras,353750,SP,Sudeste,BUTANTAN/SINOVAC,1791,783,1008
Pereiras,353750,SP,Sudeste,PFIZER/BIONTECH,54,54,0
Pereiro,231080,CE,Nordeste,BUTANTAN/SINOVAC,2864,1450,1414
Pereiro,231080,CE,Nordeste,FIOCRUZ/ASTRAZENECA,1306,1156,150
Peri Mirim,210840,MA,Nordeste,FIOCRUZ/ASTRAZENECA,2385,2288,97
Peri Mirim,210840,MA,Nordeste,BUTANTAN/SINOVAC,1800,948,852
Periquito,314995,MG,Sudeste,FIOCRUZ/ASTRAZENECA,1155,1064,91
Periquito,314995,MG,Sudeste,BUTANTAN/SINOVAC,1125,610,515
Peritiba,421260,SC,Sul,BUTANTAN/SINOVAC,1019,510,509
Peritiba,421260,SC,Sul,FIOCRUZ/ASTRAZENECA,451,357,94
Peritoró,210845,MA,Nordeste,FIOCRUZ/ASTRAZENECA,4430,4195,235
Peritoró,210845,MA,Nordeste,BUTANTAN/SINOVAC,3470,1794,1676
Perobal,411885,PR,Sul,FIOCRUZ/ASTRAZENECA,1424,1309,115
Perobal,411885,PR,Sul,BUTANTAN/SINOVAC,1281,686,595
Perobal,411885,PR,Sul,PFIZER/BIONTECH,11,11,0
Pérola,411890,PR,Sul,BUTANTAN/SINOVAC,2684,1451,1233
Pérola,411890,PR,Sul,FIOCRUZ/ASTRAZENECA,2323,2107,216
Pérola,411890,PR,Sul,PFIZER/BIONTECH,150,150,0
Pérola D'Oeste,411900,PR,Sul,FIOCRUZ/ASTRAZENECA,2026,1854,172
Pérola D'Oeste,411900,PR,Sul,BUTANTAN/SINOVAC,1660,844,816
Pérola D'Oeste,411900,PR,Sul,PFIZER/BIONTECH,37,37,0
Perolândia,521645,GO,Centro-Oeste,FIOCRUZ/ASTRAZENECA,842,781,61
Perolândia,521645,GO,Centro-Oeste,BUTANTAN/SINOVAC,713,379,334
Peruíbe,353760,SP,Sudeste,BUTANTAN/SINOVAC,15693,8895,6798
Peruíbe,353760,SP,Sudeste,FIOCRUZ/ASTRAZENECA,13951,12948,1003
Peruíbe,353760,SP,Sudeste,PFIZER/BIONTECH,631,631,0
Pescador,315000,MG,Sudeste,BUTANTAN/SINOVAC,1426,732,694
Pescador,315000,MG,Sudeste,FIOCRUZ/ASTRAZENECA,754,688,66
Pescaria Brava,421265,SC,Sul,FIOCRUZ/ASTRAZENECA,2628,2470,158
Pescaria Brava,421265,SC,Sul,BUTANTAN/SINOVAC,2130,1085,1045
Pescaria Brava,421265,SC,Sul,PFIZER/BIONTECH,189,189,0
Pesqueira,261090,PE,Nordeste,BUTANTAN/SINOVAC,22152,11873,10279
Pesqueira,261090,PE,Nordeste,FIOCRUZ/ASTRAZENECA,5780,5105,675
Petrolândia,261100,PE,Nordeste,FIOCRUZ/ASTRAZENECA,5821,5540,281
Petrolândia,261100,PE,Nordeste,BUTANTAN/SINOVAC,4054,2157,1897
Petrolândia,261100,PE,Nordeste,PFIZER/BIONTECH,473,473,0
Petrolândia,421270,SC,Sul,BUTANTAN/SINOVAC,1375,744,631
Petrolândia,421270,SC,Sul,FIOCRUZ/ASTRAZENECA,1370,1230,140
Petrolândia,421270,SC,Sul,PFIZER/BIONTECH,90,90,0
Petrolina,261110,PE,Nordeste,BUTANTAN/SINOVAC,56304,31711,24593
Petrolina,261110,PE,Nordeste,FIOCRUZ/ASTRAZENECA,49251,45935,3316
Petrolina,261110,PE,Nordeste,PFIZER/BIONTECH,6346,6340,6
Petrolina De Goiás,521680,GO,Centro-Oeste,FIOCRUZ/ASTRAZENECA,2421,2290,131
Petrolina De Goiás,521680,GO,Centro-Oeste,BUTANTAN/SINOVAC,1887,960,927
Petrolina De Goiás,521680,GO,Centro-Oeste,PFIZER/BIONTECH,150,150,0
Petrópolis,330390,RJ,Sudeste,BUTANTAN/SINOVAC,56232,32109,24123
Petrópolis,330390,RJ,Sudeste,FIOCRUZ/ASTRAZENECA,44188,41005,3183
Petrópolis,330390,RJ,Sudeste,PFIZER/BIONTECH,2802,2800,2
Piaçabuçu,270680,AL,Nordeste,FIOCRUZ/ASTRAZENECA,2991,2692,299
Piaçabuçu,270680,AL,Nordeste,BUTANTAN/SINOVAC,2722,1384,1338
Piacatu,353770,SP,Sudeste,BUTANTAN/SINOVAC,1326,694,632
Piacatu,353770,SP,Sudeste,FIOCRUZ/ASTRAZENECA,1064,976,88
Piacatu,353770,SP,Sudeste,PFIZER/BIONTECH,156,156,0
Piancó,251130,PB,Nordeste,BUTANTAN/SINOVAC,4343,2209,2134
Piancó,251130,PB,Nordeste,FIOCRUZ/ASTRAZENECA,2978,2651,327
Piancó,251130,PB,Nordeste,PFIZER/BIONTECH,126,126,0
Piatã,292430,BA,Nordeste,FIOCRUZ/ASTRAZENECA,7442,6413,1029
Piatã,292430,BA,Nordeste,BUTANTAN/SINOVAC,3832,1969,1863
Piatã,292430,BA,Nordeste,PFIZER/BIONTECH,87,87,0
Piau,315010,MG,Sudeste,BUTANTAN/SINOVAC,853,434,419
Piau,315010,MG,Sudeste,FIOCRUZ/ASTRAZENECA,850,781,69
Piau,315010,MG,Sudeste,PFIZER/BIONTECH,34,34,0
Picada Café,431442,RS,Sul,FIOCRUZ/ASTRAZENECA,1604,1470,134
Picada Café,431442,RS,Sul,BUTANTAN/SINOVAC,1408,707,701
Picada Café,431442,RS,Sul,PFIZER/BIONTECH,156,156,0
Piçarra,150563,PA,Norte,FIOCRUZ/ASTRAZENECA,1399,1313,86
Piçarra,150563,PA,Norte,BUTANTAN/SINOVAC,573,366,207
Picos,220800,PI,Nordeste,BUTANTAN/SINOVAC,13849,7007,6842
Picos,220800,PI,Nordeste,FIOCRUZ/ASTRAZENECA,13826,12276,1550
Picos,220800,PI,Nordeste,PFIZER/BIONTECH,978,978,0
Picuí,251140,PB,Nordeste,BUTANTAN/SINOVAC,4449,2292,2157
Picuí,251140,PB,Nordeste,FIOCRUZ/ASTRAZENECA,3746,3358,388
Picuí,251140,PB,Nordeste,PFIZER/BIONTECH,350,350,0
Piedade,353780,SP,Sudeste,BUTANTAN/SINOVAC,10472,5152,5320
Piedade,353780,SP,Sudeste,FIOCRUZ/ASTRAZENECA,9398,8610,788
Piedade,353780,SP,Sudeste,PFIZER/BIONTECH,747,746,1
Piedade De Caratinga,315015,MG,Sudeste,BUTANTAN/SINOVAC,1370,696,674
Piedade De Caratinga,315015,MG,Sudeste,FIOCRUZ/ASTRAZENECA,1273,1172,101
Piedade De Caratinga,315015,MG,Sudeste,PFIZER/BIONTECH,37,37,0
Piedade De Ponte Nova,315020,MG,Sudeste,BUTANTAN/SINOVAC,1145,576,569
Piedade De Ponte Nova,315020,MG,Sudeste,FIOCRUZ/ASTRAZENECA,952,873,79
Piedade De Ponte Nova,315020,MG,Sudeste,PFIZER/BIONTECH,46,46,0
Piedade Do Rio Grande,315030,MG,Sudeste,BUTANTAN/SINOVAC,1239,663,576
Piedade Do Rio Grande,315030,MG,Sudeste,FIOCRUZ/ASTRAZENECA,1188,1082,106
Piedade Do Rio Grande,315030,MG,Sudeste,PFIZER/BIONTECH,18,17,1
Piedade Dos Gerais,315040,MG,Sudeste,FIOCRUZ/ASTRAZENECA,1277,1168,109
Piedade Dos Gerais,315040,MG,Sudeste,BUTANTAN/SINOVAC,1265,638,627
Piedade Dos Gerais,315040,MG,Sudeste,PFIZER/BIONTECH,79,79,0
Piên,411910,PR,Sul,FIOCRUZ/ASTRAZENECA,2641,2550,91
Piên,411910,PR,Sul,BUTANTAN/SINOVAC,1750,936,814
Pilão Arcado,292440,BA,Nordeste,BUTANTAN/SINOVAC,5841,3444,2397
Pilão Arcado,292440,BA,Nordeste,FIOCRUZ/ASTRAZENECA,4933,4656,277
Pilão Arcado,292440,BA,Nordeste,PFIZER/BIONTECH,303,302,1
Pilar,251150,PB,Nordeste,BUTANTAN/SINOVAC,2556,1312,1244
Pilar,251150,PB,Nordeste,FIOCRUZ/ASTRAZENECA,2549,2365,184
Pilar,251150,PB,Nordeste,PFIZER/BIONTECH,262,262,0
Pilar,270690,AL,Nordeste,FIOCRUZ/ASTRAZENECA,7372,6874,498
Pilar,270690,AL,Nordeste,BUTANTAN/SINOVAC,5870,3021,2849
Pilar De Goiás,521690,GO,Centro-Oeste,FIOCRUZ/ASTRAZENECA,1288,1249,39
Pilar De Goiás,521690,GO,Centro-Oeste,BUTANTAN/SINOVAC,554,312,242
Pilar De Goiás,521690,GO,Centro-Oeste,PFIZER/BIONTECH,6,6,0
Pilar Do Sul,353790,SP,Sudeste,BUTANTAN/SINOVAC,6517,3309,3208
Pilar Do Sul,353790,SP,Sudeste,FIOCRUZ/ASTRAZENECA,5529,5046,483
Pilar Do Sul,353790,SP,Sudeste,PFIZER/BIONTECH,625,625,0
Pilões,241000,RN,Nordeste,BUTANTAN/SINOVAC,3381,1734,1647
Pilões,241000,RN,Nordeste,FIOCRUZ/ASTRAZENECA,2893,2685,208
Pilões,241000,RN,Nordeste,PFIZER/BIONTECH,297,297,0
Pilões,251160,PB,Nordeste,BUTANTAN/SINOVAC,1516,780,736
Pilões,251160,PB,Nordeste,FIOCRUZ/ASTRAZENECA,790,721,69
Pilões,251160,PB,Nordeste,PFIZER/BIONTECH,61,61,0
Pilõezinhos,251170,PB,Nordeste,BUTANTAN/SINOVAC,912,468,444
Pilõezinhos,251170,PB,Nordeste,FIOCRUZ/ASTRAZENECA,540,510,30
Pilõezinhos,251170,PB,Nordeste,PFIZER/BIONTECH,12,12,0
Pimenta,315050,MG,Sudeste,FIOCRUZ/ASTRAZENECA,1808,1692,116
Pimenta,315050,MG,Sudeste,BUTANTAN/SINOVAC,1663,842,821
Pimenta,315050,MG,Sudeste,PFIZER/BIONTECH,44,44,0
Pimenta Bueno,110018,RO,Norte,FIOCRUZ/ASTRAZENECA,6150,5897,253
Pimenta Bueno,110018,RO,Norte,BUTANTAN/SINOVAC,5617,2928,2689
Pimenta Bueno,110018,RO,Norte,PFIZER/BIONTECH,1043,1042,1
Pimenteiras,220810,PI,Nordeste,FIOCRUZ/ASTRAZENECA,2242,2060,182
Pimenteiras,220810,PI,Nordeste,BUTANTAN/SINOVAC,1958,1030,928
Pimenteiras Do Oeste,110146,RO,Norte,BUTANTAN/SINOVAC,696,391,305
Pimenteiras Do Oeste,110146,RO,Norte,FIOCRUZ/ASTRAZENECA,679,644,35
Pindaí,292450,BA,Nordeste,BUTANTAN/SINOVAC,3514,1819,1695
Pindaí,292450,BA,Nordeste,FIOCRUZ/ASTRAZENECA,3423,3191,232
Pindamonhangaba,353800,SP,Sudeste,FIOCRUZ/ASTRAZENECA,32232,30183,2049
Pindamonhangaba,353800,SP,Sudeste,BUTANTAN/SINOVAC,29638,14931,14707
Pindamonhangaba,353800,SP,Sudeste,PFIZER/BIONTECH,1667,1667,0
Pindaré-Mirim,210850,MA,Nordeste,FIOCRUZ/ASTRAZENECA,6534,6211,323
Pindaré-Mirim,210850,MA,Nordeste,BUTANTAN/SINOVAC,4873,2640,2233
Pindoba,270700,AL,Nordeste,BUTANTAN/SINOVAC,569,294,275
Pindoba,270700,AL,Nordeste,FIOCRUZ/ASTRAZENECA,566,520,46
Pindobaçu,292460,BA,Nordeste,FIOCRUZ/ASTRAZENECA,4837,4784,53
Pindobaçu,292460,BA,Nordeste,BUTANTAN/SINOVAC,3215,1765,1450
Pindobaçu,292460,BA,Nordeste,PFIZER/BIONTECH,17,17,0
Pindorama,353810,SP,Sudeste,BUTANTAN/SINOVAC,4225,2282,1943
Pindorama,353810,SP,Sudeste,FIOCRUZ/ASTRAZENECA,4043,3636,407
Pindorama,353810,SP,Sudeste,PFIZER/BIONTECH,311,311,0
Pindorama Do Tocantins,171700,TO,Norte,BUTANTAN/SINOVAC,740,381,359
Pindorama Do Tocantins,171700,TO,Norte,FIOCRUZ/ASTRAZENECA,605,573,32
Pindoretama,231085,CE,Nordeste,BUTANTAN/SINOVAC,1051,723,328
Pindoretama,231085,CE,Nordeste,FIOCRUZ/ASTRAZENECA,515,514,1
Pingo-D'Água,315053,MG,Sudeste,BUTANTAN/SINOVAC,873,439,434
Pingo-D'Água,315053,MG,Sudeste,FIOCRUZ/ASTRAZENECA,740,688,52
Pinhais,411915,PR,Sul,FIOCRUZ/ASTRAZENECA,28898,27521,1377
Pinhais,411915,PR,Sul,BUTANTAN/SINOVAC,19421,10113,9308
Pinhais,411915,PR,Sul,PFIZER/BIONTECH,5666,5666,0
Pinhal,431445,RS,Sul,BUTANTAN/SINOVAC,870,444,426
Pinhal,431445,RS,Sul,FIOCRUZ/ASTRAZENECA,702,650,52
Pinhal,431445,RS,Sul,PFIZER/BIONTECH,114,114,0
Pinhal Da Serra,431446,RS,Sul,FIOCRUZ/ASTRAZENECA,789,746,43
Pinhal Da Serra,431446,RS,Sul,BUTANTAN/SINOVAC,488,243,245
Pinhal Da Serra,431446,RS,Sul,PFIZER/BIONTECH,73,73,0
Pinhal De São Bento,411925,PR,Sul,FIOCRUZ/ASTRAZENECA,988,935,53
Pinhal De São Bento,411925,PR,Sul,BUTANTAN/SINOVAC,776,479,297
Pinhal De São Bento,411925,PR,Sul,PFIZER/BIONTECH,23,23,0
Pinhal Grande,431447,RS,Sul,FIOCRUZ/ASTRAZENECA,1376,1201,175
Pinhal Grande,431447,RS,Sul,BUTANTAN/SINOVAC,1201,604,597
Pinhal Grande,431447,RS,Sul,PFIZER/BIONTECH,180,180,0
Pinhalão,411920,PR,Sul,FIOCRUZ/ASTRAZENECA,1886,1723,163
Pinhalão,411920,PR,Sul,BUTANTAN/SINOVAC,1552,855,697
Pinhalão,411920,PR,Sul,PFIZER/BIONTECH,30,30,0
Pinhalzinho,353820,SP,Sudeste,BUTANTAN/SINOVAC,3610,1842,1768
Pinhalzinho,353820,SP,Sudeste,FIOCRUZ/ASTRAZENECA,3415,3177,238
Pinhalzinho,353820,SP,Sudeste,PFIZER/BIONTECH,92,92,0
Pinhalzinho,421290,SC,Sul,FIOCRUZ/ASTRAZENECA,4809,4416,393
Pinhalzinho,421290,SC,Sul,BUTANTAN/SINOVAC,3664,1940,1724
Pinhalzinho,421290,SC,Sul,PFIZER/BIONTECH,559,559,0
Pinhão,280520,SE,Nordeste,BUTANTAN/SINOVAC,1741,894,847
Pinhão,280520,SE,Nordeste,FIOCRUZ/ASTRAZENECA,693,693,0
Pinhão,280520,SE,Nordeste,PFIZER/BIONTECH,28,28,0
Pinhão,411930,PR,Sul,FIOCRUZ/ASTRAZENECA,7212,6982,230
Pinhão,411930,PR,Sul,BUTANTAN/SINOVAC,4742,2515,2227
Pinhão,411930,PR,Sul,PFIZER/BIONTECH,318,318,0
Pinheiral,330395,RJ,Sudeste,FIOCRUZ/ASTRAZENECA,7613,6183,1430
Pinheiral,330395,RJ,Sudeste,BUTANTAN/SINOVAC,7559,4154,3405
Pinheiral,330395,RJ,Sudeste,PFIZER/BIONTECH,1360,1359,1
Pinheirinho Do Vale,431449,RS,Sul,BUTANTAN/SINOVAC,1305,663,642
Pinheirinho Do Vale,431449,RS,Sul,FIOCRUZ/ASTRAZENECA,1082,1033,49
Pinheirinho Do Vale,431449,RS,Sul,PFIZER/BIONTECH,119,119,0
Pinheiro,210860,MA,Nordeste,FIOCRUZ/ASTRAZENECA,24190,23161,1029
Pinheiro,210860,MA,Nordeste,BUTANTAN/SINOVAC,12260,6232,6028
Pinheiro,210860,MA,Nordeste,PFIZER/BIONTECH,169,169,0
Pinheiro Machado,431450,RS,Sul,BUTANTAN/SINOVAC,3515,1779,1736
Pinheiro Machado,431450,RS,Sul,FIOCRUZ/ASTRAZENECA,3496,3141,355
Pinheiro Machado,431450,RS,Sul,PFIZER/BIONTECH,358,358,0
Pinheiro Preto,421300,SC,Sul,FIOCRUZ/ASTRAZENECA,1001,937,64
Pinheiro Preto,421300,SC,Sul,BUTANTAN/SINOVAC,716,376,340
Pinheiro Preto,421300,SC,Sul,PFIZER/BIONTECH,53,53,0
Pinheiros,320410,ES,Sudeste,BUTANTAN/SINOVAC,6169,3207,2962
Pinheiros,320410,ES,Sudeste,FIOCRUZ/ASTRAZENECA,4841,4618,223
Pinheiros,320410,ES,Sudeste,PFIZER/BIONTECH,1020,1020,0
Pintadas,292465,BA,Nordeste,BUTANTAN/SINOVAC,2441,1309,1132
Pintadas,292465,BA,Nordeste,FIOCRUZ/ASTRAZENECA,1936,1646,290
Pintadas,292465,BA,Nordeste,PFIZER/BIONTECH,285,284,1
Pinto Bandeira,431454,RS,Sul,BUTANTAN/SINOVAC,1162,634,528
Pinto Bandeira,431454,RS,Sul,FIOCRUZ/ASTRAZENECA,709,556,153
Pinto Bandeira,431454,RS,Sul,PFIZER/BIONTECH,22,22,0
Pintópolis,315057,MG,Sudeste,BUTANTAN/SINOVAC,1450,763,687
Pintópolis,315057,MG,Sudeste,FIOCRUZ/ASTRAZENECA,1372,1248,124
Pintópolis,315057,MG,Sudeste,PFIZER/BIONTECH,34,34,0
Pio Ix,220820,PI,Nordeste,BUTANTAN/SINOVAC,2323,1259,1064
Pio Ix,220820,PI,Nordeste,FIOCRUZ/ASTRAZENECA,2119,1932,187
Pio Xii,210870,MA,Nordeste,FIOCRUZ/ASTRAZENECA,4052,3821,231
Pio Xii,210870,MA,Nordeste,BUTANTAN/SINOVAC,3787,2099,1688
Piquerobi,353830,SP,Sudeste,BUTANTAN/SINOVAC,1118,592,526
Piquerobi,353830,SP,Sudeste,FIOCRUZ/ASTRAZENECA,1037,939,98
Piquerobi,353830,SP,Sudeste,PFIZER/BIONTECH,108,108,0
Piquet Carneiro,231090,CE,Nordeste,BUTANTAN/SINOVAC,3465,1786,1679
Piquet Carneiro,231090,CE,Nordeste,FIOCRUZ/ASTRAZENECA,1805,1470,335
Piquete,353850,SP,Sudeste,BUTANTAN/SINOVAC,3621,1955,1666
Piquete,353850,SP,Sudeste,FIOCRUZ/ASTRAZENECA,3513,3193,320
Piquete,353850,SP,Sudeste,PFIZER/BIONTECH,1,1,0
Piracaia,353860,SP,Sudeste,BUTANTAN/SINOVAC,6055,3240,2815
Piracaia,353860,SP,Sudeste,FIOCRUZ/ASTRAZENECA,5702,5231,471
Piracaia,353860,SP,Sudeste,PFIZER/BIONTECH,429,429,0
Piracanjuba,521710,GO,Centro-Oeste,FIOCRUZ/ASTRAZENECA,6616,6134,482
Piracanjuba,521710,GO,Centro-Oeste,BUTANTAN/SINOVAC,6220,3202,3018
Piracanjuba,521710,GO,Centro-Oeste,PFIZER/BIONTECH,72,72,0
Piracema,315060,MG,Sudeste,FIOCRUZ/ASTRAZENECA,1731,1587,144
Piracema,315060,MG,Sudeste,BUTANTAN/SINOVAC,1587,806,781
Piracema,315060,MG,Sudeste,PFIZER/BIONTECH,75,75,0
Piracicaba,353870,SP,Sudeste,BUTANTAN/SINOVAC,83867,46102,37765
Piracicaba,353870,SP,Sudeste,FIOCRUZ/ASTRAZENECA,78515,71698,6817
Piracicaba,353870,SP,Sudeste,PFIZER/BIONTECH,4040,4036,4
Piracuruca,220830,PI,Nordeste,FIOCRUZ/ASTRAZENECA,5795,5445,350
Piracuruca,220830,PI,Nordeste,BUTANTAN/SINOVAC,4409,2300,2109
Piraí,330400,RJ,Sudeste,FIOCRUZ/ASTRAZENECA,6400,5724,676
Piraí,330400,RJ,Sudeste,BUTANTAN/SINOVAC,5621,2876,2745
Piraí,330400,RJ,Sudeste,PFIZER/BIONTECH,524,524,0
Piraí Do Norte,292467,BA,Nordeste,FIOCRUZ/ASTRAZENECA,1391,1290,101
Piraí Do Norte,292467,BA,Nordeste,BUTANTAN/SINOVAC,1180,698,482
Piraí Do Norte,292467,BA,Nordeste,PFIZER/BIONTECH,34,24,10
Piraí Do Sul,411940,PR,Sul,FIOCRUZ/ASTRAZENECA,5361,5046,315
Piraí Do Sul,411940,PR,Sul,BUTANTAN/SINOVAC,4877,2528,2349
Piraí Do Sul,411940,PR,Sul,PFIZER/BIONTECH,67,67,0
Piraju,353880,SP,Sudeste,BUTANTAN/SINOVAC,8104,4053,4051
Piraju,353880,SP,Sudeste,FIOCRUZ/ASTRAZENECA,7760,7182,578
Piraju,353880,SP,Sudeste,PFIZER/BIONTECH,729,729,0
Pirajuba,315070,MG,Sudeste,BUTANTAN/SINOVAC,732,362,370
Pirajuba,315070,MG,Sudeste,FIOCRUZ/ASTRAZENECA,643,553,90
Pirajuí,353890,SP,Sudeste,BUTANTAN/SINOVAC,5821,3149,2672
Pirajuí,353890,SP,Sudeste,FIOCRUZ/ASTRAZENECA,3815,3370,445
Pirajuí,353890,SP,Sudeste,PFIZER/BIONTECH,168,168,0
Pirambu,280530,SE,Nordeste,BUTANTAN/SINOVAC,1763,892,871
Pirambu,280530,SE,Nordeste,FIOCRUZ/ASTRAZENECA,546,540,6
Piranga,315080,MG,Sudeste,FIOCRUZ/ASTRAZENECA,1235,1112,123
Piranga,315080,MG,Sudeste,BUTANTAN/SINOVAC,1153,671,482
Pirangi,353900,SP,Sudeste,BUTANTAN/SINOVAC,3048,1480,1568
Pirangi,353900,SP,Sudeste,FIOCRUZ/ASTRAZENECA,2717,2426,291
Pirangi,353900,SP,Sudeste,PFIZER/BIONTECH,200,200,0
Piranguçu,315090,MG,Sudeste,BUTANTAN/SINOVAC,1435,740,695
Piranguçu,315090,MG,Sudeste,FIOCRUZ/ASTRAZENECA,1235,1144,91
Piranguçu,315090,MG,Sudeste,PFIZER/BIONTECH,111,111,0
Piranguinho,315100,MG,Sudeste,BUTANTAN/SINOVAC,1766,903,863
Piranguinho,315100,MG,Sudeste,FIOCRUZ/ASTRAZENECA,1150,1086,64
Piranguinho,315100,MG,Sudeste,PFIZER/BIONTECH,33,33,0
Piranhas,270710,AL,Nordeste,BUTANTAN/SINOVAC,3855,2229,1626
Piranhas,270710,AL,Nordeste,FIOCRUZ/ASTRAZENECA,3439,3166,273
Piranhas,521720,GO,Centro-Oeste,FIOCRUZ/ASTRAZENECA,3085,2888,197
Piranhas,521720,GO,Centro-Oeste,BUTANTAN/SINOVAC,2666,1410,1256
Pirapemas,210880,MA,Nordeste,FIOCRUZ/ASTRAZENECA,3159,2963,196
Pirapemas,210880,MA,Nordeste,BUTANTAN/SINOVAC,2598,1370,1228
Pirapetinga,315110,MG,Sudeste,FIOCRUZ/ASTRAZENECA,2514,2304,210
Pirapetinga,315110,MG,Sudeste,BUTANTAN/SINOVAC,1995,1139,856
Pirapetinga,315110,MG,Sudeste,PFIZER/BIONTECH,143,143,0
Pirapó,431455,RS,Sul,BUTANTAN/SINOVAC,1127,581,546
Pirapó,431455,RS,Sul,FIOCRUZ/ASTRAZENECA,728,680,48
Pirapó,431455,RS,Sul,PFIZER/BIONTECH,99,99,0
Pirapora,315120,MG,Sudeste,BUTANTAN/SINOVAC,10795,5621,5174
Pirapora,315120,MG,Sudeste,FIOCRUZ/ASTRAZENECA,10436,9630,806
Pirapora,315120,MG,Sudeste,PFIZER/BIONTECH,2445,2445,0
Pirapora Do Bom Jesus,353910,SP,Sudeste,FIOCRUZ/ASTRAZENECA,2900,2692,208
Pirapora Do Bom Jesus,353910,SP,Sudeste,BUTANTAN/SINOVAC,2181,1166,1015
Pirapora Do Bom Jesus,353910,SP,Sudeste,PFIZER/BIONTECH,265,264,1
Pirapozinho,353920,SP,Sudeste,FIOCRUZ/ASTRAZENECA,6512,6080,432
Pirapozinho,353920,SP,Sudeste,BUTANTAN/SINOVAC,5602,3174,2428
Pirapozinho,353920,SP,Sudeste,PFIZER/BIONTECH,670,669,1
Piraquara,411950,PR,Sul,FIOCRUZ/ASTRAZENECA,18369,17458,911
Piraquara,411950,PR,Sul,BUTANTAN/SINOVAC,14694,7801,6893
Piraquara,411950,PR,Sul,PFIZER/BIONTECH,3465,3463,2
Piraquê,171720,TO,Norte,BUTANTAN/SINOVAC,660,368,292
Piraquê,171720,TO,Norte,FIOCRUZ/ASTRAZENECA,413,391,22
Pirassununga,353930,SP,Sudeste,BUTANTAN/SINOVAC,18758,9396,9362
Pirassununga,353930,SP,Sudeste,FIOCRUZ/ASTRAZENECA,18275,16871,1404
Pirassununga,353930,SP,Sudeste,PFIZER/BIONTECH,1534,1534,0
Piratini,431460,RS,Sul,BUTANTAN/SINOVAC,5869,2965,2904
Piratini,431460,RS,Sul,FIOCRUZ/ASTRAZENECA,5507,5044,463
Piratini,431460,RS,Sul,PFIZER/BIONTECH,298,298,0
Piratininga,353940,SP,Sudeste,FIOCRUZ/ASTRAZENECA,3979,3540,439
Piratininga,353940,SP,Sudeste,BUTANTAN/SINOVAC,3814,2063,1751
Piratininga,353940,SP,Sudeste,PFIZER/BIONTECH,261,261,0
Piratuba,421310,SC,Sul,BUTANTAN/SINOVAC,1382,723,659
Piratuba,421310,SC,Sul,FIOCRUZ/ASTRAZENECA,1253,1125,128
Piratuba,421310,SC,Sul,PFIZER/BIONTECH,113,113,0
Piraúba,315130,MG,Sudeste,FIOCRUZ/ASTRAZENECA,2835,2678,157
Piraúba,315130,MG,Sudeste,BUTANTAN/SINOVAC,2800,1428,1372
Piraúba,315130,MG,Sudeste,PFIZER/BIONTECH,222,222,0
Pirenópolis,521730,GO,Centro-Oeste,FIOCRUZ/ASTRAZENECA,7271,6790,481
Pirenópolis,521730,GO,Centro-Oeste,BUTANTAN/SINOVAC,4755,2600,2155
Pirenópolis,521730,GO,Centro-Oeste,PFIZER/BIONTECH,57,57,0
Pires Do Rio,521740,GO,Centro-Oeste,FIOCRUZ/ASTRAZENECA,10531,9367,1164
Pires Do Rio,521740,GO,Centro-Oeste,BUTANTAN/SINOVAC,5869,3247,2622
Pires Ferreira,231095,CE,Nordeste,FIOCRUZ/ASTRAZENECA,3051,2807,244
Pires Ferreira,231095,CE,Nordeste,BUTANTAN/SINOVAC,2264,1180,1084
Pires Ferreira,231095,CE,Nordeste,PFIZER/BIONTECH,182,182,0
Piripá,292470,BA,Nordeste,BUTANTAN/SINOVAC,3031,1611,1420
Piripá,292470,BA,Nordeste,FIOCRUZ/ASTRAZENECA,2385,2199,186
Piripá,292470,BA,Nordeste,PFIZER/BIONTECH,167,167,0
Piripiri,220840,PI,Nordeste,FIOCRUZ/ASTRAZENECA,11492,10702,790
Piripiri,220840,PI,Nordeste,BUTANTAN/SINOVAC,11140,5949,5191
Piripiri,220840,PI,Nordeste,PFIZER/BIONTECH,1450,1450,0
Piritiba,292480,BA,Nordeste,BUTANTAN/SINOVAC,4654,2408,2246
Piritiba,292480,BA,Nordeste,FIOCRUZ/ASTRAZENECA,4416,3871,545
Piritiba,292480,BA,Nordeste,PFIZER/BIONTECH,68,68,0
Pirpirituba,251180,PB,Nordeste,BUTANTAN/SINOVAC,2750,1550,1200
Pirpirituba,251180,PB,Nordeste,FIOCRUZ/ASTRAZENECA,1722,1563,159
Pirpirituba,251180,PB,Nordeste,PFIZER/BIONTECH,104,104,0
Pitanga,411960,PR,Sul,FIOCRUZ/ASTRAZENECA,9437,9099,338
Pitanga,411960,PR,Sul,BUTANTAN/SINOVAC,6439,3375,3064
Pitanga,411960,PR,Sul,PFIZER/BIONTECH,1104,1104,0
Pitangueiras,353950,SP,Sudeste,FIOCRUZ/ASTRAZENECA,6967,6122,845
Pitangueiras,353950,SP,Sudeste,BUTANTAN/SINOVAC,6913,3466,3447
Pitangueiras,353950,SP,Sudeste,PFIZER/BIONTECH,561,561,0
Pitangueiras,411965,PR,Sul,FIOCRUZ/ASTRAZENECA,1273,1221,52
Pitangueiras,411965,PR,Sul,BUTANTAN/SINOVAC,763,391,372
Pitangui,315140,MG,Sudeste,BUTANTAN/SINOVAC,4658,2498,2160
Pitangui,315140,MG,Sudeste,FIOCRUZ/ASTRAZENECA,3796,3480,316
Pitimbu,251190,PB,Nordeste,BUTANTAN/SINOVAC,2724,1615,1109
Pitimbu,251190,PB,Nordeste,FIOCRUZ/ASTRAZENECA,490,370,120
Pium,171750,TO,Norte,BUTANTAN/SINOVAC,1697,893,804
Pium,171750,TO,Norte,FIOCRUZ/ASTRAZENECA,1230,1167,63
Piúma,320420,ES,Sudeste,BUTANTAN/SINOVAC,5366,2993,2373
Piúma,320420,ES,Sudeste,FIOCRUZ/ASTRAZENECA,3574,3463,111
Piúma,320420,ES,Sudeste,PFIZER/BIONTECH,438,438,0
Piumhi,315150,MG,Sudeste,BUTANTAN/SINOVAC,7985,4085,3900
Piumhi,315150,MG,Sudeste,FIOCRUZ/ASTRAZENECA,5966,5615,351
Piumhi,315150,MG,Sudeste,PFIZER/BIONTECH,592,592,0
Placas,150565,PA,Norte,FIOCRUZ/ASTRAZENECA,2533,2089,444
Placas,150565,PA,Norte,BUTANTAN/SINOVAC,1163,648,515
Plácido De Castro,120038,AC,Norte,FIOCRUZ/ASTRAZENECA,3653,3209,444
Plácido De Castro,120038,AC,Norte,BUTANTAN/SINOVAC,1631,894,737
Plácido De Castro,120038,AC,Norte,PFIZER/BIONTECH,184,183,1
Planaltina,521760,GO,Centro-Oeste,FIOCRUZ/ASTRAZENECA,19976,19008,968
Planaltina,521760,GO,Centro-Oeste,BUTANTAN/SINOVAC,8209,4344,3865
Planaltina,521760,GO,Centro-Oeste,PFIZER/BIONTECH,1119,1118,1
Planaltina Do Paraná,411970,PR,Sul,FIOCRUZ/ASTRAZENECA,1126,1039,87
Planaltina Do Paraná,411970,PR,Sul,BUTANTAN/SINOVAC,1050,580,470
Planaltina Do Paraná,411970,PR,Sul,PFIZER/BIONTECH,17,17,0
Planaltino,292490,BA,Nordeste,BUTANTAN/SINOVAC,143,79,64
Planaltino,292490,BA,Nordeste,FIOCRUZ/ASTRAZENECA,78,78,0
Planalto,292500,BA,Nordeste,BUTANTAN/SINOVAC,4027,1986,2041
Planalto,292500,BA,Nordeste,FIOCRUZ/ASTRAZENECA,3475,3173,302
Planalto,292500,BA,Nordeste,PFIZER/BIONTECH,30,30,0
Planalto,353960,SP,Sudeste,FIOCRUZ/ASTRAZENECA,1201,1110,91
Planalto,353960,SP,Sudeste,BUTANTAN/SINOVAC,1146,610,536
Planalto,353960,SP,Sudeste,PFIZER/BIONTECH,111,111,0
Planalto,411980,PR,Sul,FIOCRUZ/ASTRAZENECA,3697,3498,199
Planalto,411980,PR,Sul,BUTANTAN/SINOVAC,3446,1774,1672
Planalto,411980,PR,Sul,PFIZER/BIONTECH,179,179,0
Planalto,431470,RS,Sul,BUTANTAN/SINOVAC,4678,2527,2151
Planalto,431470,RS,Sul,FIOCRUZ/ASTRAZENECA,1874,1736,138
Planalto,431470,RS,Sul,PFIZER/BIONTECH,290,290,0
Planalto Alegre,421315,SC,Sul,BUTANTAN/SINOVAC,1316,709,607
Planalto Alegre,421315,SC,Sul,FIOCRUZ/ASTRAZENECA,1237,1078,159
Planalto Alegre,421315,SC,Sul,PFIZER/BIONTECH,31,31,0
Planalto Da Serra,510645,MT,Centro-Oeste,BUTANTAN/SINOVAC,685,344,341
Planalto Da Serra,510645,MT,Centro-Oeste,FIOCRUZ/ASTRAZENECA,564,445,119
Planalto Da Serra,510645,MT,Centro-Oeste,PFIZER/BIONTECH,53,53,0
Planura,315160,MG,Sudeste,BUTANTAN/SINOVAC,1632,818,814
Planura,315160,MG,Sudeste,FIOCRUZ/ASTRAZENECA,822,712,110
Platina,353970,SP,Sudeste,BUTANTAN/SINOVAC,774,386,388
Platina,353970,SP,Sudeste,FIOCRUZ/ASTRAZENECA,767,692,75
Platina,353970,SP,Sudeste,PFIZER/BIONTECH,101,100,1
Poá,353980,SP,Sudeste,FIOCRUZ/ASTRAZENECA,21964,20355,1609
Poá,353980,SP,Sudeste,BUTANTAN/SINOVAC,18527,10383,8144
Poá,353980,SP,Sudeste,PFIZER/BIONTECH,533,529,4
Poção,261120,PE,Nordeste,FIOCRUZ/ASTRAZENECA,2287,2091,196
Poção,261120,PE,Nordeste,BUTANTAN/SINOVAC,1994,1000,994
Poção,261120,PE,Nordeste,PFIZER/BIONTECH,285,285,0
Poção De Pedras,210890,MA,Nordeste,FIOCRUZ/ASTRAZENECA,4274,4045,229
Poção De Pedras,210890,MA,Nordeste,BUTANTAN/SINOVAC,3164,1632,1532
Pocinhos,251200,PB,Nordeste,BUTANTAN/SINOVAC,3806,1962,1844
Pocinhos,251200,PB,Nordeste,FIOCRUZ/ASTRAZENECA,2955,2674,281
Pocinhos,251200,PB,Nordeste,PFIZER/BIONTECH,364,364,0
Poço Branco,241010,RN,Nordeste,BUTANTAN/SINOVAC,2289,1214,1075
Poço Branco,241010,RN,Nordeste,FIOCRUZ/ASTRAZENECA,1954,1837,117
Poço Branco,241010,RN,Nordeste,PFIZER/BIONTECH,253,253,0
Poço Dantas,251203,PB,Nordeste,BUTANTAN/SINOVAC,731,376,355
Poço Dantas,251203,PB,Nordeste,FIOCRUZ/ASTRAZENECA,620,561,59
Poço Dantas,251203,PB,Nordeste,PFIZER/BIONTECH,72,72,0
Poço Das Antas,431475,RS,Sul,BUTANTAN/SINOVAC,785,392,393
Poço Das Antas,431475,RS,Sul,FIOCRUZ/ASTRAZENECA,593,492,101
Poço Das Antas,431475,RS,Sul,PFIZER/BIONTECH,60,60,0
Poço Das Trincheiras,270720,AL,Nordeste,FIOCRUZ/ASTRAZENECA,3582,3409,173
Poço Das Trincheiras,270720,AL,Nordeste,BUTANTAN/SINOVAC,1519,819,700
Poço De José De Moura,251207,PB,Nordeste,BUTANTAN/SINOVAC,1168,607,561
Poço De José De Moura,251207,PB,Nordeste,FIOCRUZ/ASTRAZENECA,995,904,91
Poço De José De Moura,251207,PB,Nordeste,PFIZER/BIONTECH,91,91,0
Poço Fundo,315170,MG,Sudeste,BUTANTAN/SINOVAC,3873,1918,1955
Poço Fundo,315170,MG,Sudeste,FIOCRUZ/ASTRAZENECA,2798,2609,189
Poço Fundo,315170,MG,Sudeste,PFIZER/BIONTECH,126,126,0
Poço Redondo,280540,SE,Nordeste,BUTANTAN/SINOVAC,5382,2797,2585
Poço Redondo,280540,SE,Nordeste,FIOCRUZ/ASTRAZENECA,4774,4593,181
Poço Redondo,280540,SE,Nordeste,PFIZER/BIONTECH,379,379,0
Poço Verde,280550,SE,Nordeste,BUTANTAN/SINOVAC,5007,2738,2269
Poço Verde,280550,SE,Nordeste,FIOCRUZ/ASTRAZENECA,3523,3448,75
Poço Verde,280550,SE,Nordeste,PFIZER/BIONTECH,191,191,0
Poções,292510,BA,Nordeste,BUTANTAN/SINOVAC,10631,6167,4464
Poções,292510,BA,Nordeste,FIOCRUZ/ASTRAZENECA,7460,7061,399
Poções,292510,BA,Nordeste,PFIZER/BIONTECH,107,107,0
Poconé,510650,MT,Centro-Oeste,FIOCRUZ/ASTRAZENECA,9569,8790,779
Poconé,510650,MT,Centro-Oeste,BUTANTAN/SINOVAC,5876,3109,2767
Poconé,510650,MT,Centro-Oeste,PFIZER/BIONTECH,67,67,0
Poços De Caldas,315180,MG,Sudeste,BUTANTAN/SINOVAC,40029,20250,19779
Poços De Caldas,315180,MG,Sudeste,FIOCRUZ/ASTRAZENECA,37495,34130,3365
Poços De Caldas,315180,MG,Sudeste,PFIZER/BIONTECH,5122,5107,15
Pocrane,315190,MG,Sudeste,BUTANTAN/SINOVAC,2434,1228,1206
Pocrane,315190,MG,Sudeste,FIOCRUZ/ASTRAZENECA,1818,1673,145
Pocrane,315190,MG,Sudeste,PFIZER/BIONTECH,189,189,0
Pojuca,292520,BA,Nordeste,FIOCRUZ/ASTRAZENECA,5947,5466,481
Pojuca,292520,BA,Nordeste,BUTANTAN/SINOVAC,5193,2677,2516
Pojuca,292520,BA,Nordeste,PFIZER/BIONTECH,889,889,0
Poloni,353990,SP,Sudeste,BUTANTAN/SINOVAC,1840,939,901
Poloni,353990,SP,Sudeste,FIOCRUZ/ASTRAZENECA,1533,1354,179
Poloni,353990,SP,Sudeste,PFIZER/BIONTECH,167,167,0
Pombal,251210,PB,Nordeste,FIOCRUZ/ASTRAZENECA,8240,7610,630
Pombal,251210,PB,Nordeste,BUTANTAN/SINOVAC,8024,4165,3859
Pombal,251210,PB,Nordeste,PFIZER/BIONTECH,551,550,1
Pombos,261130,PE,Nordeste,BUTANTAN/SINOVAC,4393,2553,1840
Pombos,261130,PE,Nordeste,FIOCRUZ/ASTRAZENECA,3640,3392,248
Pombos,261130,PE,Nordeste,PFIZER/BIONTECH,135,135,0
Pomerode,421320,SC,Sul,BUTANTAN/SINOVAC,8066,3927,4139
Pomerode,421320,SC,Sul,FIOCRUZ/ASTRAZENECA,6390,6180,210
Pomerode,421320,SC,Sul,PFIZER/BIONTECH,516,516,0
Pompéia,354000,SP,Sudeste,BUTANTAN/SINOVAC,5852,3043,2809
Pompéia,354000,SP,Sudeste,FIOCRUZ/ASTRAZENECA,5109,4478,631
Pompéia,354000,SP,Sudeste,PFIZER/BIONTECH,239,239,0
Pompéu,315200,MG,Sudeste,BUTANTAN/SINOVAC,5112,2564,2548
Pompéu,315200,MG,Sudeste,FIOCRUZ/ASTRAZENECA,5086,4680,406
Pompéu,315200,MG,Sudeste,PFIZER/BIONTECH,756,756,0
Pongaí,354010,SP,Sudeste,BUTANTAN/SINOVAC,1835,985,850
Pongaí,354010,SP,Sudeste,FIOCRUZ/ASTRAZENECA,1370,1233,137
Pongaí,354010,SP,Sudeste,PFIZER/BIONTECH,79,79,0
Ponta De Pedras,150570,PA,Norte,FIOCRUZ/ASTRAZENECA,9838,8945,893
Ponta De Pedras,150570,PA,Norte,BUTANTAN/SINOVAC,1633,861,772
Ponta Grossa,411990,PR,Sul,BUTANTAN/SINOVAC,54611,27591,27020
Ponta Grossa,411990,PR,Sul,FIOCRUZ/ASTRAZENECA,53974,49448,4526
Ponta Grossa,411990,PR,Sul,PFIZER/BIONTECH,6044,6015,29
Ponta Porã,500660,MS,Centro-Oeste,FIOCRUZ/ASTRAZENECA,20225,18732,1493
Ponta Porã,500660,MS,Centro-Oeste,BUTANTAN/SINOVAC,17572,9375,8197
Ponta Porã,500660,MS,Centro-Oeste,PFIZER/BIONTECH,1757,1753,4
Pontal,354020,SP,Sudeste,FIOCRUZ/ASTRAZENECA,8313,7617,696
Pontal,354020,SP,Sudeste,BUTANTAN/SINOVAC,6040,2850,3190
Pontal,354020,SP,Sudeste,PFIZER/BIONTECH,415,413,2
Pontal Do Araguaia,510665,MT,Centro-Oeste,BUTANTAN/SINOVAC,1105,552,553
Pontal Do Araguaia,510665,MT,Centro-Oeste,FIOCRUZ/ASTRAZENECA,887,817,70
Pontal Do Araguaia,510665,MT,Centro-Oeste,PFIZER/BIONTECH,60,60,0
Pontal Do Paraná,411995,PR,Sul,FIOCRUZ/ASTRAZENECA,9483,9161,322
Pontal Do Paraná,411995,PR,Sul,BUTANTAN/SINOVAC,6747,3577,3170
Pontal Do Paraná,411995,PR,Sul,PFIZER/BIONTECH,384,384,0
Pontalina,521770,GO,Centro-Oeste,FIOCRUZ/ASTRAZENECA,4326,4077,249
Pontalina,521770,GO,Centro-Oeste,BUTANTAN/SINOVAC,3861,1952,1909
Pontalinda,354025,SP,Sudeste,BUTANTAN/SINOVAC,1419,783,636
Pontalinda,354025,SP,Sudeste,FIOCRUZ/ASTRAZENECA,1326,1225,101
Pontalinda,354025,SP,Sudeste,PFIZER/BIONTECH,161,161,0
Pontão,431477,RS,Sul,FIOCRUZ/ASTRAZENECA,1151,994,157
Pontão,431477,RS,Sul,BUTANTAN/SINOVAC,907,484,423
Pontão,431477,RS,Sul,PFIZER/BIONTECH,140,140,0
Ponte Alta,421330,SC,Sul,FIOCRUZ/ASTRAZENECA,1835,1734,101
Ponte Alta,421330,SC,Sul,BUTANTAN/SINOVAC,1355,781,574
Ponte Alta,421330,SC,Sul,PFIZER/BIONTECH,38,38,0
Ponte Alta Do Bom Jesus,171780,TO,Norte,BUTANTAN/SINOVAC,1096,561,535
Ponte Alta Do Bom Jesus,171780,TO,Norte,FIOCRUZ/ASTRAZENECA,983,942,41
Ponte Alta Do Norte,421335,SC,Sul,FIOCRUZ/ASTRAZENECA,691,635,56
Ponte Alta Do Norte,421335,SC,Sul,BUTANTAN/SINOVAC,668,339,329
Ponte Alta Do Tocantins,171790,TO,Norte,BUTANTAN/SINOVAC,1177,614,563
Ponte Alta Do Tocantins,171790,TO,Norte,FIOCRUZ/ASTRAZENECA,984,927,57
Ponte Branca,510670,MT,Centro-Oeste,BUTANTAN/SINOVAC,597,320,277
Ponte Branca,510670,MT,Centro-Oeste,FIOCRUZ/ASTRAZENECA,518,492,26
Ponte Branca,510670,MT,Centro-Oeste,PFIZER/BIONTECH,30,30,0
Ponte Nova,315210,MG,Sudeste,BUTANTAN/SINOVAC,14955,7768,7187
Ponte Nova,315210,MG,Sudeste,FIOCRUZ/ASTRAZENECA,10833,9476,1357
Ponte Nova,315210,MG,Sudeste,PFIZER/BIONTECH,1379,1379,0
Ponte Preta,431478,RS,Sul,BUTANTAN/SINOVAC,644,333,311
Ponte Preta,431478,RS,Sul,FIOCRUZ/ASTRAZENECA,432,385,47
Ponte Preta,431478,RS,Sul,PFIZER/BIONTECH,60,60,0
Ponte Serrada,421340,SC,Sul,FIOCRUZ/ASTRAZENECA,2400,2252,148
Ponte Serrada,421340,SC,Sul,BUTANTAN/SINOVAC,2138,1087,1051
Ponte Serrada,421340,SC,Sul,PFIZER/BIONTECH,134,133,1
Pontes E Lacerda,510675,MT,Centro-Oeste,FIOCRUZ/ASTRAZENECA,5580,5243,337
Pontes E Lacerda,510675,MT,Centro-Oeste,BUTANTAN/SINOVAC,5386,2922,2464
Pontes E Lacerda,510675,MT,Centro-Oeste,PFIZER/BIONTECH,498,498,0
Pontes Gestal,354030,SP,Sudeste,BUTANTAN/SINOVAC,721,362,359
Pontes Gestal,354030,SP,Sudeste,FIOCRUZ/ASTRAZENECA,657,599,58
Pontes Gestal,354030,SP,Sudeste,PFIZER/BIONTECH,71,71,0
Ponto Belo,320425,ES,Sudeste,BUTANTAN/SINOVAC,1879,1123,756
Ponto Belo,320425,ES,Sudeste,FIOCRUZ/ASTRAZENECA,1699,1604,95
Ponto Belo,320425,ES,Sudeste,PFIZER/BIONTECH,138,138,0
Ponto Chique,315213,MG,Sudeste,BUTANTAN/SINOVAC,923,524,399
Ponto Chique,315213,MG,Sudeste,FIOCRUZ/ASTRAZENECA,464,439,25
Ponto Dos Volantes,315217,MG,Sudeste,BUTANTAN/SINOVAC,2370,1193,1177
Ponto Dos Volantes,315217,MG,Sudeste,FIOCRUZ/ASTRAZENECA,1903,1770,133
Ponto Dos Volantes,315217,MG,Sudeste,PFIZER/BIONTECH,175,175,0
Ponto Novo,292525,BA,Nordeste,FIOCRUZ/ASTRAZENECA,3031,2751,280
Ponto Novo,292525,BA,Nordeste,BUTANTAN/SINOVAC,2823,1517,1306
Ponto Novo,292525,BA,Nordeste,PFIZER/BIONTECH,296,296,0
Populina,354040,SP,Sudeste,BUTANTAN/SINOVAC,1387,770,617
Populina,354040,SP,Sudeste,FIOCRUZ/ASTRAZENECA,1257,1125,132
Populina,354040,SP,Sudeste,PFIZER/BIONTECH,130,130,0
Poranga,231100,CE,Nordeste,BUTANTAN/SINOVAC,4541,2382,2159
Poranga,231100,CE,Nordeste,FIOCRUZ/ASTRAZENECA,1720,1388,332
Porangaba,354050,SP,Sudeste,BUTANTAN/SINOVAC,2274,1310,964
Porangaba,354050,SP,Sudeste,FIOCRUZ/ASTRAZENECA,1917,1738,179
Porangaba,354050,SP,Sudeste,PFIZER/BIONTECH,198,198,0
Porangatu,521800,GO,Centro-Oeste,FIOCRUZ/ASTRAZENECA,9321,8664,657
Porangatu,521800,GO,Centro-Oeste,BUTANTAN/SINOVAC,6432,3482,2950
Porangatu,521800,GO,Centro-Oeste,PFIZER/BIONTECH,1213,1212,1
Porciúncula,330410,RJ,Sudeste,BUTANTAN/SINOVAC,3984,2079,1905
Porciúncula,330410,RJ,Sudeste,FIOCRUZ/ASTRAZENECA,2312,2006,306
Porecatu,412000,PR,Sul,FIOCRUZ/ASTRAZENECA,3515,3215,300
Porecatu,412000,PR,Sul,BUTANTAN/SINOVAC,3087,1571,1516
Porecatu,412000,PR,Sul,PFIZER/BIONTECH,306,306,0
Portalegre,241020,RN,Nordeste,FIOCRUZ/ASTRAZENECA,2486,2303,183
Portalegre,241020,RN,Nordeste,BUTANTAN/SINOVAC,1760,899,861
Portalegre,241020,RN,Nordeste,PFIZER/BIONTECH,246,246,0
Portão,431480,RS,Sul,FIOCRUZ/ASTRAZENECA,7979,7592,387
Portão,431480,RS,Sul,BUTANTAN/SINOVAC,7421,3773,3648
Portão,431480,RS,Sul,PFIZER/BIONTECH,1293,1293,0
Porteirão,521805,GO,Centro-Oeste,FIOCRUZ/ASTRAZENECA,883,806,77
Porteirão,521805,GO,Centro-Oeste,BUTANTAN/SINOVAC,641,334,307
Porteirão,521805,GO,Centro-Oeste,PFIZER/BIONTECH,66,66,0
Porteiras,231110,CE,Nordeste,BUTANTAN/SINOVAC,2641,1354,1287
Porteiras,231110,CE,Nordeste,FIOCRUZ/ASTRAZENECA,2589,2318,271
Porteirinha,315220,MG,Sudeste,BUTANTAN/SINOVAC,8822,4586,4236
Porteirinha,315220,MG,Sudeste,FIOCRUZ/ASTRAZENECA,6448,5946,502
Porteirinha,315220,MG,Sudeste,PFIZER/BIONTECH,898,896,2
Portel,150580,PA,Norte,FIOCRUZ/ASTRAZENECA,12183,11861,322
Portel,150580,PA,Norte,BUTANTAN/SINOVAC,2042,1111,931
Portelândia,521810,GO,Centro-Oeste,BUTANTAN/SINOVAC,858,465,393
Portelândia,521810,GO,Centro-Oeste,FIOCRUZ/ASTRAZENECA,822,768,54
Porto,220850,PI,Nordeste,BUTANTAN/SINOVAC,1520,773,747
Porto,220850,PI,Nordeste,FIOCRUZ/ASTRAZENECA,887,823,64
Porto Acre,120080,AC,Norte,FIOCRUZ/ASTRAZENECA,3282,3008,274
Porto Acre,120080,AC,Norte,BUTANTAN/SINOVAC,1691,969,722
Porto Alegre,431490,RS,Sul,BUTANTAN/SINOVAC,543618,277807,265811
Porto Alegre,431490,RS,Sul,FIOCRUZ/ASTRAZENECA,323508,274711,48797
Porto Alegre,431490,RS,Sul,PFIZER/BIONTECH,97815,69625,28190
Porto Alegre Do Norte,510677,MT,Centro-Oeste,BUTANTAN/SINOVAC,2062,1105,957
Porto Alegre Do Norte,510677,MT,Centro-Oeste,FIOCRUZ/ASTRAZENECA,903,795,108
Porto Alegre Do Norte,510677,MT,Centro-Oeste,PFIZER/BIONTECH,23,23,0
Porto Alegre Do Piauí,220855,PI,Nordeste,BUTANTAN/SINOVAC,537,282,255
Porto Alegre Do Piauí,220855,PI,Nordeste,FIOCRUZ/ASTRAZENECA,419,380,39
Porto Alegre Do Tocantins,171800,TO,Norte,BUTANTAN/SINOVAC,634,322,312
Porto Alegre Do Tocantins,171800,TO,Norte,FIOCRUZ/ASTRAZENECA,615,594,21
Porto Amazonas,412010,PR,Sul,FIOCRUZ/ASTRAZENECA,941,861,80
Porto Amazonas,412010,PR,Sul,BUTANTAN/SINOVAC,875,463,412
Porto Barreiro,412015,PR,Sul,FIOCRUZ/ASTRAZENECA,935,902,33
Porto Barreiro,412015,PR,Sul,BUTANTAN/SINOVAC,738,384,354
Porto Barreiro,412015,PR,Sul,PFIZER/BIONTECH,18,18,0
Porto Belo,421350,SC,Sul,FIOCRUZ/ASTRAZENECA,3696,3618,78
Porto Belo,421350,SC,Sul,BUTANTAN/SINOVAC,3559,1967,1592
Porto Belo,421350,SC,Sul,PFIZER/BIONTECH,228,228,0
Porto Calvo,270730,AL,Nordeste,FIOCRUZ/ASTRAZENECA,3794,3546,248
Porto Calvo,270730,AL,Nordeste,BUTANTAN/SINOVAC,3469,1849,1620
Porto Da Folha,280560,SE,Nordeste,BUTANTAN/SINOVAC,6140,3132,3008
Porto Da Folha,280560,SE,Nordeste,FIOCRUZ/ASTRAZENECA,3879,3879,0
Porto Da Folha,280560,SE,Nordeste,PFIZER/BIONTECH,351,351,0
Porto De Moz,150590,PA,Norte,FIOCRUZ/ASTRAZENECA,5204,4393,811
Porto De Moz,150590,PA,Norte,BUTANTAN/SINOVAC,3506,2112,1394
Porto De Pedras,270740,AL,Nordeste,FIOCRUZ/ASTRAZENECA,1216,1134,82
Porto De Pedras,270740,AL,Nordeste,BUTANTAN/SINOVAC,1068,605,463
Porto Do Mangue,241025,RN,Nordeste,BUTANTAN/SINOVAC,783,392,391
Porto Do Mangue,241025,RN,Nordeste,FIOCRUZ/ASTRAZENECA,442,422,20
Porto Do Mangue,241025,RN,Nordeste,PFIZER/BIONTECH,42,42,0
Porto Dos Gaúchos,510680,MT,Centro-Oeste,BUTANTAN/SINOVAC,1041,547,494
Porto Dos Gaúchos,510680,MT,Centro-Oeste,FIOCRUZ/ASTRAZENECA,760,679,81
Porto Dos Gaúchos,510680,MT,Centro-Oeste,PFIZER/BIONTECH,123,123,0
Porto Esperidião,510682,MT,Centro-Oeste,BUTANTAN/SINOVAC,2889,1489,1400
Porto Esperidião,510682,MT,Centro-Oeste,FIOCRUZ/ASTRAZENECA,1720,1587,133
Porto Esperidião,510682,MT,Centro-Oeste,PFIZER/BIONTECH,18,18,0
Porto Estrela,510685,MT,Centro-Oeste,FIOCRUZ/ASTRAZENECA,1297,1264,33
Porto Estrela,510685,MT,Centro-Oeste,BUTANTAN/SINOVAC,644,331,313
Porto Estrela,510685,MT,Centro-Oeste,PFIZER/BIONTECH,15,15,0
Porto Feliz,354060,SP,Sudeste,BUTANTAN/SINOVAC,9930,5144,4786
Porto Feliz,354060,SP,Sudeste,FIOCRUZ/ASTRAZENECA,9519,8627,892
Porto Feliz,354060,SP,Sudeste,PFIZER/BIONTECH,277,277,0
Porto Ferreira,354070,SP,Sudeste,FIOCRUZ/ASTRAZENECA,12985,12130,855
Porto Ferreira,354070,SP,Sudeste,BUTANTAN/SINOVAC,11653,6140,5513
Porto Ferreira,354070,SP,Sudeste,PFIZER/BIONTECH,474,474,0
Porto Firme,315230,MG,Sudeste,BUTANTAN/SINOVAC,2310,1212,1098
Porto Firme,315230,MG,Sudeste,FIOCRUZ/ASTRAZENECA,1623,1478,145
Porto Franco,210900,MA,Nordeste,FIOCRUZ/ASTRAZENECA,4786,4490,296
Porto Franco,210900,MA,Nordeste,BUTANTAN/SINOVAC,3190,1654,1536
Porto Grande,160053,AP,Norte,BUTANTAN/SINOVAC,2450,1314,1136
Porto Grande,160053,AP,Norte,FIOCRUZ/ASTRAZENECA,1159,1110,49
Porto Grande,160053,AP,Norte,PFIZER/BIONTECH,285,285,0
Porto Lucena,431500,RS,Sul,BUTANTAN/SINOVAC,2129,1069,1060
Porto Lucena,431500,RS,Sul,FIOCRUZ/ASTRAZENECA,1580,1432,148
Porto Lucena,431500,RS,Sul,PFIZER/BIONTECH,59,59,0
Porto Mauá,431505,RS,Sul,BUTANTAN/SINOVAC,1010,547,463
Porto Mauá,431505,RS,Sul,FIOCRUZ/ASTRAZENECA,654,582,72
Porto Mauá,431505,RS,Sul,PFIZER/BIONTECH,105,105,0
Porto Murtinho,500690,MS,Centro-Oeste,FIOCRUZ/ASTRAZENECA,3959,3462,497
Porto Murtinho,500690,MS,Centro-Oeste,BUTANTAN/SINOVAC,3446,1918,1528
Porto Murtinho,500690,MS,Centro-Oeste,PFIZER/BIONTECH,550,549,1
Porto Nacional,171820,TO,Norte,FIOCRUZ/ASTRAZENECA,10866,10161,705
Porto Nacional,171820,TO,Norte,BUTANTAN/SINOVAC,9589,5015,4574
Porto Nacional,171820,TO,Norte,PFIZER/BIONTECH,2548,2540,8
Porto Real,330411,RJ,Sudeste,BUTANTAN/SINOVAC,4212,2147,2065
Porto Real,330411,RJ,Sudeste,FIOCRUZ/ASTRAZENECA,3529,3288,241
Porto Real,330411,RJ,Sudeste,PFIZER/BIONTECH,652,652,0
Porto Real Do Colégio,270750,AL,Nordeste,BUTANTAN/SINOVAC,5550,3128,2422
Porto Real Do Colégio,270750,AL,Nordeste,FIOCRUZ/ASTRAZENECA,3211,2883,328
Porto Rico,412020,PR,Sul,BUTANTAN/SINOVAC,584,298,286
Porto Rico,412020,PR,Sul,FIOCRUZ/ASTRAZENECA,524,493,31
Porto Rico Do Maranhão,210905,MA,Nordeste,FIOCRUZ/ASTRAZENECA,1577,1503,74
Porto Rico Do Maranhão,210905,MA,Nordeste,BUTANTAN/SINOVAC,1407,695,712
Porto Seguro,292530,BA,Nordeste,BUTANTAN/SINOVAC,15564,8727,6837
Porto Seguro,292530,BA,Nordeste,FIOCRUZ/ASTRAZENECA,8049,7210,839
Porto Seguro,292530,BA,Nordeste,PFIZER/BIONTECH,1258,1255,3
Porto União,421360,SC,Sul,FIOCRUZ/ASTRAZENECA,9482,8804,678
Porto União,421360,SC,Sul,BUTANTAN/SINOVAC,6933,3810,3123
Porto União,421360,SC,Sul,PFIZER/BIONTECH,223,223,0
Porto Velho,110020,RO,Norte,FIOCRUZ/ASTRAZENECA,84388,78133,6255
Porto Velho,110020,RO,Norte,BUTANTAN/SINOVAC,83067,42855,40212
Porto Velho,110020,RO,Norte,PFIZER/BIONTECH,19728,19690,38
Porto Vera Cruz,431507,RS,Sul,BUTANTAN/SINOVAC,536,266,270
Porto Vera Cruz,431507,RS,Sul,FIOCRUZ/ASTRAZENECA,502,462,40
Porto Vera Cruz,431507,RS,Sul,PFIZER/BIONTECH,74,74,0
Porto Vitória,412030,PR,Sul,BUTANTAN/SINOVAC,989,502,487
Porto Vitória,412030,PR,Sul,FIOCRUZ/ASTRAZENECA,927,868,59
Porto Walter,120039,AC,Norte,BUTANTAN/SINOVAC,3476,2050,1426
Porto Walter,120039,AC,Norte,FIOCRUZ/ASTRAZENECA,851,729,122
Porto Xavier,431510,RS,Sul,BUTANTAN/SINOVAC,2863,1490,1373
Porto Xavier,431510,RS,Sul,FIOCRUZ/ASTRAZENECA,2707,2404,303
Porto Xavier,431510,RS,Sul,PFIZER/BIONTECH,395,395,0
Posse,521830,GO,Centro-Oeste,FIOCRUZ/ASTRAZENECA,9076,8489,587
Posse,521830,GO,Centro-Oeste,BUTANTAN/SINOVAC,2346,1218,1128
Posse,521830,GO,Centro-Oeste,PFIZER/BIONTECH,1634,1633,1
Poté,315240,MG,Sudeste,BUTANTAN/SINOVAC,3620,1876,1744
Poté,315240,MG,Sudeste,FIOCRUZ/ASTRAZENECA,3005,2782,223
Poté,315240,MG,Sudeste,PFIZER/BIONTECH,41,41,0
Potengi,231120,CE,Nordeste,FIOCRUZ/ASTRAZENECA,2399,2032,367
Potengi,231120,CE,Nordeste,BUTANTAN/SINOVAC,1886,920,966
Potim,354075,SP,Sudeste,FIOCRUZ/ASTRAZENECA,3882,3643,239
Potim,354075,SP,Sudeste,BUTANTAN/SINOVAC,3738,1880,1858
Potim,354075,SP,Sudeste,PFIZER/BIONTECH,2,2,0
Potiraguá,292540,BA,Nordeste,FIOCRUZ/ASTRAZENECA,2021,1918,103
Potiraguá,292540,BA,Nordeste,BUTANTAN/SINOVAC,1825,972,853
Potiraguá,292540,BA,Nordeste,PFIZER/BIONTECH,57,57,0
Potirendaba,354080,SP,Sudeste,FIOCRUZ/ASTRAZENECA,4268,3780,488
Potirendaba,354080,SP,Sudeste,BUTANTAN/SINOVAC,3956,2163,1793
Potirendaba,354080,SP,Sudeste,PFIZER/BIONTECH,202,202,0
Potiretama,231123,CE,Nordeste,BUTANTAN/SINOVAC,1292,658,634
Potiretama,231123,CE,Nordeste,FIOCRUZ/ASTRAZENECA,1036,942,94
Pouso Alegre,315250,MG,Sudeste,BUTANTAN/SINOVAC,33963,17364,16599
Pouso Alegre,315250,MG,Sudeste,FIOCRUZ/ASTRAZENECA,25828,22832,2996
Pouso Alegre,315250,MG,Sudeste,PFIZER/BIONTECH,2121,2121,0
Pouso Alto,315260,MG,Sudeste,BUTANTAN/SINOVAC,1766,898,868
Pouso Alto,315260,MG,Sudeste,FIOCRUZ/ASTRAZENECA,1338,1227,111
Pouso Alto,315260,MG,Sudeste,PFIZER/BIONTECH,40,40,0
Pouso Novo,431513,RS,Sul,BUTANTAN/SINOVAC,604,303,301
Pouso Novo,431513,RS,Sul,FIOCRUZ/ASTRAZENECA,584,517,67
Pouso Novo,431513,RS,Sul,PFIZER/BIONTECH,42,42,0
Pouso Redondo,421370,SC,Sul,BUTANTAN/SINOVAC,3136,1596,1540
Pouso Redondo,421370,SC,Sul,FIOCRUZ/ASTRAZENECA,3059,2886,173
Pouso Redondo,421370,SC,Sul,PFIZER/BIONTECH,414,414,0
Poxoréu,510700,MT,Centro-Oeste,BUTANTAN/SINOVAC,3706,2203,1503
Poxoréu,510700,MT,Centro-Oeste,FIOCRUZ/ASTRAZENECA,3362,3224,138
Poxoréu,510700,MT,Centro-Oeste,PFIZER/BIONTECH,223,223,0
Pracinha,354085,SP,Sudeste,BUTANTAN/SINOVAC,913,383,530
Pracinha,354085,SP,Sudeste,FIOCRUZ/ASTRAZENECA,657,622,35
Pracinha,354085,SP,Sudeste,PFIZER/BIONTECH,26,26,0
Pracuúba,160055,AP,Norte,BUTANTAN/SINOVAC,606,308,298
Pracuúba,160055,AP,Norte,FIOCRUZ/ASTRAZENECA,138,120,18
Pracuúba,160055,AP,Norte,PFIZER/BIONTECH,104,104,0
Prado,292550,BA,Nordeste,BUTANTAN/SINOVAC,5074,2663,2411
Prado,292550,BA,Nordeste,FIOCRUZ/ASTRAZENECA,1782,1706,76
Prado Ferreira,412033,PR,Sul,FIOCRUZ/ASTRAZENECA,1260,1201,59
Prado Ferreira,412033,PR,Sul,BUTANTAN/SINOVAC,856,463,393
Prado Ferreira,412033,PR,Sul,PFIZER/BIONTECH,16,16,0
Pradópolis,354090,SP,Sudeste,FIOCRUZ/ASTRAZENECA,3762,3566,196
Pradópolis,354090,SP,Sudeste,BUTANTAN/SINOVAC,3124,1623,1501
Pradópolis,354090,SP,Sudeste,PFIZER/BIONTECH,148,147,1
Prados,315270,MG,Sudeste,FIOCRUZ/ASTRAZENECA,2238,2067,171
Prados,315270,MG,Sudeste,BUTANTAN/SINOVAC,1694,866,828
Prados,315270,MG,Sudeste,PFIZER/BIONTECH,147,147,0
Praia Grande,354100,SP,Sudeste,FIOCRUZ/ASTRAZENECA,65646,61368,4278
Praia Grande,354100,SP,Sudeste,BUTANTAN/SINOVAC,65574,37530,28044
Praia Grande,354100,SP,Sudeste,PFIZER/BIONTECH,3175,3162,13
Praia Grande,421380,SC,Sul,FIOCRUZ/ASTRAZENECA,2002,1858,144
Praia Grande,421380,SC,Sul,BUTANTAN/SINOVAC,1795,940,855
Praia Grande,421380,SC,Sul,PFIZER/BIONTECH,104,104,0
Praia Norte,171830,TO,Norte,BUTANTAN/SINOVAC,1103,572,531
Praia Norte,171830,TO,Norte,FIOCRUZ/ASTRAZENECA,920,896,24
Prainha,150600,PA,Norte,FIOCRUZ/ASTRAZENECA,5619,4094,1525
Prainha,150600,PA,Norte,BUTANTAN/SINOVAC,1262,686,576
Pranchita,412035,PR,Sul,FIOCRUZ/ASTRAZENECA,1579,1475,104
Pranchita,412035,PR,Sul,BUTANTAN/SINOVAC,1398,722,676
Pranchita,412035,PR,Sul,PFIZER/BIONTECH,5,5,0
Prata,251220,PB,Nordeste,BUTANTAN/SINOVAC,1166,599,567
Prata,251220,PB,Nordeste,FIOCRUZ/ASTRAZENECA,770,714,56
Prata,251220,PB,Nordeste,PFIZER/BIONTECH,123,123,0
Prata,315280,MG,Sudeste,FIOCRUZ/ASTRAZENECA,5860,5312,548
Prata,315280,MG,Sudeste,BUTANTAN/SINOVAC,5202,2635,2567
Prata,315280,MG,Sudeste,PFIZER/BIONTECH,208,208,0
Prata Do Piauí,220860,PI,Nordeste,BUTANTAN/SINOVAC,1023,536,487
Prata Do Piauí,220860,PI,Nordeste,FIOCRUZ/ASTRAZENECA,900,830,70
Pratânia,354105,SP,Sudeste,FIOCRUZ/ASTRAZENECA,997,935,62
Pratânia,354105,SP,Sudeste,BUTANTAN/SINOVAC,769,404,365
Pratânia,354105,SP,Sudeste,PFIZER/BIONTECH,101,101,0
Pratápolis,315290,MG,Sudeste,FIOCRUZ/ASTRAZENECA,2843,2639,204
Pratápolis,315290,MG,Sudeste,BUTANTAN/SINOVAC,2755,1411,1344
Pratápolis,315290,MG,Sudeste,PFIZER/BIONTECH,113,113,0
Pratinha,315300,MG,Sudeste,BUTANTAN/SINOVAC,1109,566,543
Pratinha,315300,MG,Sudeste,FIOCRUZ/ASTRAZENECA,852,774,78
Pratinha,315300,MG,Sudeste,PFIZER/BIONTECH,30,30,0
Presidente Alves,354110,SP,Sudeste,BUTANTAN/SINOVAC,1396,691,705
Presidente Alves,354110,SP,Sudeste,FIOCRUZ/ASTRAZENECA,1101,947,154
Presidente Alves,354110,SP,Sudeste,PFIZER/BIONTECH,105,105,0
Presidente Bernardes,315310,MG,Sudeste,BUTANTAN/SINOVAC,1551,799,752
Presidente Bernardes,315310,MG,Sudeste,FIOCRUZ/ASTRAZENECA,1307,1245,62
Presidente Bernardes,315310,MG,Sudeste,PFIZER/BIONTECH,83,83,0
Presidente Bernardes,354120,SP,Sudeste,BUTANTAN/SINOVAC,5088,2711,2377
Presidente Bernardes,354120,SP,Sudeste,FIOCRUZ/ASTRAZENECA,4073,3679,394
Presidente Bernardes,354120,SP,Sudeste,PFIZER/BIONTECH,274,274,0
Presidente Castello Branco,421390,SC,Sul,BUTANTAN/SINOVAC,536,273,263
Presidente Castello Branco,421390,SC,Sul,FIOCRUZ/ASTRAZENECA,523,465,58
Presidente Castelo Branco,412040,PR,Sul,FIOCRUZ/ASTRAZENECA,1419,1336,83
Presidente Castelo Branco,412040,PR,Sul,BUTANTAN/SINOVAC,1082,548,534
Presidente Castelo Branco,412040,PR,Sul,PFIZER/BIONTECH,24,24,0
Presidente Dutra,210910,MA,Nordeste,FIOCRUZ/ASTRAZENECA,9305,8569,736
Presidente Dutra,210910,MA,Nordeste,BUTANTAN/SINOVAC,7760,4296,3464
Presidente Dutra,210910,MA,Nordeste,PFIZER/BIONTECH,136,136,0
Presidente Dutra,292560,BA,Nordeste,BUTANTAN/SINOVAC,4122,2356,1766
Presidente Dutra,292560,BA,Nordeste,FIOCRUZ/ASTRAZENECA,4027,3618,409
Presidente Dutra,292560,BA,Nordeste,PFIZER/BIONTECH,281,281,0
Presidente Epitácio,354130,SP,Sudeste,FIOCRUZ/ASTRAZENECA,9091,8560,531
Presidente Epitácio,354130,SP,Sudeste,BUTANTAN/SINOVAC,8122,4292,3830
Presidente Epitácio,354130,SP,Sudeste,PFIZER/BIONTECH,1219,1219,0
Presidente Figueiredo,130353,AM,Norte,FIOCRUZ/ASTRAZENECA,5494,4588,906
Presidente Figueiredo,130353,AM,Norte,BUTANTAN/SINOVAC,4467,2577,1890
Presidente Getúlio,421400,SC,Sul,FIOCRUZ/ASTRAZENECA,3840,3514,326
Presidente Getúlio,421400,SC,Sul,BUTANTAN/SINOVAC,3246,1722,1524
Presidente Getúlio,421400,SC,Sul,PFIZER/BIONTECH,329,329,0
Presidente Jânio Quadros,292570,BA,Nordeste,BUTANTAN/SINOVAC,3668,1965,1703
Presidente Jânio Quadros,292570,BA,Nordeste,FIOCRUZ/ASTRAZENECA,2699,2383,316
Presidente Jânio Quadros,292570,BA,Nordeste,PFIZER/BIONTECH,4,3,1
Presidente Juscelino,210920,MA,Nordeste,FIOCRUZ/ASTRAZENECA,3616,3518,98
Presidente Juscelino,210920,MA,Nordeste,BUTANTAN/SINOVAC,1287,681,606
Presidente Juscelino,315320,MG,Sudeste,FIOCRUZ/ASTRAZENECA,1279,1198,81
Presidente Juscelino,315320,MG,Sudeste,BUTANTAN/SINOVAC,965,482,483
Presidente Juscelino,315320,MG,Sudeste,PFIZER/BIONTECH,22,22,0
Presidente Kennedy,171840,TO,Norte,BUTANTAN/SINOVAC,736,396,340
Presidente Kennedy,171840,TO,Norte,FIOCRUZ/ASTRAZENECA,478,452,26
Presidente Kennedy,320430,ES,Sudeste,FIOCRUZ/ASTRAZENECA,3836,3695,141
Presidente Kennedy,320430,ES,Sudeste,BUTANTAN/SINOVAC,3391,1775,1616
Presidente Kennedy,320430,ES,Sudeste,PFIZER/BIONTECH,340,340,0
Presidente Kubitschek,315330,MG,Sudeste,FIOCRUZ/ASTRAZENECA,1178,1092,86
Presidente Kubitschek,315330,MG,Sudeste,BUTANTAN/SINOVAC,779,395,384
Presidente Kubitschek,315330,MG,Sudeste,PFIZER/BIONTECH,23,23,0
Presidente Lucena,431514,RS,Sul,BUTANTAN/SINOVAC,715,379,336
Presidente Lucena,431514,RS,Sul,FIOCRUZ/ASTRAZENECA,685,622,63
Presidente Lucena,431514,RS,Sul,PFIZER/BIONTECH,84,84,0
Presidente Médici,110025,RO,Norte,FIOCRUZ/ASTRAZENECA,5231,5091,140
Presidente Médici,110025,RO,Norte,BUTANTAN/SINOVAC,3642,2228,1414
Presidente Médici,110025,RO,Norte,PFIZER/BIONTECH,378,378,0
Presidente Médici,210923,MA,Nordeste,FIOCRUZ/ASTRAZENECA,1169,1095,74
Presidente Médici,210923,MA,Nordeste,BUTANTAN/SINOVAC,1169,642,527
Presidente Nereu,421410,SC,Sul,FIOCRUZ/ASTRAZENECA,650,602,48
Presidente Nereu,421410,SC,Sul,BUTANTAN/SINOVAC,544,279,265
Presidente Nereu,421410,SC,Sul,PFIZER/BIONTECH,30,30,0
Presidente Olegário,315340,MG,Sudeste,FIOCRUZ/ASTRAZENECA,4531,4239,292
Presidente Olegário,315340,MG,Sudeste,BUTANTAN/SINOVAC,3847,1962,1885
Presidente Olegário,315340,MG,Sudeste,PFIZER/BIONTECH,516,516,0
Presidente Prudente,354140,SP,Sudeste,BUTANTAN/SINOVAC,60296,32279,28017
Presidente Prudente,354140,SP,Sudeste,FIOCRUZ/ASTRAZENECA,56767,51473,5294
Presidente Prudente,354140,SP,Sudeste,PFIZER/BIONTECH,3515,3509,6
Presidente Sarney,210927,MA,Nordeste,FIOCRUZ/ASTRAZENECA,4405,3815,590
Presidente Sarney,210927,MA,Nordeste,BUTANTAN/SINOVAC,2250,1186,1064
Presidente Tancredo Neves,292575,BA,Nordeste,BUTANTAN/SINOVAC,4067,2085,1982
Presidente Tancredo Neves,292575,BA,Nordeste,FIOCRUZ/ASTRAZENECA,3606,3396,210
Presidente Tancredo Neves,292575,BA,Nordeste,PFIZER/BIONTECH,625,620,5
Presidente Vargas,210930,MA,Nordeste,FIOCRUZ/ASTRAZENECA,4396,4110,286
Presidente Vargas,210930,MA,Nordeste,BUTANTAN/SINOVAC,2112,1083,1029
Presidente Venceslau,354150,SP,Sudeste,BUTANTAN/SINOVAC,11397,6395,5002
Presidente Venceslau,354150,SP,Sudeste,FIOCRUZ/ASTRAZENECA,9833,8836,997
Primavera,150610,PA,Norte,FIOCRUZ/ASTRAZENECA,2295,2089,206
Primavera,150610,PA,Norte,BUTANTAN/SINOVAC,1354,794,560
Primavera,261140,PE,Nordeste,FIOCRUZ/ASTRAZENECA,2107,2042,65
Primavera,261140,PE,Nordeste,BUTANTAN/SINOVAC,1743,1109,634
Primavera,261140,PE,Nordeste,PFIZER/BIONTECH,49,49,0
Primavera De Rondônia,110147,RO,Norte,BUTANTAN/SINOVAC,900,475,425
Primavera De Rondônia,110147,RO,Norte,FIOCRUZ/ASTRAZENECA,652,619,33
Primavera De Rondônia,110147,RO,Norte,PFIZER/BIONTECH,34,34,0
Primavera Do Leste,510704,MT,Centro-Oeste,FIOCRUZ/ASTRAZENECA,11412,10616,796
Primavera Do Leste,510704,MT,Centro-Oeste,BUTANTAN/SINOVAC,8710,4433,4277
Primavera Do Leste,510704,MT,Centro-Oeste,PFIZER/BIONTECH,1422,1421,1
Primeira Cruz,210940,MA,Nordeste,FIOCRUZ/ASTRAZENECA,2353,1976,377
Primeira Cruz,210940,MA,Nordeste,BUTANTAN/SINOVAC,1816,940,876
Primeiro De Maio,412050,PR,Sul,BUTANTAN/SINOVAC,2769,1427,1342
Primeiro De Maio,412050,PR,Sul,FIOCRUZ/ASTRAZENECA,2584,2344,240
Princesa,421415,SC,Sul,FIOCRUZ/ASTRAZENECA,724,659,65
Princesa,421415,SC,Sul,BUTANTAN/SINOVAC,654,329,325
Princesa,421415,SC,Sul,PFIZER/BIONTECH,31,31,0
Princesa Isabel,251230,PB,Nordeste,BUTANTAN/SINOVAC,5596,2828,2768
Princesa Isabel,251230,PB,Nordeste,FIOCRUZ/ASTRAZENECA,4257,3785,472
Princesa Isabel,251230,PB,Nordeste,PFIZER/BIONTECH,253,253,0
Professor Jamil,521839,GO,Centro-Oeste,BUTANTAN/SINOVAC,1936,987,949
Professor Jamil,521839,GO,Centro-Oeste,FIOCRUZ/ASTRAZENECA,959,881,78
Progresso,431515,RS,Sul,BUTANTAN/SINOVAC,1816,924,892
Progresso,431515,RS,Sul,FIOCRUZ/ASTRAZENECA,1435,1307,128
Progresso,431515,RS,Sul,PFIZER/BIONTECH,257,257,0
Promissão,354160,SP,Sudeste,FIOCRUZ/ASTRAZENECA,14501,13501,1000
Promissão,354160,SP,Sudeste,BUTANTAN/SINOVAC,12902,7078,5824
Promissão,354160,SP,Sudeste,PFIZER/BIONTECH,611,609,2
Propriá,280570,SE,Nordeste,BUTANTAN/SINOVAC,2949,1667,1282
Propriá,280570,SE,Nordeste,FIOCRUZ/ASTRAZENECA,2164,2095,69
Protásio Alves,431517,RS,Sul,BUTANTAN/SINOVAC,654,329,325
Protásio Alves,431517,RS,Sul,FIOCRUZ/ASTRAZENECA,631,509,122
Protásio Alves,431517,RS,Sul,PFIZER/BIONTECH,65,65,0
Prudente De Morais,315360,MG,Sudeste,FIOCRUZ/ASTRAZENECA,1537,1424,113
Prudente De Morais,315360,MG,Sudeste,BUTANTAN/SINOVAC,1472,774,698
Prudente De Morais,315360,MG,Sudeste,PFIZER/BIONTECH,42,42,0
Prudentópolis,412060,PR,Sul,FIOCRUZ/ASTRAZENECA,10446,10076,370
Prudentópolis,412060,PR,Sul,BUTANTAN/SINOVAC,8934,4971,3963
Prudentópolis,412060,PR,Sul,PFIZER/BIONTECH,534,534,0
Pugmil,171845,TO,Norte,FIOCRUZ/ASTRAZENECA,471,441,30
Pugmil,171845,TO,Norte,BUTANTAN/SINOVAC,425,222,203
Pureza,241040,RN,Nordeste,FIOCRUZ/ASTRAZENECA,3455,3349,106
Pureza,241040,RN,Nordeste,BUTANTAN/SINOVAC,2914,1777,1137
Pureza,241040,RN,Nordeste,PFIZER/BIONTECH,524,523,1
Putinga,431520,RS,Sul,BUTANTAN/SINOVAC,1386,699,687
Putinga,431520,RS,Sul,FIOCRUZ/ASTRAZENECA,1329,1154,175
Putinga,431520,RS,Sul,PFIZER/BIONTECH,169,169,0
Puxinanã,251240,PB,Nordeste,BUTANTAN/SINOVAC,2859,1432,1427
Puxinanã,251240,PB,Nordeste,FIOCRUZ/ASTRAZENECA,2092,1892,200
Puxinanã,251240,PB,Nordeste,PFIZER/BIONTECH,163,163,0
Quadra,354165,SP,Sudeste,BUTANTAN/SINOVAC,879,479,400
Quadra,354165,SP,Sudeste,FIOCRUZ/ASTRAZENECA,796,763,33
Quadra,354165,SP,Sudeste,PFIZER/BIONTECH,55,55,0
Quaraí,431530,RS,Sul,BUTANTAN/SINOVAC,6424,3284,3140
Quaraí,431530,RS,Sul,FIOCRUZ/ASTRAZENECA,5323,4884,439
Quaraí,431530,RS,Sul,PFIZER/BIONTECH,1150,1149,1
Quartel Geral,315370,MG,Sudeste,FIOCRUZ/ASTRAZENECA,896,816,80
Quartel Geral,315370,MG,Sudeste,BUTANTAN/SINOVAC,889,461,428
Quartel Geral,315370,MG,Sudeste,PFIZER/BIONTECH,44,44,0
Quarto Centenário,412065,PR,Sul,FIOCRUZ/ASTRAZENECA,1430,1342,88
Quarto Centenário,412065,PR,Sul,BUTANTAN/SINOVAC,1012,521,491
Quarto Centenário,412065,PR,Sul,PFIZER/BIONTECH,24,24,0
Quatá,354170,SP,Sudeste,FIOCRUZ/ASTRAZENECA,3164,2936,228
Quatá,354170,SP,Sudeste,BUTANTAN/SINOVAC,2632,1423,1209
Quatá,354170,SP,Sudeste,PFIZER/BIONTECH,353,353,0
Quatiguá,412070,PR,Sul,FIOCRUZ/ASTRAZENECA,2211,2050,161
Quatiguá,412070,PR,Sul,BUTANTAN/SINOVAC,2193,1128,1065
Quatiguá,412070,PR,Sul,PFIZER/BIONTECH,106,106,0
Quatipuru,150611,PA,Norte,FIOCRUZ/ASTRAZENECA,1636,1491,145
Quatipuru,150611,PA,Norte,BUTANTAN/SINOVAC,1595,845,750
Quatis,330412,RJ,Sudeste,FIOCRUZ/ASTRAZENECA,3607,3306,301
Quatis,330412,RJ,Sudeste,BUTANTAN/SINOVAC,2612,1398,1214
Quatro Barras,412080,PR,Sul,FIOCRUZ/ASTRAZENECA,5162,4959,203
Quatro Barras,412080,PR,Sul,BUTANTAN/SINOVAC,3455,1780,1675
Quatro Barras,412080,PR,Sul,PFIZER/BIONTECH,262,262,0
Quatro Irmãos,431531,RS,Sul,BUTANTAN/SINOVAC,476,239,237
Quatro Irmãos,431531,RS,Sul,FIOCRUZ/ASTRAZENECA,423,391,32
Quatro Irmãos,431531,RS,Sul,PFIZER/BIONTECH,71,71,0
Quatro Pontes,412085,PR,Sul,FIOCRUZ/ASTRAZENECA,1148,1067,81
Quatro Pontes,412085,PR,Sul,BUTANTAN/SINOVAC,1042,535,507
Quatro Pontes,412085,PR,Sul,PFIZER/BIONTECH,10,10,0
Quebrangulo,270760,AL,Nordeste,FIOCRUZ/ASTRAZENECA,2288,1978,310
Quebrangulo,270760,AL,Nordeste,BUTANTAN/SINOVAC,1859,947,912
Quedas Do Iguaçu,412090,PR,Sul,FIOCRUZ/ASTRAZENECA,8088,7760,328
Quedas Do Iguaçu,412090,PR,Sul,BUTANTAN/SINOVAC,6092,3133,2959
Quedas Do Iguaçu,412090,PR,Sul,PFIZER/BIONTECH,583,583,0
Queimada Nova,220865,PI,Nordeste,BUTANTAN/SINOVAC,1393,705,688
Queimada Nova,220865,PI,Nordeste,FIOCRUZ/ASTRAZENECA,1384,1345,39
Queimadas,251250,PB,Nordeste,FIOCRUZ/ASTRAZENECA,7782,7076,706
Queimadas,251250,PB,Nordeste,BUTANTAN/SINOVAC,7076,3635,3441
Queimadas,251250,PB,Nordeste,PFIZER/BIONTECH,619,619,0
Queimadas,292580,BA,Nordeste,BUTANTAN/SINOVAC,5179,2714,2465
Queimadas,292580,BA,Nordeste,FIOCRUZ/ASTRAZENECA,4426,4033,393
Queimadas,292580,BA,Nordeste,PFIZER/BIONTECH,295,295,0
Queimados,330414,RJ,Sudeste,BUTANTAN/SINOVAC,21174,10983,10191
Queimados,330414,RJ,Sudeste,FIOCRUZ/ASTRAZENECA,17793,16869,924
Queimados,330414,RJ,Sudeste,PFIZER/BIONTECH,47,47,0
Queiroz,354180,SP,Sudeste,BUTANTAN/SINOVAC,659,356,303
Queiroz,354180,SP,Sudeste,FIOCRUZ/ASTRAZENECA,642,587,55
Queiroz,354180,SP,Sudeste,PFIZER/BIONTECH,66,66,0
Queluz,354190,SP,Sudeste,BUTANTAN/SINOVAC,2203,1211,992
Queluz,354190,SP,Sudeste,FIOCRUZ/ASTRAZENECA,1878,1778,100
Queluz,354190,SP,Sudeste,PFIZER/BIONTECH,127,127,0
Queluzito,315380,MG,Sudeste,BUTANTAN/SINOVAC,717,385,332
Queluzito,315380,MG,Sudeste,FIOCRUZ/ASTRAZENECA,578,520,58
Queluzito,315380,MG,Sudeste,PFIZER/BIONTECH,4,4,0
Querência,510706,MT,Centro-Oeste,BUTANTAN/SINOVAC,1857,994,863
Querência,510706,MT,Centro-Oeste,FIOCRUZ/ASTRAZENECA,1518,1343,175
Querência,510706,MT,Centro-Oeste,PFIZER/BIONTECH,41,41,0
Querência Do Norte,412100,PR,Sul,FIOCRUZ/ASTRAZENECA,4130,3915,215
Querência Do Norte,412100,PR,Sul,BUTANTAN/SINOVAC,2440,1258,1182
Querência Do Norte,412100,PR,Sul,PFIZER/BIONTECH,155,155,0
Quevedos,431532,RS,Sul,FIOCRUZ/ASTRAZENECA,743,698,45
Quevedos,431532,RS,Sul,BUTANTAN/SINOVAC,597,341,256
Quevedos,431532,RS,Sul,PFIZER/BIONTECH,86,86,0
Quijingue,292590,BA,Nordeste,BUTANTAN/SINOVAC,5910,3088,2822
Quijingue,292590,BA,Nordeste,FIOCRUZ/ASTRAZENECA,5119,4618,501
Quijingue,292590,BA,Nordeste,PFIZER/BIONTECH,786,785,1
Quilombo,421420,SC,Sul,FIOCRUZ/ASTRAZENECA,3493,3210,283
Quilombo,421420,SC,Sul,BUTANTAN/SINOVAC,2844,1471,1373
Quilombo,421420,SC,Sul,PFIZER/BIONTECH,1,1,0
Quinta Do Sol,412110,PR,Sul,FIOCRUZ/ASTRAZENECA,1317,1231,86
Quinta Do Sol,412110,PR,Sul,BUTANTAN/SINOVAC,1211,643,568
Quinta Do Sol,412110,PR,Sul,PFIZER/BIONTECH,24,24,0
Quintana,354200,SP,Sudeste,FIOCRUZ/ASTRAZENECA,2018,1822,196
Quintana,354200,SP,Sudeste,BUTANTAN/SINOVAC,1944,1020,924
Quintana,354200,SP,Sudeste,PFIZER/BIONTECH,153,153,0
Quinze De Novembro,431535,RS,Sul,BUTANTAN/SINOVAC,1401,726,675
Quinze De Novembro,431535,RS,Sul,FIOCRUZ/ASTRAZENECA,977,922,55
Quinze De Novembro,431535,RS,Sul,PFIZER/BIONTECH,120,120,0
Quipapá,261150,PE,Nordeste,FIOCRUZ/ASTRAZENECA,4008,3583,425
Quipapá,261150,PE,Nordeste,BUTANTAN/SINOVAC,3214,1609,1605
Quipapá,261150,PE,Nordeste,PFIZER/BIONTECH,163,163,0
Quirinópolis,521850,GO,Centro-Oeste,FIOCRUZ/ASTRAZENECA,11058,10578,480
Quirinópolis,521850,GO,Centro-Oeste,BUTANTAN/SINOVAC,8833,4652,4181
Quissamã,330415,RJ,Sudeste,BUTANTAN/SINOVAC,5900,3223,2677
Quissamã,330415,RJ,Sudeste,FIOCRUZ/ASTRAZENECA,3850,3313,537
Quitandinha,412120,PR,Sul,BUTANTAN/SINOVAC,4016,2185,1831
Quitandinha,412120,PR,Sul,FIOCRUZ/ASTRAZENECA,3629,3487,142
Quitandinha,412120,PR,Sul,PFIZER/BIONTECH,71,71,0
Quiterianópolis,231126,CE,Nordeste,BUTANTAN/SINOVAC,5120,2846,2274
Quiterianópolis,231126,CE,Nordeste,FIOCRUZ/ASTRAZENECA,3147,2893,254
Quiterianópolis,231126,CE,Nordeste,PFIZER/BIONTECH,9,9,0
Quixaba,251260,PB,Nordeste,BUTANTAN/SINOVAC,675,368,307
Quixaba,251260,PB,Nordeste,FIOCRUZ/ASTRAZENECA,358,326,32
Quixaba,251260,PB,Nordeste,PFIZER/BIONTECH,46,46,0
Quixaba,261153,PE,Nordeste,FIOCRUZ/ASTRAZENECA,1615,1500,115
Quixaba,261153,PE,Nordeste,BUTANTAN/SINOVAC,1548,822,726
Quixaba,261153,PE,Nordeste,PFIZER/BIONTECH,100,100,0
Quixabeira,292593,BA,Nordeste,BUTANTAN/SINOVAC,2903,1710,1193
Quixabeira,292593,BA,Nordeste,FIOCRUZ/ASTRAZENECA,2867,2757,110
Quixabeira,292593,BA,Nordeste,PFIZER/BIONTECH,42,42,0
Quixadá,231130,CE,Nordeste,BUTANTAN/SINOVAC,3537,2806,731
Quixadá,231130,CE,Nordeste,FIOCRUZ/ASTRAZENECA,2408,2398,10
Quixelô,231135,CE,Nordeste,BUTANTAN/SINOVAC,3666,1973,1693
Quixelô,231135,CE,Nordeste,FIOCRUZ/ASTRAZENECA,2705,2347,358
Quixeramobim,231140,CE,Nordeste,BUTANTAN/SINOVAC,11925,6390,5535
Quixeramobim,231140,CE,Nordeste,FIOCRUZ/ASTRAZENECA,6059,5460,599
Quixeramobim,231140,CE,Nordeste,PFIZER/BIONTECH,1,1,0
Quixeré,231150,CE,Nordeste,BUTANTAN/SINOVAC,3265,1647,1618
Quixeré,231150,CE,Nordeste,FIOCRUZ/ASTRAZENECA,1684,1426,258
Rafael Fernandes,241050,RN,Nordeste,BUTANTAN/SINOVAC,1473,745,728
Rafael Fernandes,241050,RN,Nordeste,FIOCRUZ/ASTRAZENECA,1193,1132,61
Rafael Fernandes,241050,RN,Nordeste,PFIZER/BIONTECH,161,161,0
Rafael Godeiro,241060,RN,Nordeste,BUTANTAN/SINOVAC,848,421,427
Rafael Godeiro,241060,RN,Nordeste,FIOCRUZ/ASTRAZENECA,780,729,51
Rafael Godeiro,241060,RN,Nordeste,PFIZER/BIONTECH,29,29,0
Rafael Jambeiro,292595,BA,Nordeste,FIOCRUZ/ASTRAZENECA,5180,4686,494
Rafael Jambeiro,292595,BA,Nordeste,BUTANTAN/SINOVAC,4651,2374,2277
Rafael Jambeiro,292595,BA,Nordeste,PFIZER/BIONTECH,633,633,0
Rafard,354210,SP,Sudeste,BUTANTAN/SINOVAC,1783,987,796
Rafard,354210,SP,Sudeste,FIOCRUZ/ASTRAZENECA,1725,1550,175
Rafard,354210,SP,Sudeste,PFIZER/BIONTECH,231,231,0
Ramilândia,412125,PR,Sul,FIOCRUZ/ASTRAZENECA,953,921,32
Ramilândia,412125,PR,Sul,BUTANTAN/SINOVAC,799,443,356
Rancharia,354220,SP,Sudeste,FIOCRUZ/ASTRAZENECA,8217,7511,706
Rancharia,354220,SP,Sudeste,BUTANTAN/SINOVAC,6577,3895,2682
Rancharia,354220,SP,Sudeste,PFIZER/BIONTECH,806,806,0
Rancho Alegre,412130,PR,Sul,FIOCRUZ/ASTRAZENECA,1375,1284,91
Rancho Alegre,412130,PR,Sul,BUTANTAN/SINOVAC,1161,603,558
Rancho Alegre,412130,PR,Sul,PFIZER/BIONTECH,17,17,0
Rancho Alegre D'Oeste,412135,PR,Sul,FIOCRUZ/ASTRAZENECA,1190,1141,49
Rancho Alegre D'Oeste,412135,PR,Sul,BUTANTAN/SINOVAC,652,351,301
Rancho Queimado,421430,SC,Sul,BUTANTAN/SINOVAC,1206,690,516
Rancho Queimado,421430,SC,Sul,FIOCRUZ/ASTRAZENECA,998,862,136
Rancho Queimado,421430,SC,Sul,PFIZER/BIONTECH,66,66,0
Raposa,210945,MA,Nordeste,FIOCRUZ/ASTRAZENECA,11262,11027,235
Raposa,210945,MA,Nordeste,BUTANTAN/SINOVAC,2909,1511,1398
Raposa,210945,MA,Nordeste,PFIZER/BIONTECH,1768,1768,0
Raposos,315390,MG,Sudeste,FIOCRUZ/ASTRAZENECA,1596,1387,209
Raposos,315390,MG,Sudeste,BUTANTAN/SINOVAC,240,83,157
Raposos,315390,MG,Sudeste,PFIZER/BIONTECH,49,49,0
Raul Soares,315400,MG,Sudeste,BUTANTAN/SINOVAC,5745,2992,2753
Raul Soares,315400,MG,Sudeste,FIOCRUZ/ASTRAZENECA,5626,5135,491
Raul Soares,315400,MG,Sudeste,PFIZER/BIONTECH,188,188,0
Realeza,412140,PR,Sul,FIOCRUZ/ASTRAZENECA,4169,3938,231
Realeza,412140,PR,Sul,BUTANTAN/SINOVAC,3752,1901,1851
Realeza,412140,PR,Sul,PFIZER/BIONTECH,658,657,1
Rebouças,412150,PR,Sul,FIOCRUZ/ASTRAZENECA,3090,2924,166
Rebouças,412150,PR,Sul,BUTANTAN/SINOVAC,2760,1425,1335
Rebouças,412150,PR,Sul,PFIZER/BIONTECH,146,146,0
Recife,261160,PE,Nordeste,BUTANTAN/SINOVAC,449076,232281,216795
Recife,261160,PE,Nordeste,FIOCRUZ/ASTRAZENECA,214703,183793,30910
Recife,261160,PE,Nordeste,PFIZER/BIONTECH,14335,14330,5
Recreio,315410,MG,Sudeste,BUTANTAN/SINOVAC,3168,1669,1499
Recreio,315410,MG,Sudeste,FIOCRUZ/ASTRAZENECA,2523,2273,250
Recreio,315410,MG,Sudeste,PFIZER/BIONTECH,161,161,0
Recursolândia,171850,TO,Norte,BUTANTAN/SINOVAC,615,335,280
Recursolândia,171850,TO,Norte,FIOCRUZ/ASTRAZENECA,422,404,18
Redenção,150613,PA,Norte,FIOCRUZ/ASTRAZENECA,12237,9475,2762
Redenção,150613,PA,Norte,BUTANTAN/SINOVAC,9484,5353,4131
Redenção,231160,CE,Nordeste,BUTANTAN/SINOVAC,3382,1871,1511
Redenção,231160,CE,Nordeste,FIOCRUZ/ASTRAZENECA,1600,1394,206
Redenção Da Serra,354230,SP,Sudeste,BUTANTAN/SINOVAC,1022,577,445
Redenção Da Serra,354230,SP,Sudeste,FIOCRUZ/ASTRAZENECA,867,792,75
Redenção Da Serra,354230,SP,Sudeste,PFIZER/BIONTECH,61,61,0
Redenção Do Gurguéia,220870,PI,Nordeste,FIOCRUZ/ASTRAZENECA,1147,1075,72
Redenção Do Gurguéia,220870,PI,Nordeste,BUTANTAN/SINOVAC,1077,563,514
Redentora,431540,RS,Sul,BUTANTAN/SINOVAC,5137,2838,2299
Redentora,431540,RS,Sul,FIOCRUZ/ASTRAZENECA,1467,1237,230
Redentora,431540,RS,Sul,PFIZER/BIONTECH,289,289,0
Reduto,315415,MG,Sudeste,BUTANTAN/SINOVAC,1333,691,642
Reduto,315415,MG,Sudeste,FIOCRUZ/ASTRAZENECA,1133,1024,109
Reduto,315415,MG,Sudeste,PFIZER/BIONTECH,63,62,1
Regeneração,220880,PI,Nordeste,BUTANTAN/SINOVAC,3022,1592,1430
Regeneração,220880,PI,Nordeste,FIOCRUZ/ASTRAZENECA,2335,2161,174
Regente Feijó,354240,SP,Sudeste,FIOCRUZ/ASTRAZENECA,5120,4744,376
Regente Feijó,354240,SP,Sudeste,BUTANTAN/SINOVAC,4695,2496,2199
Regente Feijó,354240,SP,Sudeste,PFIZER/BIONTECH,449,449,0
Reginópolis,354250,SP,Sudeste,BUTANTAN/SINOVAC,2053,1063,990
Reginópolis,354250,SP,Sudeste,FIOCRUZ/ASTRAZENECA,1758,1605,153
Reginópolis,354250,SP,Sudeste,PFIZER/BIONTECH,72,72,0
Registro,354260,SP,Sudeste,BUTANTAN/SINOVAC,15335,7859,7476
Registro,354260,SP,Sudeste,FIOCRUZ/ASTRAZENECA,14903,13950,953
Registro,354260,SP,Sudeste,PFIZER/BIONTECH,863,863,0
Relvado,431545,RS,Sul,BUTANTAN/SINOVAC,970,486,484
Relvado,431545,RS,Sul,FIOCRUZ/ASTRAZENECA,600,501,99
Relvado,431545,RS,Sul,PFIZER/BIONTECH,30,30,0
Remanso,292600,BA,Nordeste,BUTANTAN/SINOVAC,8861,5330,3531
Remanso,292600,BA,Nordeste,FIOCRUZ/ASTRAZENECA,8138,7167,971
Remanso,292600,BA,Nordeste,PFIZER/BIONTECH,239,234,5
Remígio,251270,PB,Nordeste,BUTANTAN/SINOVAC,4803,2483,2320
Remígio,251270,PB,Nordeste,FIOCRUZ/ASTRAZENECA,2246,1985,261
Remígio,251270,PB,Nordeste,PFIZER/BIONTECH,69,69,0
Renascença,412160,PR,Sul,FIOCRUZ/ASTRAZENECA,1977,1866,111
Renascença,412160,PR,Sul,BUTANTAN/SINOVAC,1339,687,652
Renascença,412160,PR,Sul,PFIZER/BIONTECH,17,17,0
Reriutaba,231170,CE,Nordeste,FIOCRUZ/ASTRAZENECA,5213,4822,391
Reriutaba,231170,CE,Nordeste,BUTANTAN/SINOVAC,4001,2112,1889
Reriutaba,231170,CE,Nordeste,PFIZER/BIONTECH,132,132,0
Resende,330420,RJ,Sudeste,BUTANTAN/SINOVAC,29292,15653,13639
Resende,330420,RJ,Sudeste,FIOCRUZ/ASTRAZENECA,29149,26707,2442
Resende,330420,RJ,Sudeste,PFIZER/BIONTECH,1954,1954,0
Resende Costa,315420,MG,Sudeste,BUTANTAN/SINOVAC,2883,1450,1433
Resende Costa,315420,MG,Sudeste,FIOCRUZ/ASTRAZENECA,2809,2560,249
Resende Costa,315420,MG,Sudeste,PFIZER/BIONTECH,55,55,0
Reserva,412170,PR,Sul,FIOCRUZ/ASTRAZENECA,5094,4966,128
Reserva,412170,PR,Sul,BUTANTAN/SINOVAC,4089,2166,1923
Reserva,412170,PR,Sul,PFIZER/BIONTECH,546,546,0
Reserva Do Cabaçal,510715,MT,Centro-Oeste,FIOCRUZ/ASTRAZENECA,715,673,42
Reserva Do Cabaçal,510715,MT,Centro-Oeste,BUTANTAN/SINOVAC,538,281,257
Reserva Do Cabaçal,510715,MT,Centro-Oeste,PFIZER/BIONTECH,6,6,0
Reserva Do Iguaçu,412175,PR,Sul,FIOCRUZ/ASTRAZENECA,1873,1807,66
Reserva Do Iguaçu,412175,PR,Sul,BUTANTAN/SINOVAC,1156,611,545
Reserva Do Iguaçu,412175,PR,Sul,PFIZER/BIONTECH,29,29,0
Resplendor,315430,MG,Sudeste,BUTANTAN/SINOVAC,5053,2562,2491
Resplendor,315430,MG,Sudeste,FIOCRUZ/ASTRAZENECA,3240,2961,279
Resplendor,315430,MG,Sudeste,PFIZER/BIONTECH,261,261,0
Ressaquinha,315440,MG,Sudeste,FIOCRUZ/ASTRAZENECA,1084,1077,7
Ressaquinha,315440,MG,Sudeste,BUTANTAN/SINOVAC,993,527,466
Ressaquinha,315440,MG,Sudeste,PFIZER/BIONTECH,11,11,0
Restinga,354270,SP,Sudeste,FIOCRUZ/ASTRAZENECA,1808,1678,130
Restinga,354270,SP,Sudeste,BUTANTAN/SINOVAC,1339,643,696
Restinga,354270,SP,Sudeste,PFIZER/BIONTECH,142,142,0
Restinga Seca,431550,RS,Sul,FIOCRUZ/ASTRAZENECA,4905,4505,400
Restinga Seca,431550,RS,Sul,BUTANTAN/SINOVAC,4082,2010,2072
Restinga Seca,431550,RS,Sul,PFIZER/BIONTECH,351,351,0
Retirolândia,292610,BA,Nordeste,FIOCRUZ/ASTRAZENECA,3332,2855,477
Retirolândia,292610,BA,Nordeste,BUTANTAN/SINOVAC,3039,1588,1451
Retirolândia,292610,BA,Nordeste,PFIZER/BIONTECH,447,446,1
Riachão,210950,MA,Nordeste,FIOCRUZ/ASTRAZENECA,3064,2867,197
Riachão,210950,MA,Nordeste,BUTANTAN/SINOVAC,3024,1553,1471
Riachão,251274,PB,Nordeste,BUTANTAN/SINOVAC,801,430,371
Riachão,251274,PB,Nordeste,FIOCRUZ/ASTRAZENECA,558,497,61
Riachão,251274,PB,Nordeste,PFIZER/BIONTECH,53,53,0
Riachão Das Neves,292620,BA,Nordeste,FIOCRUZ/ASTRAZENECA,4444,4114,330
Riachão Das Neves,292620,BA,Nordeste,BUTANTAN/SINOVAC,3825,2009,1816
Riachão Das Neves,292620,BA,Nordeste,PFIZER/BIONTECH,162,162,0
Riachão Do Bacamarte,251275,PB,Nordeste,FIOCRUZ/ASTRAZENECA,1116,1040,76
Riachão Do Bacamarte,251275,PB,Nordeste,BUTANTAN/SINOVAC,985,519,466
Riachão Do Bacamarte,251275,PB,Nordeste,PFIZER/BIONTECH,71,71,0
Riachão Do Dantas,280580,SE,Nordeste,BUTANTAN/SINOVAC,3799,1990,1809
Riachão Do Dantas,280580,SE,Nordeste,FIOCRUZ/ASTRAZENECA,2943,2752,191
Riachão Do Dantas,280580,SE,Nordeste,PFIZER/BIONTECH,306,306,0
Riachão Do Jacuípe,292630,BA,Nordeste,BUTANTAN/SINOVAC,7925,4014,3911
Riachão Do Jacuípe,292630,BA,Nordeste,FIOCRUZ/ASTRAZENECA,7083,6179,904
Riachão Do Jacuípe,292630,BA,Nordeste,PFIZER/BIONTECH,1006,1006,0
Riachão Do Poço,251276,PB,Nordeste,BUTANTAN/SINOVAC,809,465,344
Riachão Do Poço,251276,PB,Nordeste,FIOCRUZ/ASTRAZENECA,528,467,61
Riachão Do Poço,251276,PB,Nordeste,PFIZER/BIONTECH,6,6,0
Riachinho,171855,TO,Norte,BUTANTAN/SINOVAC,946,494,452
Riachinho,171855,TO,Norte,FIOCRUZ/ASTRAZENECA,627,600,27
Riachinho,315445,MG,Sudeste,BUTANTAN/SINOVAC,2311,1291,1020
Riachinho,315445,MG,Sudeste,FIOCRUZ/ASTRAZENECA,1445,1308,137
Riachinho,315445,MG,Sudeste,PFIZER/BIONTECH,227,227,0
Riacho Da Cruz,241070,RN,Nordeste,BUTANTAN/SINOVAC,1124,561,563
Riacho Da Cruz,241070,RN,Nordeste,FIOCRUZ/ASTRAZENECA,698,650,48
Riacho Da Cruz,241070,RN,Nordeste,PFIZER/BIONTECH,78,78,0
Riacho Das Almas,261170,PE,Nordeste,FIOCRUZ/ASTRAZENECA,4461,4123,338
Riacho Das Almas,261170,PE,Nordeste,BUTANTAN/SINOVAC,3474,1849,1625
Riacho Das Almas,261170,PE,Nordeste,PFIZER/BIONTECH,228,228,0
Riacho De Santana,241080,RN,Nordeste,BUTANTAN/SINOVAC,300,215,85
Riacho De Santana,241080,RN,Nordeste,FIOCRUZ/ASTRAZENECA,193,193,0
Riacho De Santana,292640,BA,Nordeste,FIOCRUZ/ASTRAZENECA,6402,6042,360
Riacho De Santana,292640,BA,Nordeste,BUTANTAN/SINOVAC,6054,3181,2873
Riacho De Santo Antônio,251278,PB,Nordeste,BUTANTAN/SINOVAC,472,254,218
Riacho De Santo Antônio,251278,PB,Nordeste,FIOCRUZ/ASTRAZENECA,327,300,27
Riacho De Santo Antônio,251278,PB,Nordeste,PFIZER/BIONTECH,36,36,0
Riacho Dos Cavalos,251280,PB,Nordeste,FIOCRUZ/ASTRAZENECA,1907,1758,149
Riacho Dos Cavalos,251280,PB,Nordeste,BUTANTAN/SINOVAC,1874,948,926
Riacho Dos Cavalos,251280,PB,Nordeste,PFIZER/BIONTECH,238,238,0
Riacho Dos Machados,315450,MG,Sudeste,FIOCRUZ/ASTRAZENECA,820,806,14
Riacho Dos Machados,315450,MG,Sudeste,BUTANTAN/SINOVAC,761,415,346
Riacho Frio,220885,PI,Nordeste,FIOCRUZ/ASTRAZENECA,690,652,38
Riacho Frio,220885,PI,Nordeste,BUTANTAN/SINOVAC,480,247,233
Riachuelo,241090,RN,Nordeste,FIOCRUZ/ASTRAZENECA,2171,2030,141
Riachuelo,241090,RN,Nordeste,BUTANTAN/SINOVAC,1856,933,923
Riachuelo,241090,RN,Nordeste,PFIZER/BIONTECH,407,406,1
Riachuelo,280590,SE,Nordeste,FIOCRUZ/ASTRAZENECA,1785,1719,66
Riachuelo,280590,SE,Nordeste,BUTANTAN/SINOVAC,1626,878,748
Riachuelo,280590,SE,Nordeste,PFIZER/BIONTECH,155,155,0
Rialma,521860,GO,Centro-Oeste,FIOCRUZ/ASTRAZENECA,2424,2193,231
Rialma,521860,GO,Centro-Oeste,BUTANTAN/SINOVAC,1741,894,847
Rianápolis,521870,GO,Centro-Oeste,FIOCRUZ/ASTRAZENECA,1417,1259,158
Rianápolis,521870,GO,Centro-Oeste,BUTANTAN/SINOVAC,677,374,303
Rianápolis,521870,GO,Centro-Oeste,PFIZER/BIONTECH,72,72,0
Ribamar Fiquene,210955,MA,Nordeste,FIOCRUZ/ASTRAZENECA,1307,1199,108
Ribamar Fiquene,210955,MA,Nordeste,BUTANTAN/SINOVAC,1151,673,478
Ribas Do Rio Pardo,500710,MS,Centro-Oeste,FIOCRUZ/ASTRAZENECA,4261,3903,358
Ribas Do Rio Pardo,500710,MS,Centro-Oeste,BUTANTAN/SINOVAC,3169,1697,1472
Ribas Do Rio Pardo,500710,MS,Centro-Oeste,PFIZER/BIONTECH,766,766,0
Ribeira,354280,SP,Sudeste,BUTANTAN/SINOVAC,854,434,420
Ribeira,354280,SP,Sudeste,FIOCRUZ/ASTRAZENECA,582,512,70
Ribeira,354280,SP,Sudeste,PFIZER/BIONTECH,102,102,0
Ribeira Do Amparo,292650,BA,Nordeste,FIOCRUZ/ASTRAZENECA,3170,2950,220
Ribeira Do Amparo,292650,BA,Nordeste,BUTANTAN/SINOVAC,2841,1564,1277
Ribeira Do Amparo,292650,BA,Nordeste,PFIZER/BIONTECH,173,173,0
Ribeira Do Piauí,220887,PI,Nordeste,FIOCRUZ/ASTRAZENECA,786,742,44
Ribeira Do Piauí,220887,PI,Nordeste,BUTANTAN/SINOVAC,596,321,275
Ribeira Do Piauí,220887,PI,Nordeste,PFIZER/BIONTECH,96,96,0
Ribeira Do Pombal,292660,BA,Nordeste,FIOCRUZ/ASTRAZENECA,11507,10092,1415
Ribeira Do Pombal,292660,BA,Nordeste,BUTANTAN/SINOVAC,9289,5003,4286
Ribeira Do Pombal,292660,BA,Nordeste,PFIZER/BIONTECH,976,975,1
Ribeirão,261180,PE,Nordeste,BUTANTAN/SINOVAC,7410,3894,3516
Ribeirão,261180,PE,Nordeste,FIOCRUZ/ASTRAZENECA,6267,5735,532
Ribeirão,261180,PE,Nordeste,PFIZER/BIONTECH,147,147,0
Ribeirão Bonito,354290,SP,Sudeste,BUTANTAN/SINOVAC,2762,1445,1317
Ribeirão Bonito,354290,SP,Sudeste,FIOCRUZ/ASTRAZENECA,2742,2501,241
Ribeirão Bonito,354290,SP,Sudeste,PFIZER/BIONTECH,126,125,1
Ribeirão Branco,354300,SP,Sudeste,FIOCRUZ/ASTRAZENECA,3553,3366,187
Ribeirão Branco,354300,SP,Sudeste,BUTANTAN/SINOVAC,2996,1494,1502
Ribeirão Branco,354300,SP,Sudeste,PFIZER/BIONTECH,227,227,0
Ribeirão Cascalheira,510718,MT,Centro-Oeste,FIOCRUZ/ASTRAZENECA,2092,1982,110
Ribeirão Cascalheira,510718,MT,Centro-Oeste,BUTANTAN/SINOVAC,1567,800,767
Ribeirão Cascalheira,510718,MT,Centro-Oeste,PFIZER/BIONTECH,177,177,0
Ribeirão Claro,412180,PR,Sul,BUTANTAN/SINOVAC,2662,1563,1099
Ribeirão Claro,412180,PR,Sul,FIOCRUZ/ASTRAZENECA,2205,2084,121
Ribeirão Corrente,354310,SP,Sudeste,BUTANTAN/SINOVAC,1222,627,595
Ribeirão Corrente,354310,SP,Sudeste,FIOCRUZ/ASTRAZENECA,1092,995,97
Ribeirão Corrente,354310,SP,Sudeste,PFIZER/BIONTECH,103,102,1
Ribeirão Das Neves,315460,MG,Sudeste,BUTANTAN/SINOVAC,42399,23035,19364
Ribeirão Das Neves,315460,MG,Sudeste,FIOCRUZ/ASTRAZENECA,34292,33013,1279
Ribeirão Das Neves,315460,MG,Sudeste,PFIZER/BIONTECH,983,982,1
Ribeirão Do Largo,292665,BA,Nordeste,BUTANTAN/SINOVAC,1120,619,501
Ribeirão Do Largo,292665,BA,Nordeste,FIOCRUZ/ASTRAZENECA,743,678,65
Ribeirão Do Largo,292665,BA,Nordeste,PFIZER/BIONTECH,19,19,0
Ribeirão Do Pinhal,412190,PR,Sul,FIOCRUZ/ASTRAZENECA,3744,3504,240
Ribeirão Do Pinhal,412190,PR,Sul,BUTANTAN/SINOVAC,3158,1614,1544
Ribeirão Do Pinhal,412190,PR,Sul,PFIZER/BIONTECH,158,158,0
Ribeirão Do Sul,354320,SP,Sudeste,BUTANTAN/SINOVAC,1286,713,573
Ribeirão Do Sul,354320,SP,Sudeste,FIOCRUZ/ASTRAZENECA,1269,1173,96
Ribeirão Do Sul,354320,SP,Sudeste,PFIZER/BIONTECH,66,66,0
Ribeirão Dos Índios,354323,SP,Sudeste,BUTANTAN/SINOVAC,854,436,418
Ribeirão Dos Índios,354323,SP,Sudeste,FIOCRUZ/ASTRAZENECA,763,654,109
Ribeirão Dos Índios,354323,SP,Sudeste,PFIZER/BIONTECH,78,78,0
Ribeirão Grande,354325,SP,Sudeste,FIOCRUZ/ASTRAZENECA,3109,2996,113
Ribeirão Grande,354325,SP,Sudeste,BUTANTAN/SINOVAC,2246,1200,1046
Ribeirão Grande,354325,SP,Sudeste,PFIZER/BIONTECH,134,134,0
Ribeirão Pires,354330,SP,Sudeste,FIOCRUZ/ASTRAZENECA,24288,22626,1662
Ribeirão Pires,354330,SP,Sudeste,BUTANTAN/SINOVAC,24070,11983,12087
Ribeirão Pires,354330,SP,Sudeste,PFIZER/BIONTECH,90,90,0
Ribeirão Preto,354340,SP,Sudeste,FIOCRUZ/ASTRAZENECA,189274,175170,14104
Ribeirão Preto,354340,SP,Sudeste,BUTANTAN/SINOVAC,162006,81364,80642
Ribeirão Preto,354340,SP,Sudeste,PFIZER/BIONTECH,4230,4218,12
Ribeirão Vermelho,315470,MG,Sudeste,FIOCRUZ/ASTRAZENECA,868,789,79
Ribeirão Vermelho,315470,MG,Sudeste,BUTANTAN/SINOVAC,627,468,159
Ribeirão Vermelho,315470,MG,Sudeste,PFIZER/BIONTECH,71,71,0
Ribeirãozinho,510719,MT,Centro-Oeste,BUTANTAN/SINOVAC,817,460,357
Ribeirãozinho,510719,MT,Centro-Oeste,FIOCRUZ/ASTRAZENECA,694,654,40
Ribeirãozinho,510719,MT,Centro-Oeste,PFIZER/BIONTECH,41,41,0
Ribeiro Gonçalves,220890,PI,Nordeste,FIOCRUZ/ASTRAZENECA,1127,1027,100
Ribeiro Gonçalves,220890,PI,Nordeste,BUTANTAN/SINOVAC,684,355,329
Ribeiro Gonçalves,220890,PI,Nordeste,PFIZER/BIONTECH,90,90,0
Ribeirópolis,280600,SE,Nordeste,BUTANTAN/SINOVAC,4803,2452,2351
Ribeirópolis,280600,SE,Nordeste,FIOCRUZ/ASTRAZENECA,3347,3336,11
Ribeirópolis,280600,SE,Nordeste,PFIZER/BIONTECH,454,454,0
Rifaina,354360,SP,Sudeste,FIOCRUZ/ASTRAZENECA,1248,1151,97
Rifaina,354360,SP,Sudeste,BUTANTAN/SINOVAC,1152,591,561
Rifaina,354360,SP,Sudeste,PFIZER/BIONTECH,81,81,0
Rincão,354370,SP,Sudeste,BUTANTAN/SINOVAC,2994,1636,1358
Rincão,354370,SP,Sudeste,FIOCRUZ/ASTRAZENECA,2021,1810,211
Rinópolis,354380,SP,Sudeste,BUTANTAN/SINOVAC,2775,1449,1326
Rinópolis,354380,SP,Sudeste,FIOCRUZ/ASTRAZENECA,2201,1927,274
Rinópolis,354380,SP,Sudeste,PFIZER/BIONTECH,88,88,0
Rio Acima,315480,MG,Sudeste,FIOCRUZ/ASTRAZENECA,2271,2123,148
Rio Acima,315480,MG,Sudeste,BUTANTAN/SINOVAC,1551,782,769
Rio Acima,315480,MG,Sudeste,PFIZER/BIONTECH,63,63,0
Rio Azul,412200,PR,Sul,FIOCRUZ/ASTRAZENECA,2853,2655,198
Rio Azul,412200,PR,Sul,BUTANTAN/SINOVAC,2623,1389,1234
Rio Azul,412200,PR,Sul,PFIZER/BIONTECH,180,180,0
Rio Bananal,320435,ES,Sudeste,BUTANTAN/SINOVAC,4515,2432,2083
Rio Bananal,320435,ES,Sudeste,FIOCRUZ/ASTRAZENECA,3623,3450,173
Rio Bananal,320435,ES,Sudeste,PFIZER/BIONTECH,515,515,0
Rio Bom,412210,PR,Sul,FIOCRUZ/ASTRAZENECA,1350,1279,71
Rio Bom,412210,PR,Sul,BUTANTAN/SINOVAC,1107,584,523
Rio Bom,412210,PR,Sul,PFIZER/BIONTECH,23,23,0
Rio Bonito,330430,RJ,Sudeste,BUTANTAN/SINOVAC,13470,7030,6440
Rio Bonito,330430,RJ,Sudeste,FIOCRUZ/ASTRAZENECA,10923,9748,1175
Rio Bonito,330430,RJ,Sudeste,PFIZER/BIONTECH,86,86,0
Rio Bonito Do Iguaçu,412215,PR,Sul,FIOCRUZ/ASTRAZENECA,4036,3907,129
Rio Bonito Do Iguaçu,412215,PR,Sul,BUTANTAN/SINOVAC,2382,1269,1113
Rio Bonito Do Iguaçu,412215,PR,Sul,PFIZER/BIONTECH,156,156,0
Rio Branco,120040,AC,Norte,FIOCRUZ/ASTRAZENECA,93361,84052,9309
Rio Branco,120040,AC,Norte,BUTANTAN/SINOVAC,43107,23132,19975
Rio Branco,120040,AC,Norte,PFIZER/BIONTECH,13772,13759,13
Rio Branco,510720,MT,Centro-Oeste,FIOCRUZ/ASTRAZENECA,1295,1248,47
Rio Branco,510720,MT,Centro-Oeste,BUTANTAN/SINOVAC,993,530,463
Rio Branco,510720,MT,Centro-Oeste,PFIZER/BIONTECH,6,6,0
Rio Branco Do Ivaí,412217,PR,Sul,BUTANTAN/SINOVAC,887,456,431
Rio Branco Do Ivaí,412217,PR,Sul,FIOCRUZ/ASTRAZENECA,885,837,48
Rio Branco Do Sul,412220,PR,Sul,FIOCRUZ/ASTRAZENECA,5056,4845,211
Rio Branco Do Sul,412220,PR,Sul,BUTANTAN/SINOVAC,3798,2017,1781
Rio Branco Do Sul,412220,PR,Sul,PFIZER/BIONTECH,356,356,0
Rio Brilhante,500720,MS,Centro-Oeste,FIOCRUZ/ASTRAZENECA,6623,5988,635
Rio Brilhante,500720,MS,Centro-Oeste,BUTANTAN/SINOVAC,5339,2712,2627
Rio Brilhante,500720,MS,Centro-Oeste,PFIZER/BIONTECH,1302,1301,1
Rio Casca,315490,MG,Sudeste,BUTANTAN/SINOVAC,3111,1646,1465
Rio Casca,315490,MG,Sudeste,FIOCRUZ/ASTRAZENECA,2854,2708,146
Rio Casca,315490,MG,Sudeste,PFIZER/BIONTECH,246,246,0
Rio Claro,330440,RJ,Sudeste,FIOCRUZ/ASTRAZENECA,4099,3691,408
Rio Claro,330440,RJ,Sudeste,BUTANTAN/SINOVAC,3987,2133,1854
Rio Claro,330440,RJ,Sudeste,PFIZER/BIONTECH,114,114,0
Rio Claro,354390,SP,Sudeste,BUTANTAN/SINOVAC,44988,25025,19963
Rio Claro,354390,SP,Sudeste,FIOCRUZ/ASTRAZENECA,42201,37948,4253
Rio Claro,354390,SP,Sudeste,PFIZER/BIONTECH,2744,2742,2
Rio Crespo,110026,RO,Norte,BUTANTAN/SINOVAC,947,502,445
Rio Crespo,110026,RO,Norte,FIOCRUZ/ASTRAZENECA,831,808,23
Rio Crespo,110026,RO,Norte,PFIZER/BIONTECH,82,82,0
Rio Da Conceição,171865,TO,Norte,BUTANTAN/SINOVAC,345,182,163
Rio Da Conceição,171865,TO,Norte,FIOCRUZ/ASTRAZENECA,327,298,29
Rio Das Antas,421440,SC,Sul,FIOCRUZ/ASTRAZENECA,1310,1191,119
Rio Das Antas,421440,SC,Sul,BUTANTAN/SINOVAC,1226,649,577
Rio Das Antas,421440,SC,Sul,PFIZER/BIONTECH,70,70,0
Rio Das Flores,330450,RJ,Sudeste,FIOCRUZ/ASTRAZENECA,2948,2692,256
Rio Das Flores,330450,RJ,Sudeste,BUTANTAN/SINOVAC,2483,1323,1160
Rio Das Ostras,330452,RJ,Sudeste,BUTANTAN/SINOVAC,28548,14641,13907
Rio Das Ostras,330452,RJ,Sudeste,FIOCRUZ/ASTRAZENECA,16104,14681,1423
Rio Das Ostras,330452,RJ,Sudeste,PFIZER/BIONTECH,223,222,1
Rio Das Pedras,354400,SP,Sudeste,FIOCRUZ/ASTRAZENECA,7180,6832,348
Rio Das Pedras,354400,SP,Sudeste,BUTANTAN/SINOVAC,5683,2936,2747
Rio Das Pedras,354400,SP,Sudeste,PFIZER/BIONTECH,343,342,1
Rio De Contas,292670,BA,Nordeste,FIOCRUZ/ASTRAZENECA,4192,3576,616
Rio De Contas,292670,BA,Nordeste,BUTANTAN/SINOVAC,4191,2301,1890
Rio De Contas,292670,BA,Nordeste,PFIZER/BIONTECH,158,158,0
Rio De Janeiro,330455,RJ,Sudeste,BUTANTAN/SINOVAC,1743054,912608,830446
Rio De Janeiro,330455,RJ,Sudeste,FIOCRUZ/ASTRAZENECA,1715109,1567897,147212
Rio De Janeiro,330455,RJ,Sudeste,PFIZER/BIONTECH,251631,250979,652
Rio Do Antônio,292680,BA,Nordeste,BUTANTAN/SINOVAC,2771,1561,1210
Rio Do Antônio,292680,BA,Nordeste,FIOCRUZ/ASTRAZENECA,2265,1981,284
Rio Do Antônio,292680,BA,Nordeste,PFIZER/BIONTECH,145,144,1
Rio Do Campo,421450,SC,Sul,FIOCRUZ/ASTRAZENECA,1383,1295,88
Rio Do Campo,421450,SC,Sul,BUTANTAN/SINOVAC,1128,652,476
Rio Do Campo,421450,SC,Sul,PFIZER/BIONTECH,106,106,0
Rio Do Fogo,240895,RN,Nordeste,BUTANTAN/SINOVAC,1679,846,833
Rio Do Fogo,240895,RN,Nordeste,FIOCRUZ/ASTRAZENECA,1326,1186,140
Rio Do Fogo,240895,RN,Nordeste,PFIZER/BIONTECH,113,113,0
Rio Do Oeste,421460,SC,Sul,BUTANTAN/SINOVAC,1984,1028,956
Rio Do Oeste,421460,SC,Sul,FIOCRUZ/ASTRAZENECA,1733,1587,146
Rio Do Pires,292690,BA,Nordeste,BUTANTAN/SINOVAC,2790,1413,1377
Rio Do Pires,292690,BA,Nordeste,FIOCRUZ/ASTRAZENECA,2364,2160,204
Rio Do Prado,315510,MG,Sudeste,BUTANTAN/SINOVAC,1237,626,611
Rio Do Prado,315510,MG,Sudeste,FIOCRUZ/ASTRAZENECA,1012,909,103
Rio Do Prado,315510,MG,Sudeste,PFIZER/BIONTECH,20,20,0
Rio Do Sul,421480,SC,Sul,FIOCRUZ/ASTRAZENECA,15341,14022,1319
Rio Do Sul,421480,SC,Sul,BUTANTAN/SINOVAC,12681,6624,6057
Rio Do Sul,421480,SC,Sul,PFIZER/BIONTECH,1295,1295,0
Rio Doce,315500,MG,Sudeste,FIOCRUZ/ASTRAZENECA,713,674,39
Rio Doce,315500,MG,Sudeste,BUTANTAN/SINOVAC,534,274,260
Rio Doce,315500,MG,Sudeste,PFIZER/BIONTECH,23,23,0
Rio Dos Bois,171870,TO,Norte,BUTANTAN/SINOVAC,602,330,272
Rio Dos Bois,171870,TO,Norte,FIOCRUZ/ASTRAZENECA,375,352,23
Rio Dos Cedros,421470,SC,Sul,BUTANTAN/SINOVAC,3176,1658,1518
Rio Dos Cedros,421470,SC,Sul,FIOCRUZ/ASTRAZENECA,2342,2287,55
Rio Dos Cedros,421470,SC,Sul,PFIZER/BIONTECH,242,242,0
Rio Dos Índios,431555,RS,Sul,BUTANTAN/SINOVAC,905,458,447
Rio Dos Índios,431555,RS,Sul,FIOCRUZ/ASTRAZENECA,640,547,93
Rio Dos Índios,431555,RS,Sul,PFIZER/BIONTECH,48,48,0
Rio Espera,315520,MG,Sudeste,FIOCRUZ/ASTRAZENECA,1053,797,256
Rio Espera,315520,MG,Sudeste,BUTANTAN/SINOVAC,959,664,295
Rio Formoso,261190,PE,Nordeste,FIOCRUZ/ASTRAZENECA,3621,3511,110
Rio Formoso,261190,PE,Nordeste,BUTANTAN/SINOVAC,2747,1492,1255
Rio Formoso,261190,PE,Nordeste,PFIZER/BIONTECH,446,446,0
Rio Fortuna,421490,SC,Sul,FIOCRUZ/ASTRAZENECA,1241,1105,136
Rio Fortuna,421490,SC,Sul,BUTANTAN/SINOVAC,1185,622,563
Rio Fortuna,421490,SC,Sul,PFIZER/BIONTECH,271,271,0
Rio Grande,431560,RS,Sul,BUTANTAN/SINOVAC,41488,24620,16868
Rio Grande,431560,RS,Sul,FIOCRUZ/ASTRAZENECA,41473,39101,2372
Rio Grande,431560,RS,Sul,PFIZER/BIONTECH,754,754,0
Rio Grande Da Serra,354410,SP,Sudeste,BUTANTAN/SINOVAC,6755,3727,3028
Rio Grande Da Serra,354410,SP,Sudeste,FIOCRUZ/ASTRAZENECA,6400,6149,251
Rio Grande Da Serra,354410,SP,Sudeste,PFIZER/BIONTECH,314,313,1
Rio Grande Do Piauí,220900,PI,Nordeste,FIOCRUZ/ASTRAZENECA,1364,1228,136
Rio Grande Do Piauí,220900,PI,Nordeste,BUTANTAN/SINOVAC,1350,699,651
Rio Largo,270770,AL,Nordeste,FIOCRUZ/ASTRAZENECA,17170,16629,541
Rio Largo,270770,AL,Nordeste,BUTANTAN/SINOVAC,11765,6784,4981
Rio Largo,270770,AL,Nordeste,PFIZER/BIONTECH,1092,1090,2
Rio Manso,315530,MG,Sudeste,BUTANTAN/SINOVAC,1496,757,739
Rio Manso,315530,MG,Sudeste,FIOCRUZ/ASTRAZENECA,1355,1224,131
Rio Manso,315530,MG,Sudeste,PFIZER/BIONTECH,33,33,0
Rio Maria,150616,PA,Norte,FIOCRUZ/ASTRAZENECA,2981,2288,693
Rio Maria,150616,PA,Norte,BUTANTAN/SINOVAC,2112,1115,997
Rio Negrinho,421500,SC,Sul,BUTANTAN/SINOVAC,3371,2407,964
Rio Negrinho,421500,SC,Sul,FIOCRUZ/ASTRAZENECA,563,558,5
Rio Negro,412230,PR,Sul,FIOCRUZ/ASTRAZENECA,6867,6801,66
Rio Negro,412230,PR,Sul,BUTANTAN/SINOVAC,5768,3127,2641
Rio Negro,412230,PR,Sul,PFIZER/BIONTECH,379,379,0
Rio Negro,500730,MS,Centro-Oeste,BUTANTAN/SINOVAC,1551,803,748
Rio Negro,500730,MS,Centro-Oeste,FIOCRUZ/ASTRAZENECA,1136,1002,134
Rio Negro,500730,MS,Centro-Oeste,PFIZER/BIONTECH,130,130,0
Rio Novo,315540,MG,Sudeste,FIOCRUZ/ASTRAZENECA,2284,2107,177
Rio Novo,315540,MG,Sudeste,BUTANTAN/SINOVAC,2143,1076,1067
Rio Novo,315540,MG,Sudeste,PFIZER/BIONTECH,123,123,0
Rio Novo Do Sul,320440,ES,Sudeste,BUTANTAN/SINOVAC,3292,1708,1584
Rio Novo Do Sul,320440,ES,Sudeste,FIOCRUZ/ASTRAZENECA,2577,2435,142
Rio Novo Do Sul,320440,ES,Sudeste,PFIZER/BIONTECH,308,308,0
Rio Paranaíba,315550,MG,Sudeste,BUTANTAN/SINOVAC,3594,1820,1774
Rio Paranaíba,315550,MG,Sudeste,FIOCRUZ/ASTRAZENECA,2425,2244,181
Rio Paranaíba,315550,MG,Sudeste,PFIZER/BIONTECH,233,233,0
Rio Pardo,431570,RS,Sul,BUTANTAN/SINOVAC,11214,5772,5442
Rio Pardo,431570,RS,Sul,FIOCRUZ/ASTRAZENECA,10426,9390,1036
Rio Pardo,431570,RS,Sul,PFIZER/BIONTECH,525,525,0
Rio Pardo De Minas,315560,MG,Sudeste,BUTANTAN/SINOVAC,5883,3099,2784
Rio Pardo De Minas,315560,MG,Sudeste,FIOCRUZ/ASTRAZENECA,4304,3964,340
Rio Pardo De Minas,315560,MG,Sudeste,PFIZER/BIONTECH,786,786,0
Rio Piracicaba,315570,MG,Sudeste,FIOCRUZ/ASTRAZENECA,5652,4351,1301
Rio Piracicaba,315570,MG,Sudeste,BUTANTAN/SINOVAC,3219,1705,1514
Rio Piracicaba,315570,MG,Sudeste,PFIZER/BIONTECH,217,217,0
Rio Pomba,315580,MG,Sudeste,BUTANTAN/SINOVAC,3559,2051,1508
Rio Pomba,315580,MG,Sudeste,FIOCRUZ/ASTRAZENECA,2492,2153,339
Rio Pomba,315580,MG,Sudeste,PFIZER/BIONTECH,154,154,0
Rio Preto,315590,MG,Sudeste,FIOCRUZ/ASTRAZENECA,1399,1284,115
Rio Preto,315590,MG,Sudeste,BUTANTAN/SINOVAC,1358,670,688
Rio Preto,315590,MG,Sudeste,PFIZER/BIONTECH,74,74,0
Rio Preto Da Eva,130356,AM,Norte,FIOCRUZ/ASTRAZENECA,3489,2678,811
Rio Preto Da Eva,130356,AM,Norte,BUTANTAN/SINOVAC,2699,1678,1021
Rio Quente,521878,GO,Centro-Oeste,FIOCRUZ/ASTRAZENECA,943,872,71
Rio Quente,521878,GO,Centro-Oeste,BUTANTAN/SINOVAC,575,289,286
Rio Quente,521878,GO,Centro-Oeste,PFIZER/BIONTECH,10,10,0
Rio Real,292700,BA,Nordeste,FIOCRUZ/ASTRAZENECA,5653,5149,504
Rio Real,292700,BA,Nordeste,BUTANTAN/SINOVAC,3689,2332,1357
Rio Rufino,421505,SC,Sul,FIOCRUZ/ASTRAZENECA,743,705,38
Rio Rufino,421505,SC,Sul,BUTANTAN/SINOVAC,659,370,289
Rio Rufino,421505,SC,Sul,PFIZER/BIONTECH,24,24,0
Rio Sono,171875,TO,Norte,BUTANTAN/SINOVAC,1195,671,524
Rio Sono,171875,TO,Norte,FIOCRUZ/ASTRAZENECA,420,387,33
Rio Tinto,251290,PB,Nordeste,BUTANTAN/SINOVAC,8945,4570,4375
Rio Tinto,251290,PB,Nordeste,FIOCRUZ/ASTRAZENECA,3320,3028,292
Rio Tinto,251290,PB,Nordeste,PFIZER/BIONTECH,200,200,0
Rio Verde,521880,GO,Centro-Oeste,FIOCRUZ/ASTRAZENECA,42571,37732,4839
Rio Verde,521880,GO,Centro-Oeste,BUTANTAN/SINOVAC,34237,18773,15464
Rio Verde,521880,GO,Centro-Oeste,PFIZER/BIONTECH,9303,9295,8
Rio Verde De Mato Grosso,500740,MS,Centro-Oeste,BUTANTAN/SINOVAC,5360,2786,2574
Rio Verde De Mato Grosso,500740,MS,Centro-Oeste,FIOCRUZ/ASTRAZENECA,5048,4553,495
Rio Verde De Mato Grosso,500740,MS,Centro-Oeste,PFIZER/BIONTECH,349,349,0
Rio Vermelho,315600,MG,Sudeste,BUTANTAN/SINOVAC,2527,1446,1081
Rio Vermelho,315600,MG,Sudeste,FIOCRUZ/ASTRAZENECA,1115,1044,71
Riolândia,354420,SP,Sudeste,BUTANTAN/SINOVAC,2458,1416,1042
Riolândia,354420,SP,Sudeste,FIOCRUZ/ASTRAZENECA,1740,1599,141
Riolândia,354420,SP,Sudeste,PFIZER/BIONTECH,97,97,0
Riozinho,431575,RS,Sul,BUTANTAN/SINOVAC,1300,661,639
Riozinho,431575,RS,Sul,FIOCRUZ/ASTRAZENECA,1005,930,75
Riozinho,431575,RS,Sul,PFIZER/BIONTECH,186,186,0
Riqueza,421507,SC,Sul,BUTANTAN/SINOVAC,1329,728,601
Riqueza,421507,SC,Sul,FIOCRUZ/ASTRAZENECA,1164,1081,83
Riqueza,421507,SC,Sul,PFIZER/BIONTECH,60,60,0
Ritápolis,315610,MG,Sudeste,FIOCRUZ/ASTRAZENECA,1504,1379,125
Ritápolis,315610,MG,Sudeste,BUTANTAN/SINOVAC,1358,709,649
Ritápolis,315610,MG,Sudeste,PFIZER/BIONTECH,29,29,0
Riversul,354350,SP,Sudeste,BUTANTAN/SINOVAC,1407,747,660
Riversul,354350,SP,Sudeste,FIOCRUZ/ASTRAZENECA,1389,1273,116
Riversul,354350,SP,Sudeste,PFIZER/BIONTECH,216,216,0
Roca Sales,431580,RS,Sul,BUTANTAN/SINOVAC,3062,1676,1386
Roca Sales,431580,RS,Sul,FIOCRUZ/ASTRAZENECA,2708,2450,258
Roca Sales,431580,RS,Sul,PFIZER/BIONTECH,263,262,1
Rochedo,500750,MS,Centro-Oeste,FIOCRUZ/ASTRAZENECA,1546,1391,155
Rochedo,500750,MS,Centro-Oeste,BUTANTAN/SINOVAC,1210,624,586
Rochedo,500750,MS,Centro-Oeste,PFIZER/BIONTECH,178,178,0
Rochedo De Minas,315620,MG,Sudeste,FIOCRUZ/ASTRAZENECA,715,666,49
Rochedo De Minas,315620,MG,Sudeste,BUTANTAN/SINOVAC,568,281,287
Rochedo De Minas,315620,MG,Sudeste,PFIZER/BIONTECH,47,47,0
Rodeio,421510,SC,Sul,BUTANTAN/SINOVAC,2870,1453,1417
Rodeio,421510,SC,Sul,FIOCRUZ/ASTRAZENECA,2514,2458,56
Rodeio,421510,SC,Sul,PFIZER/BIONTECH,209,209,0
Rodeio Bonito,431590,RS,Sul,BUTANTAN/SINOVAC,1869,935,934
Rodeio Bonito,431590,RS,Sul,FIOCRUZ/ASTRAZENECA,1535,1359,176
Rodeio Bonito,431590,RS,Sul,PFIZER/BIONTECH,181,181,0
Rodeiro,315630,MG,Sudeste,BUTANTAN/SINOVAC,1172,643,529
Rodeiro,315630,MG,Sudeste,FIOCRUZ/ASTRAZENECA,884,817,67
Rodelas,292710,BA,Nordeste,BUTANTAN/SINOVAC,3165,1666,1499
Rodelas,292710,BA,Nordeste,FIOCRUZ/ASTRAZENECA,1070,1052,18
Rodolfo Fernandes,241100,RN,Nordeste,BUTANTAN/SINOVAC,1114,582,532
Rodolfo Fernandes,241100,RN,Nordeste,FIOCRUZ/ASTRAZENECA,1017,956,61
Rodolfo Fernandes,241100,RN,Nordeste,PFIZER/BIONTECH,125,125,0
Rodrigues Alves,120042,AC,Norte,BUTANTAN/SINOVAC,2800,1574,1226
Rodrigues Alves,120042,AC,Norte,FIOCRUZ/ASTRAZENECA,1290,1134,156
Rolador,431595,RS,Sul,BUTANTAN/SINOVAC,765,408,357
Rolador,431595,RS,Sul,FIOCRUZ/ASTRAZENECA,686,601,85
Rolador,431595,RS,Sul,PFIZER/BIONTECH,121,121,0
Rolândia,412240,PR,Sul,BUTANTAN/SINOVAC,12212,6319,5893
Rolândia,412240,PR,Sul,FIOCRUZ/ASTRAZENECA,10673,8901,1772
Rolândia,412240,PR,Sul,PFIZER/BIONTECH,482,482,0
Rolante,431600,RS,Sul,BUTANTAN/SINOVAC,5214,2690,2524
Rolante,431600,RS,Sul,FIOCRUZ/ASTRAZENECA,4364,4157,207
Rolante,431600,RS,Sul,PFIZER/BIONTECH,143,143,0
Rolim De Moura,110028,RO,Norte,BUTANTAN/SINOVAC,9600,5055,4545
Rolim De Moura,110028,RO,Norte,FIOCRUZ/ASTRAZENECA,8529,8085,444
Rolim De Moura,110028,RO,Norte,PFIZER/BIONTECH,334,334,0
Romaria,315640,MG,Sudeste,FIOCRUZ/ASTRAZENECA,803,751,52
Romaria,315640,MG,Sudeste,BUTANTAN/SINOVAC,734,377,357
Romaria,315640,MG,Sudeste,PFIZER/BIONTECH,48,48,0
Romelândia,421520,SC,Sul,BUTANTAN/SINOVAC,1358,678,680
Romelândia,421520,SC,Sul,FIOCRUZ/ASTRAZENECA,1230,1115,115
Romelândia,421520,SC,Sul,PFIZER/BIONTECH,87,87,0
Roncador,412250,PR,Sul,FIOCRUZ/ASTRAZENECA,2070,1947,123
Roncador,412250,PR,Sul,BUTANTAN/SINOVAC,1986,1024,962
Ronda Alta,431610,RS,Sul,BUTANTAN/SINOVAC,4026,2028,1998
Ronda Alta,431610,RS,Sul,FIOCRUZ/ASTRAZENECA,2713,2382,331
Ronda Alta,431610,RS,Sul,PFIZER/BIONTECH,390,388,2
Rondinha,431620,RS,Sul,BUTANTAN/SINOVAC,2321,1185,1136
Rondinha,431620,RS,Sul,FIOCRUZ/ASTRAZENECA,1619,1370,249
Rondinha,431620,RS,Sul,PFIZER/BIONTECH,198,197,1
Rondolândia,510757,MT,Centro-Oeste,BUTANTAN/SINOVAC,527,269,258
Rondolândia,510757,MT,Centro-Oeste,FIOCRUZ/ASTRAZENECA,473,440,33
Rondolândia,510757,MT,Centro-Oeste,PFIZER/BIONTECH,20,20,0
Rondon,412260,PR,Sul,FIOCRUZ/ASTRAZENECA,2468,2337,131
Rondon,412260,PR,Sul,BUTANTAN/SINOVAC,1934,1006,928
Rondon,412260,PR,Sul,PFIZER/BIONTECH,125,125,0
Rondon Do Pará,150618,PA,Norte,FIOCRUZ/ASTRAZENECA,5892,5529,363
Rondon Do Pará,150618,PA,Norte,BUTANTAN/SINOVAC,1899,1034,865
Rondonópolis,510760,MT,Centro-Oeste,FIOCRUZ/ASTRAZENECA,43815,40401,3414
Rondonópolis,510760,MT,Centro-Oeste,BUTANTAN/SINOVAC,37068,21158,15910
Rondonópolis,510760,MT,Centro-Oeste,PFIZER/BIONTECH,1308,1308,0
Roque Gonzales,431630,RS,Sul,BUTANTAN/SINOVAC,2055,1084,971
Roque Gonzales,431630,RS,Sul,FIOCRUZ/ASTRAZENECA,1969,1778,191
Roque Gonzales,431630,RS,Sul,PFIZER/BIONTECH,210,210,0
Rorainópolis,140047,RR,Norte,BUTANTAN/SINOVAC,4251,2199,2052
Rorainópolis,140047,RR,Norte,FIOCRUZ/ASTRAZENECA,3049,2990,59
Rosana,354425,SP,Sudeste,BUTANTAN/SINOVAC,4592,2256,2336
Rosana,354425,SP,Sudeste,FIOCRUZ/ASTRAZENECA,4587,4307,280
Rosana,354425,SP,Sudeste,PFIZER/BIONTECH,518,518,0
Rosário,210960,MA,Nordeste,FIOCRUZ/ASTRAZENECA,9216,8724,492
Rosário,210960,MA,Nordeste,BUTANTAN/SINOVAC,4978,2633,2345
Rosário,210960,MA,Nordeste,PFIZER/BIONTECH,111,111,0
Rosário Da Limeira,315645,MG,Sudeste,BUTANTAN/SINOVAC,1234,631,603
Rosário Da Limeira,315645,MG,Sudeste,FIOCRUZ/ASTRAZENECA,1027,932,95
Rosário Da Limeira,315645,MG,Sudeste,PFIZER/BIONTECH,107,107,0
Rosário Do Catete,280610,SE,Nordeste,FIOCRUZ/ASTRAZENECA,1456,1456,0
Rosário Do Catete,280610,SE,Nordeste,BUTANTAN/SINOVAC,1201,800,401
Rosário Do Catete,280610,SE,Nordeste,PFIZER/BIONTECH,172,172,0
Rosário Do Ivaí,412265,PR,Sul,FIOCRUZ/ASTRAZENECA,1621,1524,97
Rosário Do Ivaí,412265,PR,Sul,BUTANTAN/SINOVAC,1388,718,670
Rosário Do Ivaí,412265,PR,Sul,PFIZER/BIONTECH,20,20,0
Rosário Do Sul,431640,RS,Sul,BUTANTAN/SINOVAC,10957,5724,5233
Rosário Do Sul,431640,RS,Sul,FIOCRUZ/ASTRAZENECA,9425,8743,682
Rosário Do Sul,431640,RS,Sul,PFIZER/BIONTECH,1456,1455,1
Rosário Oeste,510770,MT,Centro-Oeste,BUTANTAN/SINOVAC,3361,1691,1670
Rosário Oeste,510770,MT,Centro-Oeste,FIOCRUZ/ASTRAZENECA,2833,2629,204
Rosário Oeste,510770,MT,Centro-Oeste,PFIZER/BIONTECH,12,12,0
Roseira,354430,SP,Sudeste,FIOCRUZ/ASTRAZENECA,2226,2058,168
Roseira,354430,SP,Sudeste,BUTANTAN/SINOVAC,1961,964,997
Roseira,354430,SP,Sudeste,PFIZER/BIONTECH,107,107,0
Roteiro,270780,AL,Nordeste,BUTANTAN/SINOVAC,872,445,427
Roteiro,270780,AL,Nordeste,FIOCRUZ/ASTRAZENECA,674,539,135
Roteiro,270780,AL,Nordeste,PFIZER/BIONTECH,126,125,1
Rubelita,315650,MG,Sudeste,BUTANTAN/SINOVAC,943,472,471
Rubelita,315650,MG,Sudeste,FIOCRUZ/ASTRAZENECA,823,717,106
Rubelita,315650,MG,Sudeste,PFIZER/BIONTECH,27,27,0
Rubiácea,354440,SP,Sudeste,BUTANTAN/SINOVAC,687,348,339
Rubiácea,354440,SP,Sudeste,FIOCRUZ/ASTRAZENECA,686,623,63
Rubiácea,354440,SP,Sudeste,PFIZER/BIONTECH,105,105,0
Rubiataba,521890,GO,Centro-Oeste,FIOCRUZ/ASTRAZENECA,6754,5997,757
Rubiataba,521890,GO,Centro-Oeste,BUTANTAN/SINOVAC,3179,1707,1472
Rubiataba,521890,GO,Centro-Oeste,PFIZER/BIONTECH,192,192,0
Rubim,315660,MG,Sudeste,BUTANTAN/SINOVAC,2739,1385,1354
Rubim,315660,MG,Sudeste,FIOCRUZ/ASTRAZENECA,2035,1856,179
Rubim,315660,MG,Sudeste,PFIZER/BIONTECH,57,57,0
Rubinéia,354450,SP,Sudeste,FIOCRUZ/ASTRAZENECA,1546,1427,119
Rubinéia,354450,SP,Sudeste,BUTANTAN/SINOVAC,1353,673,680
Rubinéia,354450,SP,Sudeste,PFIZER/BIONTECH,108,108,0
Rurópolis,150619,PA,Norte,FIOCRUZ/ASTRAZENECA,5081,4118,963
Rurópolis,150619,PA,Norte,BUTANTAN/SINOVAC,1794,922,872
Russas,231180,CE,Nordeste,BUTANTAN/SINOVAC,5660,4549,1111
Russas,231180,CE,Nordeste,FIOCRUZ/ASTRAZENECA,1470,1451,19
Ruy Barbosa,241110,RN,Nordeste,BUTANTAN/SINOVAC,827,416,411
Ruy Barbosa,241110,RN,Nordeste,FIOCRUZ/ASTRAZENECA,732,679,53
Ruy Barbosa,241110,RN,Nordeste,PFIZER/BIONTECH,134,134,0
Ruy Barbosa,292720,BA,Nordeste,FIOCRUZ/ASTRAZENECA,6095,5137,958
Ruy Barbosa,292720,BA,Nordeste,BUTANTAN/SINOVAC,5862,3071,2791
Ruy Barbosa,292720,BA,Nordeste,PFIZER/BIONTECH,266,264,2
Sabará,315670,MG,Sudeste,BUTANTAN/SINOVAC,25904,13532,12372
Sabará,315670,MG,Sudeste,FIOCRUZ/ASTRAZENECA,24229,21770,2459
Sabará,315670,MG,Sudeste,PFIZER/BIONTECH,2845,2843,2
Sabáudia,412270,PR,Sul,FIOCRUZ/ASTRAZENECA,1864,1766,98
Sabáudia,412270,PR,Sul,BUTANTAN/SINOVAC,1486,760,726
Sabáudia,412270,PR,Sul,PFIZER/BIONTECH,23,23,0
Sabino,354460,SP,Sudeste,BUTANTAN/SINOVAC,1677,926,751
Sabino,354460,SP,Sudeste,FIOCRUZ/ASTRAZENECA,1597,1400,197
Sabino,354460,SP,Sudeste,PFIZER/BIONTECH,34,34,0
Sabinópolis,315680,MG,Sudeste,FIOCRUZ/ASTRAZENECA,3923,3662,261
Sabinópolis,315680,MG,Sudeste,BUTANTAN/SINOVAC,3757,2147,1610
Sabinópolis,315680,MG,Sudeste,PFIZER/BIONTECH,184,184,0
Saboeiro,231190,CE,Nordeste,BUTANTAN/SINOVAC,2750,1511,1239
Saboeiro,231190,CE,Nordeste,FIOCRUZ/ASTRAZENECA,1102,1030,72
Sacramento,315690,MG,Sudeste,BUTANTAN/SINOVAC,5098,2720,2378
Sacramento,315690,MG,Sudeste,FIOCRUZ/ASTRAZENECA,4218,3934,284
Sacramento,315690,MG,Sudeste,PFIZER/BIONTECH,10,10,0
Sagrada Família,431642,RS,Sul,FIOCRUZ/ASTRAZENECA,751,660,91
Sagrada Família,431642,RS,Sul,BUTANTAN/SINOVAC,689,374,315
Sagrada Família,431642,RS,Sul,PFIZER/BIONTECH,104,104,0
Sagres,354470,SP,Sudeste,BUTANTAN/SINOVAC,835,472,363
Sagres,354470,SP,Sudeste,FIOCRUZ/ASTRAZENECA,738,673,65
Sagres,354470,SP,Sudeste,PFIZER/BIONTECH,69,69,0
Sairé,261200,PE,Nordeste,BUTANTAN/SINOVAC,1955,997,958
Sairé,261200,PE,Nordeste,FIOCRUZ/ASTRAZENECA,1930,1757,173
Sairé,261200,PE,Nordeste,PFIZER/BIONTECH,108,108,0
Saldanha Marinho,431643,RS,Sul,BUTANTAN/SINOVAC,1190,603,587
Saldanha Marinho,431643,RS,Sul,FIOCRUZ/ASTRAZENECA,786,684,102
Saldanha Marinho,431643,RS,Sul,PFIZER/BIONTECH,118,118,0
Sales,354480,SP,Sudeste,FIOCRUZ/ASTRAZENECA,1716,1561,155
Sales,354480,SP,Sudeste,BUTANTAN/SINOVAC,1614,815,799
Sales,354480,SP,Sudeste,PFIZER/BIONTECH,156,155,1
Sales Oliveira,354490,SP,Sudeste,FIOCRUZ/ASTRAZENECA,3113,2787,326
Sales Oliveira,354490,SP,Sudeste,BUTANTAN/SINOVAC,2971,1429,1542
Sales Oliveira,354490,SP,Sudeste,PFIZER/BIONTECH,106,106,0
Salesópolis,354500,SP,Sudeste,FIOCRUZ/ASTRAZENECA,4699,4345,354
Salesópolis,354500,SP,Sudeste,BUTANTAN/SINOVAC,3915,2030,1885
Salesópolis,354500,SP,Sudeste,PFIZER/BIONTECH,416,416,0
Salete,421530,SC,Sul,FIOCRUZ/ASTRAZENECA,1750,1626,124
Salete,421530,SC,Sul,BUTANTAN/SINOVAC,1581,870,711
Salete,421530,SC,Sul,PFIZER/BIONTECH,107,107,0
Salgadinho,251300,PB,Nordeste,BUTANTAN/SINOVAC,598,342,256
Salgadinho,251300,PB,Nordeste,FIOCRUZ/ASTRAZENECA,479,439,40
Salgadinho,251300,PB,Nordeste,PFIZER/BIONTECH,42,42,0
Salgadinho,261210,PE,Nordeste,FIOCRUZ/ASTRAZENECA,2273,2071,202
Salgadinho,261210,PE,Nordeste,BUTANTAN/SINOVAC,1724,916,808
Salgadinho,261210,PE,Nordeste,PFIZER/BIONTECH,53,53,0
Salgado,280620,SE,Nordeste,BUTANTAN/SINOVAC,3813,1999,1814
Salgado,280620,SE,Nordeste,FIOCRUZ/ASTRAZENECA,2360,2359,1
Salgado,280620,SE,Nordeste,PFIZER/BIONTECH,263,263,0
Salgado De São Félix,251310,PB,Nordeste,BUTANTAN/SINOVAC,4163,2325,1838
Salgado De São Félix,251310,PB,Nordeste,FIOCRUZ/ASTRAZENECA,2533,2322,211
Salgado De São Félix,251310,PB,Nordeste,PFIZER/BIONTECH,88,88,0
Salgado Filho,412280,PR,Sul,FIOCRUZ/ASTRAZENECA,942,864,78
Salgado Filho,412280,PR,Sul,BUTANTAN/SINOVAC,915,467,448
Salgueiro,261220,PE,Nordeste,FIOCRUZ/ASTRAZENECA,20447,17875,2572
Salgueiro,261220,PE,Nordeste,BUTANTAN/SINOVAC,13014,6703,6311
Salgueiro,261220,PE,Nordeste,PFIZER/BIONTECH,1733,1731,2
Salinas,315700,MG,Sudeste,BUTANTAN/SINOVAC,5036,2866,2170
Salinas,315700,MG,Sudeste,FIOCRUZ/ASTRAZENECA,4547,4238,309
Salinas,315700,MG,Sudeste,PFIZER/BIONTECH,146,146,0
Salinas Da Margarida,292730,BA,Nordeste,FIOCRUZ/ASTRAZENECA,4808,4683,125
Salinas Da Margarida,292730,BA,Nordeste,BUTANTAN/SINOVAC,2307,1165,1142
Salinas Da Margarida,292730,BA,Nordeste,PFIZER/BIONTECH,287,287,0
Salinópolis,150620,PA,Norte,FIOCRUZ/ASTRAZENECA,7195,5683,1512
Salinópolis,150620,PA,Norte,BUTANTAN/SINOVAC,4410,2322,2088
Salitre,231195,CE,Nordeste,FIOCRUZ/ASTRAZENECA,3250,3071,179
Salitre,231195,CE,Nordeste,BUTANTAN/SINOVAC,2485,1299,1186
Salitre,231195,CE,Nordeste,PFIZER/BIONTECH,12,12,0
Salmourão,354510,SP,Sudeste,BUTANTAN/SINOVAC,1193,667,526
Salmourão,354510,SP,Sudeste,FIOCRUZ/ASTRAZENECA,1153,1055,98
Salmourão,354510,SP,Sudeste,PFIZER/BIONTECH,70,70,0
Saloá,261230,PE,Nordeste,FIOCRUZ/ASTRAZENECA,3483,3188,295
Saloá,261230,PE,Nordeste,BUTANTAN/SINOVAC,3042,1572,1470
Saloá,261230,PE,Nordeste,PFIZER/BIONTECH,455,455,0
Saltinho,354515,SP,Sudeste,BUTANTAN/SINOVAC,3384,1893,1491
Saltinho,354515,SP,Sudeste,FIOCRUZ/ASTRAZENECA,3339,3072,267
Saltinho,354515,SP,Sudeste,PFIZER/BIONTECH,192,192,0
Saltinho,421535,SC,Sul,FIOCRUZ/ASTRAZENECA,1097,1009,88
Saltinho,421535,SC,Sul,BUTANTAN/SINOVAC,1070,556,514
Salto,354520,SP,Sudeste,BUTANTAN/SINOVAC,20992,11359,9633
Salto,354520,SP,Sudeste,FIOCRUZ/ASTRAZENECA,20185,18472,1713
Salto,354520,SP,Sudeste,PFIZER/BIONTECH,2894,2891,3
Salto Da Divisa,315710,MG,Sudeste,BUTANTAN/SINOVAC,1343,709,634
Salto Da Divisa,315710,MG,Sudeste,FIOCRUZ/ASTRAZENECA,1094,1015,79
Salto Da Divisa,315710,MG,Sudeste,PFIZER/BIONTECH,45,45,0
Salto De Pirapora,354530,SP,Sudeste,FIOCRUZ/ASTRAZENECA,12623,11766,857
Salto De Pirapora,354530,SP,Sudeste,BUTANTAN/SINOVAC,10617,5549,5068
Salto De Pirapora,354530,SP,Sudeste,PFIZER/BIONTECH,627,627,0
Salto Do Céu,510775,MT,Centro-Oeste,BUTANTAN/SINOVAC,857,451,406
Salto Do Céu,510775,MT,Centro-Oeste,FIOCRUZ/ASTRAZENECA,836,782,54
Salto Do Céu,510775,MT,Centro-Oeste,PFIZER/BIONTECH,17,17,0
Salto Do Itararé,412290,PR,Sul,FIOCRUZ/ASTRAZENECA,1474,1416,58
Salto Do Itararé,412290,PR,Sul,BUTANTAN/SINOVAC,1025,663,362
Salto Do Jacuí,431645,RS,Sul,BUTANTAN/SINOVAC,3161,1645,1516
Salto Do Jacuí,431645,RS,Sul,FIOCRUZ/ASTRAZENECA,3018,2926,92
Salto Do Jacuí,431645,RS,Sul,PFIZER/BIONTECH,384,384,0
Salto Do Lontra,412300,PR,Sul,FIOCRUZ/ASTRAZENECA,3306,3127,179
Salto Do Lontra,412300,PR,Sul,BUTANTAN/SINOVAC,2579,1360,1219
Salto Grande,354540,SP,Sudeste,FIOCRUZ/ASTRAZENECA,2274,2110,164
Salto Grande,354540,SP,Sudeste,BUTANTAN/SINOVAC,1943,1083,860
Salto Grande,354540,SP,Sudeste,PFIZER/BIONTECH,92,92,0
Salto Veloso,421540,SC,Sul,FIOCRUZ/ASTRAZENECA,1154,1054,100
Salto Veloso,421540,SC,Sul,BUTANTAN/SINOVAC,1055,551,504
Salto Veloso,421540,SC,Sul,PFIZER/BIONTECH,58,58,0
Salvador,292740,BA,Nordeste,BUTANTAN/SINOVAC,654139,346266,307873
Salvador,292740,BA,Nordeste,FIOCRUZ/ASTRAZENECA,600314,501365,98949
Salvador,292740,BA,Nordeste,PFIZER/BIONTECH,161613,161591,22
Salvador Das Missões,431647,RS,Sul,BUTANTAN/SINOVAC,899,464,435
Salvador Das Missões,431647,RS,Sul,FIOCRUZ/ASTRAZENECA,812,693,119
Salvador Das Missões,431647,RS,Sul,PFIZER/BIONTECH,132,132,0
Salvador Do Sul,431650,RS,Sul,BUTANTAN/SINOVAC,2273,1141,1132
Salvador Do Sul,431650,RS,Sul,FIOCRUZ/ASTRAZENECA,1627,1531,96
Salvador Do Sul,431650,RS,Sul,PFIZER/BIONTECH,186,186,0
Salvaterra,150630,PA,Norte,FIOCRUZ/ASTRAZENECA,5294,5149,145
Salvaterra,150630,PA,Norte,BUTANTAN/SINOVAC,1317,686,631
Sambaíba,210970,MA,Nordeste,FIOCRUZ/ASTRAZENECA,1107,1018,89
Sambaíba,210970,MA,Nordeste,BUTANTAN/SINOVAC,1037,545,492
Sampaio,171880,TO,Norte,BUTANTAN/SINOVAC,692,354,338
Sampaio,171880,TO,Norte,FIOCRUZ/ASTRAZENECA,447,415,32
Sananduva,431660,RS,Sul,FIOCRUZ/ASTRAZENECA,4847,4193,654
Sananduva,431660,RS,Sul,BUTANTAN/SINOVAC,4645,2347,2298
Sananduva,431660,RS,Sul,PFIZER/BIONTECH,590,589,1
Sanclerlândia,521900,GO,Centro-Oeste,FIOCRUZ/ASTRAZENECA,2218,2075,143
Sanclerlândia,521900,GO,Centro-Oeste,BUTANTAN/SINOVAC,1782,971,811
Sandolândia,171884,TO,Norte,BUTANTAN/SINOVAC,903,461,442
Sandolândia,171884,TO,Norte,FIOCRUZ/ASTRAZENECA,520,492,28
Sandovalina,354550,SP,Sudeste,FIOCRUZ/ASTRAZENECA,1035,982,53
Sandovalina,354550,SP,Sudeste,BUTANTAN/SINOVAC,897,406,491
Sandovalina,354550,SP,Sudeste,PFIZER/BIONTECH,91,91,0
Sangão,421545,SC,Sul,FIOCRUZ/ASTRAZENECA,3437,3259,178
Sangão,421545,SC,Sul,BUTANTAN/SINOVAC,2267,1198,1069
Sangão,421545,SC,Sul,PFIZER/BIONTECH,196,196,0
Sanharó,261240,PE,Nordeste,FIOCRUZ/ASTRAZENECA,2807,2532,275
Sanharó,261240,PE,Nordeste,BUTANTAN/SINOVAC,2758,1565,1193
Sanharó,261240,PE,Nordeste,PFIZER/BIONTECH,40,40,0
Sant'Ana Do Livramento,431710,RS,Sul,BUTANTAN/SINOVAC,23090,11801,11289
Sant'Ana Do Livramento,431710,RS,Sul,FIOCRUZ/ASTRAZENECA,21038,19175,1863
Sant'Ana Do Livramento,431710,RS,Sul,PFIZER/BIONTECH,1822,1822,0
Santa Adélia,354560,SP,Sudeste,BUTANTAN/SINOVAC,3608,1806,1802
Santa Adélia,354560,SP,Sudeste,FIOCRUZ/ASTRAZENECA,3148,2854,294
Santa Adélia,354560,SP,Sudeste,PFIZER/BIONTECH,297,297,0
Santa Albertina,354570,SP,Sudeste,FIOCRUZ/ASTRAZENECA,2181,1981,200
Santa Albertina,354570,SP,Sudeste,BUTANTAN/SINOVAC,2023,1110,913
Santa Albertina,354570,SP,Sudeste,PFIZER/BIONTECH,174,159,15
Santa Amélia,412310,PR,Sul,FIOCRUZ/ASTRAZENECA,1212,1143,69
Santa Amélia,412310,PR,Sul,BUTANTAN/SINOVAC,1147,599,548
Santa Bárbara,292750,BA,Nordeste,BUTANTAN/SINOVAC,3420,1878,1542
Santa Bárbara,292750,BA,Nordeste,FIOCRUZ/ASTRAZENECA,3270,2921,349
Santa Bárbara,292750,BA,Nordeste,PFIZER/BIONTECH,590,590,0
Santa Bárbara,315720,MG,Sudeste,BUTANTAN/SINOVAC,4825,2492,2333
Santa Bárbara,315720,MG,Sudeste,FIOCRUZ/ASTRAZENECA,4658,4291,367
Santa Bárbara,315720,MG,Sudeste,PFIZER/BIONTECH,833,833,0
Santa Bárbara D'Oeste,354580,SP,Sudeste,FIOCRUZ/ASTRAZENECA,40180,37296,2884
Santa Bárbara D'Oeste,354580,SP,Sudeste,BUTANTAN/SINOVAC,38074,20706,17368
Santa Bárbara D'Oeste,354580,SP,Sudeste,PFIZER/BIONTECH,2423,2420,3
Santa Bárbara De Goiás,521910,GO,Centro-Oeste,FIOCRUZ/ASTRAZENECA,1482,1373,109
Santa Bárbara De Goiás,521910,GO,Centro-Oeste,BUTANTAN/SINOVAC,1200,614,586
Santa Bárbara Do Leste,315725,MG,Sudeste,BUTANTAN/SINOVAC,2001,1024,977
Santa Bárbara Do Leste,315725,MG,Sudeste,FIOCRUZ/ASTRAZENECA,1738,1604,134
Santa Bárbara Do Leste,315725,MG,Sudeste,PFIZER/BIONTECH,235,235,0
Santa Bárbara Do Monte Verde,315727,MG,Sudeste,BUTANTAN/SINOVAC,153,108,45
Santa Bárbara Do Monte Verde,315727,MG,Sudeste,FIOCRUZ/ASTRAZENECA,114,107,7
Santa Bárbara Do Pará,150635,PA,Norte,BUTANTAN/SINOVAC,3711,1943,1768
Santa Bárbara Do Pará,150635,PA,Norte,FIOCRUZ/ASTRAZENECA,3050,2797,253
Santa Bárbara Do Pará,150635,PA,Norte,PFIZER/BIONTECH,459,459,0
Santa Bárbara Do Sul,431670,RS,Sul,BUTANTAN/SINOVAC,2303,1182,1121
Santa Bárbara Do Sul,431670,RS,Sul,FIOCRUZ/ASTRAZENECA,2211,2029,182
Santa Bárbara Do Sul,431670,RS,Sul,PFIZER/BIONTECH,306,305,1
Santa Bárbara Do Tugúrio,315730,MG,Sudeste,BUTANTAN/SINOVAC,960,488,472
Santa Bárbara Do Tugúrio,315730,MG,Sudeste,FIOCRUZ/ASTRAZENECA,549,452,97
Santa Bárbara Do Tugúrio,315730,MG,Sudeste,PFIZER/BIONTECH,12,12,0
Santa Branca,354600,SP,Sudeste,FIOCRUZ/ASTRAZENECA,3229,3013,216
Santa Branca,354600,SP,Sudeste,BUTANTAN/SINOVAC,3175,1670,1505
Santa Branca,354600,SP,Sudeste,PFIZER/BIONTECH,231,231,0
Santa Brígida,292760,BA,Nordeste,FIOCRUZ/ASTRAZENECA,2760,2616,144
Santa Brígida,292760,BA,Nordeste,BUTANTAN/SINOVAC,2298,1246,1052
Santa Brígida,292760,BA,Nordeste,PFIZER/BIONTECH,79,79,0
Santa Carmem,510724,MT,Centro-Oeste,FIOCRUZ/ASTRAZENECA,791,738,53
Santa Carmem,510724,MT,Centro-Oeste,BUTANTAN/SINOVAC,600,299,301
Santa Cecília,251315,PB,Nordeste,BUTANTAN/SINOVAC,1251,743,508
Santa Cecília,251315,PB,Nordeste,FIOCRUZ/ASTRAZENECA,902,837,65
Santa Cecília,251315,PB,Nordeste,PFIZER/BIONTECH,132,132,0
Santa Cecília,421550,SC,Sul,FIOCRUZ/ASTRAZENECA,3275,3081,194
Santa Cecília,421550,SC,Sul,BUTANTAN/SINOVAC,2511,1373,1138
Santa Cecília,421550,SC,Sul,PFIZER/BIONTECH,181,181,0
Santa Cecília Do Pavão,412320,PR,Sul,FIOCRUZ/ASTRAZENECA,1637,1577,60
Santa Cecília Do Pavão,412320,PR,Sul,BUTANTAN/SINOVAC,1021,522,499
Santa Cecília Do Pavão,412320,PR,Sul,PFIZER/BIONTECH,19,19,0
Santa Cecília Do Sul,431673,RS,Sul,BUTANTAN/SINOVAC,597,299,298
Santa Cecília Do Sul,431673,RS,Sul,FIOCRUZ/ASTRAZENECA,476,391,85
Santa Cecília Do Sul,431673,RS,Sul,PFIZER/BIONTECH,58,58,0
Santa Clara D'Oeste,354610,SP,Sudeste,BUTANTAN/SINOVAC,996,554,442
Santa Clara D'Oeste,354610,SP,Sudeste,FIOCRUZ/ASTRAZENECA,995,922,73
Santa Clara D'Oeste,354610,SP,Sudeste,PFIZER/BIONTECH,70,70,0
Santa Clara Do Sul,431675,RS,Sul,BUTANTAN/SINOVAC,2037,1028,1009
Santa Clara Do Sul,431675,RS,Sul,FIOCRUZ/ASTRAZENECA,1642,1467,175
Santa Clara Do Sul,431675,RS,Sul,PFIZER/BIONTECH,223,223,0
Santa Cruz,241120,RN,Nordeste,FIOCRUZ/ASTRAZENECA,6747,5947,800
Santa Cruz,241120,RN,Nordeste,BUTANTAN/SINOVAC,6622,3367,3255
Santa Cruz,241120,RN,Nordeste,PFIZER/BIONTECH,1124,1124,0
Santa Cruz,251320,PB,Nordeste,BUTANTAN/SINOVAC,2366,1251,1115
Santa Cruz,251320,PB,Nordeste,FIOCRUZ/ASTRAZENECA,1388,1235,153
Santa Cruz,251320,PB,Nordeste,PFIZER/BIONTECH,85,85,0
Santa Cruz,261245,PE,Nordeste,FIOCRUZ/ASTRAZENECA,2841,2599,242
Santa Cruz,261245,PE,Nordeste,BUTANTAN/SINOVAC,2660,1346,1314
Santa Cruz,261245,PE,Nordeste,PFIZER/BIONTECH,350,350,0
Santa Cruz Cabrália,292770,BA,Nordeste,BUTANTAN/SINOVAC,6979,3804,3175
Santa Cruz Cabrália,292770,BA,Nordeste,FIOCRUZ/ASTRAZENECA,2203,1867,336
Santa Cruz Da Baixa Verde,261247,PE,Nordeste,FIOCRUZ/ASTRAZENECA,2622,2392,230
Santa Cruz Da Baixa Verde,261247,PE,Nordeste,BUTANTAN/SINOVAC,2504,1325,1179
Santa Cruz Da Baixa Verde,261247,PE,Nordeste,PFIZER/BIONTECH,387,387,0
Santa Cruz Da Conceição,354620,SP,Sudeste,BUTANTAN/SINOVAC,1472,817,655
Santa Cruz Da Conceição,354620,SP,Sudeste,FIOCRUZ/ASTRAZENECA,1203,1058,145
Santa Cruz Da Conceição,354620,SP,Sudeste,PFIZER/BIONTECH,66,66,0
Santa Cruz Da Esperança,354625,SP,Sudeste,BUTANTAN/SINOVAC,691,337,354
Santa Cruz Da Esperança,354625,SP,Sudeste,FIOCRUZ/ASTRAZENECA,455,405,50
Santa Cruz Da Esperança,354625,SP,Sudeste,PFIZER/BIONTECH,46,46,0
Santa Cruz Da Vitória,292780,BA,Nordeste,BUTANTAN/SINOVAC,1271,667,604
Santa Cruz Da Vitória,292780,BA,Nordeste,FIOCRUZ/ASTRAZENECA,1049,943,106
Santa Cruz Das Palmeiras,354630,SP,Sudeste,FIOCRUZ/ASTRAZENECA,5686,5276,410
Santa Cruz Das Palmeiras,354630,SP,Sudeste,BUTANTAN/SINOVAC,5511,3037,2474
Santa Cruz Das Palmeiras,354630,SP,Sudeste,PFIZER/BIONTECH,635,635,0
Santa Cruz De Goiás,521920,GO,Centro-Oeste,BUTANTAN/SINOVAC,936,534,402
Santa Cruz De Goiás,521920,GO,Centro-Oeste,FIOCRUZ/ASTRAZENECA,920,870,50
Santa Cruz De Minas,315733,MG,Sudeste,FIOCRUZ/ASTRAZENECA,1760,1659,101
Santa Cruz De Minas,315733,MG,Sudeste,BUTANTAN/SINOVAC,1314,675,639
Santa Cruz De Minas,315733,MG,Sudeste,PFIZER/BIONTECH,133,133,0
Santa Cruz De Monte Castelo,412330,PR,Sul,FIOCRUZ/ASTRAZENECA,2514,2358,156
Santa Cruz De Monte Castelo,412330,PR,Sul,BUTANTAN/SINOVAC,1943,1020,923
Santa Cruz De Monte Castelo,412330,PR,Sul,PFIZER/BIONTECH,121,121,0
Santa Cruz De Salinas,315737,MG,Sudeste,BUTANTAN/SINOVAC,1263,634,629
Santa Cruz De Salinas,315737,MG,Sudeste,FIOCRUZ/ASTRAZENECA,680,626,54
Santa Cruz Do Arari,150640,PA,Norte,FIOCRUZ/ASTRAZENECA,818,755,63
Santa Cruz Do Arari,150640,PA,Norte,BUTANTAN/SINOVAC,471,274,197
Santa Cruz Do Capibaribe,261250,PE,Nordeste,FIOCRUZ/ASTRAZENECA,12577,11774,803
Santa Cruz Do Capibaribe,261250,PE,Nordeste,BUTANTAN/SINOVAC,9420,5079,4341
Santa Cruz Do Capibaribe,261250,PE,Nordeste,PFIZER/BIONTECH,811,810,1
Santa Cruz Do Escalvado,315740,MG,Sudeste,FIOCRUZ/ASTRAZENECA,2190,2086,104
Santa Cruz Do Escalvado,315740,MG,Sudeste,BUTANTAN/SINOVAC,1295,658,637
Santa Cruz Do Escalvado,315740,MG,Sudeste,PFIZER/BIONTECH,87,87,0
Santa Cruz Do Piauí,220910,PI,Nordeste,FIOCRUZ/ASTRAZENECA,1998,1346,652
Santa Cruz Do Piauí,220910,PI,Nordeste,BUTANTAN/SINOVAC,1239,634,605
Santa Cruz Do Rio Pardo,354640,SP,Sudeste,FIOCRUZ/ASTRAZENECA,12378,11440,938
Santa Cruz Do Rio Pardo,354640,SP,Sudeste,BUTANTAN/SINOVAC,11739,6053,5686
Santa Cruz Do Rio Pardo,354640,SP,Sudeste,PFIZER/BIONTECH,1234,1234,0
Santa Cruz Do Sul,431680,RS,Sul,BUTANTAN/SINOVAC,35967,18523,17444
Santa Cruz Do Sul,431680,RS,Sul,FIOCRUZ/ASTRAZENECA,35054,31860,3194
Santa Cruz Do Sul,431680,RS,Sul,PFIZER/BIONTECH,4353,4343,10
Santa Cruz Do Xingu,510774,MT,Centro-Oeste,BUTANTAN/SINOVAC,397,205,192
Santa Cruz Do Xingu,510774,MT,Centro-Oeste,FIOCRUZ/ASTRAZENECA,316,304,12
Santa Cruz Dos Milagres,220915,PI,Nordeste,FIOCRUZ/ASTRAZENECA,703,642,61
Santa Cruz Dos Milagres,220915,PI,Nordeste,BUTANTAN/SINOVAC,677,346,331
Santa Cruz Dos Milagres,220915,PI,Nordeste,PFIZER/BIONTECH,47,47,0
Santa Efigênia De Minas,315750,MG,Sudeste,FIOCRUZ/ASTRAZENECA,1151,1026,125
Santa Efigênia De Minas,315750,MG,Sudeste,BUTANTAN/SINOVAC,1085,562,523
Santa Efigênia De Minas,315750,MG,Sudeste,PFIZER/BIONTECH,59,59,0
Santa Ernestina,354650,SP,Sudeste,FIOCRUZ/ASTRAZENECA,1319,1224,95
Santa Ernestina,354650,SP,Sudeste,BUTANTAN/SINOVAC,1044,549,495
Santa Ernestina,354650,SP,Sudeste,PFIZER/BIONTECH,107,107,0
Santa Fé,412340,PR,Sul,FIOCRUZ/ASTRAZENECA,3533,3330,203
Santa Fé,412340,PR,Sul,BUTANTAN/SINOVAC,2676,1376,1300
Santa Fé,412340,PR,Sul,PFIZER/BIONTECH,148,148,0
Santa Fé De Goiás,521925,GO,Centro-Oeste,FIOCRUZ/ASTRAZENECA,1159,1089,70
Santa Fé De Goiás,521925,GO,Centro-Oeste,BUTANTAN/SINOVAC,990,545,445
Santa Fé De Minas,315760,MG,Sudeste,FIOCRUZ/ASTRAZENECA,893,861,32
Santa Fé De Minas,315760,MG,Sudeste,BUTANTAN/SINOVAC,794,413,381
Santa Fé De Minas,315760,MG,Sudeste,PFIZER/BIONTECH,35,35,0
Santa Fé Do Araguaia,171886,TO,Norte,FIOCRUZ/ASTRAZENECA,1755,1518,237
Santa Fé Do Araguaia,171886,TO,Norte,BUTANTAN/SINOVAC,1461,777,684
Santa Fé Do Sul,354660,SP,Sudeste,BUTANTAN/SINOVAC,9779,5188,4591
Santa Fé Do Sul,354660,SP,Sudeste,FIOCRUZ/ASTRAZENECA,8841,7893,948
Santa Fé Do Sul,354660,SP,Sudeste,PFIZER/BIONTECH,205,205,0
Santa Filomena,220920,PI,Nordeste,FIOCRUZ/ASTRAZENECA,1121,1020,101
Santa Filomena,220920,PI,Nordeste,BUTANTAN/SINOVAC,810,443,367
Santa Filomena,220920,PI,Nordeste,PFIZER/BIONTECH,152,152,0
Santa Filomena,261255,PE,Nordeste,FIOCRUZ/ASTRAZENECA,2656,2414,242
Santa Filomena,261255,PE,Nordeste,BUTANTAN/SINOVAC,2543,1301,1242
Santa Filomena,261255,PE,Nordeste,PFIZER/BIONTECH,94,94,0
Santa Filomena Do Maranhão,210975,MA,Nordeste,FIOCRUZ/ASTRAZENECA,959,902,57
Santa Filomena Do Maranhão,210975,MA,Nordeste,BUTANTAN/SINOVAC,835,457,378
Santa Gertrudes,354670,SP,Sudeste,FIOCRUZ/ASTRAZENECA,5177,4818,359
Santa Gertrudes,354670,SP,Sudeste,BUTANTAN/SINOVAC,3772,2214,1558
Santa Gertrudes,354670,SP,Sudeste,PFIZER/BIONTECH,234,234,0
Santa Helena,210980,MA,Nordeste,FIOCRUZ/ASTRAZENECA,9881,9116,765
Santa Helena,210980,MA,Nordeste,BUTANTAN/SINOVAC,4708,2410,2298
Santa Helena,251330,PB,Nordeste,BUTANTAN/SINOVAC,1770,929,841
Santa Helena,251330,PB,Nordeste,FIOCRUZ/ASTRAZENECA,991,885,106
Santa Helena,251330,PB,Nordeste,PFIZER/BIONTECH,97,97,0
Santa Helena,412350,PR,Sul,FIOCRUZ/ASTRAZENECA,6655,6272,383
Santa Helena,412350,PR,Sul,BUTANTAN/SINOVAC,6294,3231,3063
Santa Helena,412350,PR,Sul,PFIZER/BIONTECH,283,283,0
Santa Helena,412350,PR,Sul,-,114,37,77
Santa Helena,421555,SC,Sul,FIOCRUZ/ASTRAZENECA,610,553,57
Santa Helena,421555,SC,Sul,BUTANTAN/SINOVAC,593,307,286
Santa Helena,421555,SC,Sul,PFIZER/BIONTECH,58,58,0
Santa Helena De Goiás,521930,GO,Centro-Oeste,FIOCRUZ/ASTRAZENECA,10472,9516,956
Santa Helena De Goiás,521930,GO,Centro-Oeste,BUTANTAN/SINOVAC,7856,4089,3767
Santa Helena De Goiás,521930,GO,Centro-Oeste,PFIZER/BIONTECH,213,213,0
Santa Helena De Minas,315765,MG,Sudeste,BUTANTAN/SINOVAC,2396,1239,1157
Santa Helena De Minas,315765,MG,Sudeste,FIOCRUZ/ASTRAZENECA,904,789,115
Santa Helena De Minas,315765,MG,Sudeste,PFIZER/BIONTECH,2,2,0
Santa Inês,210990,MA,Nordeste,FIOCRUZ/ASTRAZENECA,22285,21364,921
Santa Inês,210990,MA,Nordeste,BUTANTAN/SINOVAC,13074,7068,6006
Santa Inês,210990,MA,Nordeste,PFIZER/BIONTECH,3564,3564,0
Santa Inês,251335,PB,Nordeste,BUTANTAN/SINOVAC,703,364,339
Santa Inês,251335,PB,Nordeste,FIOCRUZ/ASTRAZENECA,658,608,50
Santa Inês,251335,PB,Nordeste,PFIZER/BIONTECH,59,59,0
Santa Inês,292790,BA,Nordeste,FIOCRUZ/ASTRAZENECA,2587,2353,234
Santa Inês,292790,BA,Nordeste,BUTANTAN/SINOVAC,2211,1246,965
Santa Inês,292790,BA,Nordeste,PFIZER/BIONTECH,180,180,0
Santa Inês,412360,PR,Sul,FIOCRUZ/ASTRAZENECA,843,804,39
Santa Inês,412360,PR,Sul,BUTANTAN/SINOVAC,417,215,202
Santa Isabel,354680,SP,Sudeste,FIOCRUZ/ASTRAZENECA,11624,10937,687
Santa Isabel,354680,SP,Sudeste,BUTANTAN/SINOVAC,9770,5382,4388
Santa Isabel,354680,SP,Sudeste,PFIZER/BIONTECH,110,110,0
Santa Isabel,521935,GO,Centro-Oeste,FIOCRUZ/ASTRAZENECA,1425,1366,59
Santa Isabel,521935,GO,Centro-Oeste,BUTANTAN/SINOVAC,800,413,387
Santa Isabel,521935,GO,Centro-Oeste,PFIZER/BIONTECH,6,6,0
Santa Isabel Do Ivaí,412370,PR,Sul,FIOCRUZ/ASTRAZENECA,2376,2194,182
Santa Isabel Do Ivaí,412370,PR,Sul,BUTANTAN/SINOVAC,2213,1155,1058
Santa Isabel Do Ivaí,412370,PR,Sul,PFIZER/BIONTECH,124,124,0
Santa Isabel Do Rio Negro,130360,AM,Norte,BUTANTAN/SINOVAC,4695,2549,2146
Santa Isabel Do Rio Negro,130360,AM,Norte,FIOCRUZ/ASTRAZENECA,984,660,324
Santa Izabel Do Oeste,412380,PR,Sul,FIOCRUZ/ASTRAZENECA,3564,3350,214
Santa Izabel Do Oeste,412380,PR,Sul,BUTANTAN/SINOVAC,3003,1541,1462
Santa Izabel Do Oeste,412380,PR,Sul,PFIZER/BIONTECH,188,188,0
Santa Izabel Do Pará,150650,PA,Norte,FIOCRUZ/ASTRAZENECA,12028,9329,2699
Santa Izabel Do Pará,150650,PA,Norte,BUTANTAN/SINOVAC,8827,4742,4085
Santa Juliana,315770,MG,Sudeste,FIOCRUZ/ASTRAZENECA,2769,2549,220
Santa Juliana,315770,MG,Sudeste,BUTANTAN/SINOVAC,2029,1050,979
Santa Juliana,315770,MG,Sudeste,PFIZER/BIONTECH,365,365,0
Santa Leopoldina,320450,ES,Sudeste,BUTANTAN/SINOVAC,3256,1867,1389
Santa Leopoldina,320450,ES,Sudeste,FIOCRUZ/ASTRAZENECA,3071,2956,115
Santa Leopoldina,320450,ES,Sudeste,PFIZER/BIONTECH,317,317,0
Santa Lúcia,354690,SP,Sudeste,FIOCRUZ/ASTRAZENECA,1536,1417,119
Santa Lúcia,354690,SP,Sudeste,BUTANTAN/SINOVAC,1287,737,550
Santa Lúcia,354690,SP,Sudeste,PFIZER/BIONTECH,195,195,0
Santa Lúcia,412382,PR,Sul,BUTANTAN/SINOVAC,935,480,455
Santa Lúcia,412382,PR,Sul,FIOCRUZ/ASTRAZENECA,763,704,59
Santa Lúcia,412382,PR,Sul,PFIZER/BIONTECH,6,6,0
Santa Luz,220930,PI,Nordeste,BUTANTAN/SINOVAC,963,539,424
Santa Luz,220930,PI,Nordeste,FIOCRUZ/ASTRAZENECA,909,858,51
Santa Luzia,211000,MA,Nordeste,FIOCRUZ/ASTRAZENECA,11315,10660,655
Santa Luzia,211000,MA,Nordeste,BUTANTAN/SINOVAC,9208,5013,4195
Santa Luzia,251340,PB,Nordeste,FIOCRUZ/ASTRAZENECA,4086,3765,321
Santa Luzia,251340,PB,Nordeste,BUTANTAN/SINOVAC,3959,2029,1930
Santa Luzia,251340,PB,Nordeste,PFIZER/BIONTECH,476,476,0
Santa Luzia,292805,BA,Nordeste,BUTANTAN/SINOVAC,2568,1341,1227
Santa Luzia,292805,BA,Nordeste,FIOCRUZ/ASTRAZENECA,2558,2417,141
Santa Luzia,292805,BA,Nordeste,PFIZER/BIONTECH,106,106,0
Santa Luzia,315780,MG,Sudeste,BUTANTAN/SINOVAC,29104,15502,13602
Santa Luzia,315780,MG,Sudeste,FIOCRUZ/ASTRAZENECA,28992,27060,1932
Santa Luzia,315780,MG,Sudeste,PFIZER/BIONTECH,1518,1517,1
Santa Luzia D'Oeste,110029,RO,Norte,BUTANTAN/SINOVAC,1721,878,843
Santa Luzia D'Oeste,110029,RO,Norte,FIOCRUZ/ASTRAZENECA,1056,1019,37
Santa Luzia D'Oeste,110029,RO,Norte,PFIZER/BIONTECH,20,20,0
Santa Luzia Do Itanhy,280630,SE,Nordeste,FIOCRUZ/ASTRAZENECA,4017,3915,102
Santa Luzia Do Itanhy,280630,SE,Nordeste,BUTANTAN/SINOVAC,1688,864,824
Santa Luzia Do Itanhy,280630,SE,Nordeste,PFIZER/BIONTECH,131,131,0
Santa Luzia Do Norte,270790,AL,Nordeste,FIOCRUZ/ASTRAZENECA,2463,2226,237
Santa Luzia Do Norte,270790,AL,Nordeste,BUTANTAN/SINOVAC,1289,709,580
Santa Luzia Do Pará,150655,PA,Norte,FIOCRUZ/ASTRAZENECA,3756,3428,328
Santa Luzia Do Pará,150655,PA,Norte,BUTANTAN/SINOVAC,2464,1266,1198
Santa Luzia Do Paruá,211003,MA,Nordeste,FIOCRUZ/ASTRAZENECA,4184,3928,256
Santa Luzia Do Paruá,211003,MA,Nordeste,BUTANTAN/SINOVAC,2894,1476,1418
Santa Margarida,315790,MG,Sudeste,BUTANTAN/SINOVAC,2545,1328,1217
Santa Margarida,315790,MG,Sudeste,FIOCRUZ/ASTRAZENECA,1200,1198,2
Santa Margarida Do Sul,431697,RS,Sul,FIOCRUZ/ASTRAZENECA,765,703,62
Santa Margarida Do Sul,431697,RS,Sul,BUTANTAN/SINOVAC,698,355,343
Santa Margarida Do Sul,431697,RS,Sul,PFIZER/BIONTECH,113,113,0
Santa Maria,240933,RN,Nordeste,BUTANTAN/SINOVAC,926,488,438
Santa Maria,240933,RN,Nordeste,FIOCRUZ/ASTRAZENECA,650,596,54
Santa Maria,240933,RN,Nordeste,PFIZER/BIONTECH,70,70,0
Santa Maria,431690,RS,Sul,BUTANTAN/SINOVAC,58831,32314,26517
Santa Maria,431690,RS,Sul,FIOCRUZ/ASTRAZENECA,54883,53373,1510
Santa Maria,431690,RS,Sul,PFIZER/BIONTECH,2090,2087,3
Santa Maria Da Boa Vista,261260,PE,Nordeste,FIOCRUZ/ASTRAZENECA,8927,8444,483
Santa Maria Da Boa Vista,261260,PE,Nordeste,BUTANTAN/SINOVAC,5354,2759,2595
Santa Maria Da Boa Vista,261260,PE,Nordeste,PFIZER/BIONTECH,831,831,0
Santa Maria Da Serra,354700,SP,Sudeste,BUTANTAN/SINOVAC,1359,661,698
Santa Maria Da Serra,354700,SP,Sudeste,FIOCRUZ/ASTRAZENECA,1281,1105,176
Santa Maria Da Serra,354700,SP,Sudeste,PFIZER/BIONTECH,185,185,0
Santa Maria Da Vitória,292810,BA,Nordeste,BUTANTAN/SINOVAC,4581,3506,1075
Santa Maria Da Vitória,292810,BA,Nordeste,FIOCRUZ/ASTRAZENECA,3013,2801,212
Santa Maria Da Vitória,292810,BA,Nordeste,PFIZER/BIONTECH,83,83,0
Santa Maria Das Barreiras,150658,PA,Norte,FIOCRUZ/ASTRAZENECA,2427,1926,501
Santa Maria Das Barreiras,150658,PA,Norte,BUTANTAN/SINOVAC,2324,1275,1049
Santa Maria De Itabira,315800,MG,Sudeste,FIOCRUZ/ASTRAZENECA,2873,2745,128
Santa Maria De Itabira,315800,MG,Sudeste,BUTANTAN/SINOVAC,2289,1286,1003
Santa Maria De Itabira,315800,MG,Sudeste,PFIZER/BIONTECH,50,50,0
Santa Maria De Jetibá,320455,ES,Sudeste,BUTANTAN/SINOVAC,8278,4244,4034
Santa Maria De Jetibá,320455,ES,Sudeste,FIOCRUZ/ASTRAZENECA,7449,7166,283
Santa Maria De Jetibá,320455,ES,Sudeste,PFIZER/BIONTECH,1365,1363,2
Santa Maria Do Cambucá,261270,PE,Nordeste,BUTANTAN/SINOVAC,2633,1345,1288
Santa Maria Do Cambucá,261270,PE,Nordeste,FIOCRUZ/ASTRAZENECA,1600,1326,274
Santa Maria Do Cambucá,261270,PE,Nordeste,PFIZER/BIONTECH,138,135,3
Santa Maria Do Herval,431695,RS,Sul,BUTANTAN/SINOVAC,2007,1029,978
Santa Maria Do Herval,431695,RS,Sul,FIOCRUZ/ASTRAZENECA,1519,1438,81
Santa Maria Do Herval,431695,RS,Sul,PFIZER/BIONTECH,247,247,0
Santa Maria Do Oeste,412385,PR,Sul,FIOCRUZ/ASTRAZENECA,2570,2468,102
Santa Maria Do Oeste,412385,PR,Sul,BUTANTAN/SINOVAC,1984,1049,935
Santa Maria Do Pará,150660,PA,Norte,FIOCRUZ/ASTRAZENECA,4226,3839,387
Santa Maria Do Pará,150660,PA,Norte,BUTANTAN/SINOVAC,3577,2104,1473
Santa Maria Do Salto,315810,MG,Sudeste,BUTANTAN/SINOVAC,1335,764,571
Santa Maria Do Salto,315810,MG,Sudeste,FIOCRUZ/ASTRAZENECA,666,620,46
Santa Maria Do Salto,315810,MG,Sudeste,PFIZER/BIONTECH,43,43,0
Santa Maria Do Suaçuí,315820,MG,Sudeste,BUTANTAN/SINOVAC,3197,1616,1581
Santa Maria Do Suaçuí,315820,MG,Sudeste,FIOCRUZ/ASTRAZENECA,2471,2197,274
Santa Maria Do Tocantins,171888,TO,Norte,BUTANTAN/SINOVAC,654,329,325
Santa Maria Do Tocantins,171888,TO,Norte,FIOCRUZ/ASTRAZENECA,430,410,20
Santa Maria Madalena,330460,RJ,Sudeste,BUTANTAN/SINOVAC,2603,1338,1265
Santa Maria Madalena,330460,RJ,Sudeste,FIOCRUZ/ASTRAZENECA,2291,2113,178
Santa Mariana,412390,PR,Sul,FIOCRUZ/ASTRAZENECA,3508,3277,231
Santa Mariana,412390,PR,Sul,BUTANTAN/SINOVAC,3474,1804,1670
Santa Mercedes,354710,SP,Sudeste,FIOCRUZ/ASTRAZENECA,930,841,89
Santa Mercedes,354710,SP,Sudeste,BUTANTAN/SINOVAC,774,375,399
Santa Mercedes,354710,SP,Sudeste,PFIZER/BIONTECH,59,59,0
Santa Mônica,412395,PR,Sul,FIOCRUZ/ASTRAZENECA,691,647,44
Santa Mônica,412395,PR,Sul,BUTANTAN/SINOVAC,549,299,250
Santa Quitéria,231220,CE,Nordeste,BUTANTAN/SINOVAC,8328,4461,3867
Santa Quitéria,231220,CE,Nordeste,FIOCRUZ/ASTRAZENECA,4135,3602,533
Santa Quitéria,231220,CE,Nordeste,PFIZER/BIONTECH,100,100,0
Santa Quitéria Do Maranhão,211010,MA,Nordeste,FIOCRUZ/ASTRAZENECA,5586,5396,190
Santa Quitéria Do Maranhão,211010,MA,Nordeste,BUTANTAN/SINOVAC,3039,1581,1458
Santa Rita,211020,MA,Nordeste,FIOCRUZ/ASTRAZENECA,15153,11740,3413
Santa Rita,211020,MA,Nordeste,BUTANTAN/SINOVAC,4837,2605,2232
Santa Rita,251370,PB,Nordeste,BUTANTAN/SINOVAC,23333,12909,10424
Santa Rita,251370,PB,Nordeste,FIOCRUZ/ASTRAZENECA,17385,16005,1380
Santa Rita,251370,PB,Nordeste,PFIZER/BIONTECH,993,993,0
Santa Rita D'Oeste,354740,SP,Sudeste,BUTANTAN/SINOVAC,882,453,429
Santa Rita D'Oeste,354740,SP,Sudeste,FIOCRUZ/ASTRAZENECA,733,664,69
Santa Rita D'Oeste,354740,SP,Sudeste,PFIZER/BIONTECH,30,30,0
Santa Rita De Caldas,315920,MG,Sudeste,BUTANTAN/SINOVAC,2152,1127,1025
Santa Rita De Caldas,315920,MG,Sudeste,FIOCRUZ/ASTRAZENECA,2101,1994,107
Santa Rita De Caldas,315920,MG,Sudeste,PFIZER/BIONTECH,94,94,0
Santa Rita De Cássia,292840,BA,Nordeste,BUTANTAN/SINOVAC,6224,3361,2863
Santa Rita De Cássia,292840,BA,Nordeste,FIOCRUZ/ASTRAZENECA,4151,3865,286
Santa Rita De Cássia,292840,BA,Nordeste,PFIZER/BIONTECH,31,31,0
Santa Rita De Ibitipoca,315940,MG,Sudeste,FIOCRUZ/ASTRAZENECA,1273,903,370
Santa Rita De Ibitipoca,315940,MG,Sudeste,BUTANTAN/SINOVAC,840,432,408
Santa Rita De Ibitipoca,315940,MG,Sudeste,PFIZER/BIONTECH,41,41,0
Santa Rita De Jacutinga,315930,MG,Sudeste,FIOCRUZ/ASTRAZENECA,1561,1442,119
Santa Rita De Jacutinga,315930,MG,Sudeste,BUTANTAN/SINOVAC,1419,723,696
Santa Rita De Jacutinga,315930,MG,Sudeste,PFIZER/BIONTECH,76,76,0
Santa Rita De Minas,315935,MG,Sudeste,BUTANTAN/SINOVAC,1030,624,406
Santa Rita De Minas,315935,MG,Sudeste,FIOCRUZ/ASTRAZENECA,577,524,53
Santa Rita De Minas,315935,MG,Sudeste,PFIZER/BIONTECH,17,17,0
Santa Rita Do Araguaia,521940,GO,Centro-Oeste,BUTANTAN/SINOVAC,1207,674,533
Santa Rita Do Araguaia,521940,GO,Centro-Oeste,FIOCRUZ/ASTRAZENECA,812,729,83
Santa Rita Do Itueto,315950,MG,Sudeste,BUTANTAN/SINOVAC,1149,583,566
Santa Rita Do Itueto,315950,MG,Sudeste,FIOCRUZ/ASTRAZENECA,923,852,71
Santa Rita Do Itueto,315950,MG,Sudeste,PFIZER/BIONTECH,33,33,0
Santa Rita Do Novo Destino,521945,GO,Centro-Oeste,FIOCRUZ/ASTRAZENECA,1304,1270,34
Santa Rita Do Novo Destino,521945,GO,Centro-Oeste,BUTANTAN/SINOVAC,537,276,261
Santa Rita Do Novo Destino,521945,GO,Centro-Oeste,PFIZER/BIONTECH,10,10,0
Santa Rita Do Pardo,500755,MS,Centro-Oeste,BUTANTAN/SINOVAC,1765,967,798
Santa Rita Do Pardo,500755,MS,Centro-Oeste,FIOCRUZ/ASTRAZENECA,1744,1634,110
Santa Rita Do Pardo,500755,MS,Centro-Oeste,PFIZER/BIONTECH,187,187,0
Santa Rita Do Passa Quatro,354750,SP,Sudeste,BUTANTAN/SINOVAC,8271,4260,4011
Santa Rita Do Passa Quatro,354750,SP,Sudeste,FIOCRUZ/ASTRAZENECA,7351,6706,645
Santa Rita Do Passa Quatro,354750,SP,Sudeste,PFIZER/BIONTECH,396,396,0
Santa Rita Do Sapucaí,315960,MG,Sudeste,BUTANTAN/SINOVAC,7407,3820,3587
Santa Rita Do Sapucaí,315960,MG,Sudeste,FIOCRUZ/ASTRAZENECA,5365,5220,145
Santa Rita Do Sapucaí,315960,MG,Sudeste,PFIZER/BIONTECH,880,880,0
Santa Rita Do Tocantins,171889,TO,Norte,BUTANTAN/SINOVAC,462,273,189
Santa Rita Do Tocantins,171889,TO,Norte,FIOCRUZ/ASTRAZENECA,338,319,19
Santa Rita Do Trivelato,510776,MT,Centro-Oeste,FIOCRUZ/ASTRAZENECA,851,803,48
Santa Rita Do Trivelato,510776,MT,Centro-Oeste,BUTANTAN/SINOVAC,383,196,187
Santa Rita Do Trivelato,510776,MT,Centro-Oeste,PFIZER/BIONTECH,19,19,0
Santa Rosa,431720,RS,Sul,BUTANTAN/SINOVAC,18396,9463,8933
Santa Rosa,431720,RS,Sul,FIOCRUZ/ASTRAZENECA,18096,16718,1378
Santa Rosa,431720,RS,Sul,PFIZER/BIONTECH,2444,2443,1
Santa Rosa Da Serra,315970,MG,Sudeste,BUTANTAN/SINOVAC,748,375,373
Santa Rosa Da Serra,315970,MG,Sudeste,FIOCRUZ/ASTRAZENECA,737,675,62
Santa Rosa Da Serra,315970,MG,Sudeste,PFIZER/BIONTECH,70,70,0
Santa Rosa De Goiás,521950,GO,Centro-Oeste,FIOCRUZ/ASTRAZENECA,785,725,60
Santa Rosa De Goiás,521950,GO,Centro-Oeste,BUTANTAN/SINOVAC,692,354,338
Santa Rosa De Lima,280650,SE,Nordeste,FIOCRUZ/ASTRAZENECA,417,416,1
Santa Rosa De Lima,280650,SE,Nordeste,BUTANTAN/SINOVAC,400,200,200
Santa Rosa De Lima,280650,SE,Nordeste,PFIZER/BIONTECH,32,32,0
Santa Rosa De Lima,421560,SC,Sul,FIOCRUZ/ASTRAZENECA,712,688,24
Santa Rosa De Lima,421560,SC,Sul,BUTANTAN/SINOVAC,550,321,229
Santa Rosa De Lima,421560,SC,Sul,PFIZER/BIONTECH,30,30,0
Santa Rosa De Viterbo,354760,SP,Sudeste,FIOCRUZ/ASTRAZENECA,5571,5120,451
Santa Rosa De Viterbo,354760,SP,Sudeste,BUTANTAN/SINOVAC,5556,2955,2601
Santa Rosa De Viterbo,354760,SP,Sudeste,PFIZER/BIONTECH,238,238,0
Santa Rosa Do Piauí,220937,PI,Nordeste,FIOCRUZ/ASTRAZENECA,1203,1135,68
Santa Rosa Do Piauí,220937,PI,Nordeste,BUTANTAN/SINOVAC,976,505,471
Santa Rosa Do Purus,120043,AC,Norte,BUTANTAN/SINOVAC,2822,1621,1201
Santa Rosa Do Purus,120043,AC,Norte,FIOCRUZ/ASTRAZENECA,706,651,55
Santa Rosa Do Sul,421565,SC,Sul,FIOCRUZ/ASTRAZENECA,2514,2312,202
Santa Rosa Do Sul,421565,SC,Sul,BUTANTAN/SINOVAC,1995,1076,919
Santa Rosa Do Sul,421565,SC,Sul,PFIZER/BIONTECH,227,227,0
Santa Rosa Do Tocantins,171890,TO,Norte,FIOCRUZ/ASTRAZENECA,966,937,29
Santa Rosa Do Tocantins,171890,TO,Norte,BUTANTAN/SINOVAC,889,479,410
Santa Salete,354765,SP,Sudeste,BUTANTAN/SINOVAC,886,473,413
Santa Salete,354765,SP,Sudeste,FIOCRUZ/ASTRAZENECA,666,566,100
Santa Salete,354765,SP,Sudeste,PFIZER/BIONTECH,64,62,2
Santa Teresa,320460,ES,Sudeste,BUTANTAN/SINOVAC,7988,4203,3785
Santa Teresa,320460,ES,Sudeste,FIOCRUZ/ASTRAZENECA,5374,5072,302
Santa Teresa,320460,ES,Sudeste,PFIZER/BIONTECH,1245,1245,0
Santa Teresinha,251380,PB,Nordeste,BUTANTAN/SINOVAC,1327,672,655
Santa Teresinha,251380,PB,Nordeste,FIOCRUZ/ASTRAZENECA,846,756,90
Santa Teresinha,251380,PB,Nordeste,PFIZER/BIONTECH,70,70,0
Santa Tereza,431725,RS,Sul,BUTANTAN/SINOVAC,706,363,343
Santa Tereza,431725,RS,Sul,FIOCRUZ/ASTRAZENECA,567,461,106
Santa Tereza,431725,RS,Sul,PFIZER/BIONTECH,70,70,0
Santa Tereza De Goiás,521960,GO,Centro-Oeste,FIOCRUZ/ASTRAZENECA,1266,1187,79
Santa Tereza De Goiás,521960,GO,Centro-Oeste,BUTANTAN/SINOVAC,700,356,344
Santa Tereza Do Oeste,412402,PR,Sul,FIOCRUZ/ASTRAZENECA,2223,2123,100
Santa Tereza Do Oeste,412402,PR,Sul,BUTANTAN/SINOVAC,1625,849,776
Santa Tereza Do Tocantins,171900,TO,Norte,FIOCRUZ/ASTRAZENECA,1014,853,161
Santa Tereza Do Tocantins,171900,TO,Norte,BUTANTAN/SINOVAC,534,297,237
Santa Terezinha,261280,PE,Nordeste,BUTANTAN/SINOVAC,2254,1147,1107
Santa Terezinha,261280,PE,Nordeste,FIOCRUZ/ASTRAZENECA,2250,2045,205
Santa Terezinha,261280,PE,Nordeste,PFIZER/BIONTECH,96,96,0
Santa Terezinha,292850,BA,Nordeste,FIOCRUZ/ASTRAZENECA,2417,2249,168
Santa Terezinha,292850,BA,Nordeste,BUTANTAN/SINOVAC,2204,1141,1063
Santa Terezinha,292850,BA,Nordeste,PFIZER/BIONTECH,320,320,0
Santa Terezinha,421567,SC,Sul,FIOCRUZ/ASTRAZENECA,1568,1471,97
Santa Terezinha,421567,SC,Sul,BUTANTAN/SINOVAC,1371,693,678
Santa Terezinha,421567,SC,Sul,PFIZER/BIONTECH,164,164,0
Santa Terezinha,510777,MT,Centro-Oeste,BUTANTAN/SINOVAC,1666,917,749
Santa Terezinha,510777,MT,Centro-Oeste,FIOCRUZ/ASTRAZENECA,1113,1029,84
Santa Terezinha,510777,MT,Centro-Oeste,PFIZER/BIONTECH,22,22,0
Santa Terezinha De Goiás,521970,GO,Centro-Oeste,FIOCRUZ/ASTRAZENECA,2797,2725,72
Santa Terezinha De Goiás,521970,GO,Centro-Oeste,BUTANTAN/SINOVAC,1789,957,832
Santa Terezinha De Goiás,521970,GO,Centro-Oeste,PFIZER/BIONTECH,10,10,0
Santa Terezinha De Itaipu,412405,PR,Sul,FIOCRUZ/ASTRAZENECA,5206,4978,228
Santa Terezinha De Itaipu,412405,PR,Sul,BUTANTAN/SINOVAC,4466,2354,2112
Santa Terezinha De Itaipu,412405,PR,Sul,PFIZER/BIONTECH,242,242,0
Santa Terezinha Do Progresso,421568,SC,Sul,BUTANTAN/SINOVAC,1311,730,581
Santa Terezinha Do Progresso,421568,SC,Sul,FIOCRUZ/ASTRAZENECA,1011,914,97
Santa Terezinha Do Progresso,421568,SC,Sul,PFIZER/BIONTECH,6,6,0
Santa Terezinha Do Tocantins,172000,TO,Norte,FIOCRUZ/ASTRAZENECA,531,503,28
Santa Terezinha Do Tocantins,172000,TO,Norte,BUTANTAN/SINOVAC,460,236,224
Santa Vitória,315980,MG,Sudeste,BUTANTAN/SINOVAC,4087,2141,1946
Santa Vitória,315980,MG,Sudeste,FIOCRUZ/ASTRAZENECA,3852,3254,598
Santa Vitória,315980,MG,Sudeste,PFIZER/BIONTECH,70,70,0
Santa Vitória Do Palmar,431730,RS,Sul,FIOCRUZ/ASTRAZENECA,8129,7373,756
Santa Vitória Do Palmar,431730,RS,Sul,BUTANTAN/SINOVAC,7629,4113,3516
Santa Vitória Do Palmar,431730,RS,Sul,PFIZER/BIONTECH,471,471,0
Santaluz,292800,BA,Nordeste,FIOCRUZ/ASTRAZENECA,7521,6797,724
Santaluz,292800,BA,Nordeste,BUTANTAN/SINOVAC,6316,3335,2981
Santaluz,292800,BA,Nordeste,PFIZER/BIONTECH,674,673,1
Santana,160060,AP,Norte,FIOCRUZ/ASTRAZENECA,24829,22219,2610
Santana,160060,AP,Norte,BUTANTAN/SINOVAC,19074,10031,9043
Santana,160060,AP,Norte,PFIZER/BIONTECH,2866,2863,3
Santana,292820,BA,Nordeste,BUTANTAN/SINOVAC,3138,2564,574
Santana,292820,BA,Nordeste,FIOCRUZ/ASTRAZENECA,605,605,0
Santana Da Boa Vista,431700,RS,Sul,BUTANTAN/SINOVAC,3693,1894,1799
Santana Da Boa Vista,431700,RS,Sul,FIOCRUZ/ASTRAZENECA,1829,1638,191
Santana Da Boa Vista,431700,RS,Sul,PFIZER/BIONTECH,95,95,0
Santana Da Ponte Pensa,354720,SP,Sudeste,BUTANTAN/SINOVAC,601,311,290
Santana Da Ponte Pensa,354720,SP,Sudeste,FIOCRUZ/ASTRAZENECA,491,428,63
Santana Da Ponte Pensa,354720,SP,Sudeste,PFIZER/BIONTECH,43,43,0
Santana Da Vargem,315830,MG,Sudeste,FIOCRUZ/ASTRAZENECA,1826,1687,139
Santana Da Vargem,315830,MG,Sudeste,BUTANTAN/SINOVAC,1388,723,665
Santana Da Vargem,315830,MG,Sudeste,PFIZER/BIONTECH,96,96,0
Santana De Cataguases,315840,MG,Sudeste,BUTANTAN/SINOVAC,965,516,449
Santana De Cataguases,315840,MG,Sudeste,FIOCRUZ/ASTRAZENECA,775,693,82
Santana De Cataguases,315840,MG,Sudeste,PFIZER/BIONTECH,16,16,0
Santana De Mangueira,251350,PB,Nordeste,BUTANTAN/SINOVAC,1237,646,591
Santana De Mangueira,251350,PB,Nordeste,FIOCRUZ/ASTRAZENECA,762,697,65
Santana De Mangueira,251350,PB,Nordeste,PFIZER/BIONTECH,42,42,0
Santana De Parnaíba,354730,SP,Sudeste,BUTANTAN/SINOVAC,22070,12037,10033
Santana De Parnaíba,354730,SP,Sudeste,FIOCRUZ/ASTRAZENECA,21950,19897,2053
Santana De Parnaíba,354730,SP,Sudeste,PFIZER/BIONTECH,695,690,5
Santana De Pirapama,315850,MG,Sudeste,FIOCRUZ/ASTRAZENECA,2554,2386,168
Santana De Pirapama,315850,MG,Sudeste,BUTANTAN/SINOVAC,2098,1060,1038
Santana De Pirapama,315850,MG,Sudeste,PFIZER/BIONTECH,47,47,0
Santana Do Acaraú,231200,CE,Nordeste,BUTANTAN/SINOVAC,3970,2043,1927
Santana Do Acaraú,231200,CE,Nordeste,FIOCRUZ/ASTRAZENECA,1905,1531,374
Santana Do Araguaia,150670,PA,Norte,FIOCRUZ/ASTRAZENECA,2548,2423,125
Santana Do Araguaia,150670,PA,Norte,BUTANTAN/SINOVAC,2413,1418,995
Santana Do Cariri,231210,CE,Nordeste,BUTANTAN/SINOVAC,3100,1610,1490
Santana Do Cariri,231210,CE,Nordeste,FIOCRUZ/ASTRAZENECA,1685,1365,320
Santana Do Deserto,315860,MG,Sudeste,BUTANTAN/SINOVAC,935,486,449
Santana Do Deserto,315860,MG,Sudeste,FIOCRUZ/ASTRAZENECA,651,594,57
Santana Do Deserto,315860,MG,Sudeste,PFIZER/BIONTECH,38,38,0
Santana Do Garambéu,315870,MG,Sudeste,BUTANTAN/SINOVAC,704,356,348
Santana Do Garambéu,315870,MG,Sudeste,FIOCRUZ/ASTRAZENECA,665,458,207
Santana Do Garambéu,315870,MG,Sudeste,PFIZER/BIONTECH,43,43,0
Santana Do Ipanema,270800,AL,Nordeste,BUTANTAN/SINOVAC,7762,4022,3740
Santana Do Ipanema,270800,AL,Nordeste,FIOCRUZ/ASTRAZENECA,6879,6207,672
Santana Do Ipanema,270800,AL,Nordeste,PFIZER/BIONTECH,1324,1323,1
Santana Do Itararé,412400,PR,Sul,FIOCRUZ/ASTRAZENECA,1543,1461,82
Santana Do Itararé,412400,PR,Sul,BUTANTAN/SINOVAC,1199,623,576
Santana Do Jacaré,315880,MG,Sudeste,BUTANTAN/SINOVAC,948,548,400
Santana Do Jacaré,315880,MG,Sudeste,FIOCRUZ/ASTRAZENECA,374,372,2
Santana Do Manhuaçu,315890,MG,Sudeste,BUTANTAN/SINOVAC,1227,657,570
Santana Do Manhuaçu,315890,MG,Sudeste,FIOCRUZ/ASTRAZENECA,662,658,4
Santana Do Manhuaçu,315890,MG,Sudeste,PFIZER/BIONTECH,30,30,0
Santana Do Maranhão,211023,MA,Nordeste,FIOCRUZ/ASTRAZENECA,1909,1649,260
Santana Do Maranhão,211023,MA,Nordeste,BUTANTAN/SINOVAC,1787,948,839
Santana Do Matos,241140,RN,Nordeste,BUTANTAN/SINOVAC,3071,1613,1458
Santana Do Matos,241140,RN,Nordeste,FIOCRUZ/ASTRAZENECA,2855,2618,237
Santana Do Matos,241140,RN,Nordeste,PFIZER/BIONTECH,78,78,0
Santana Do Mundaú,270810,AL,Nordeste,FIOCRUZ/ASTRAZENECA,2681,2469,212
Santana Do Mundaú,270810,AL,Nordeste,BUTANTAN/SINOVAC,1598,805,793
Santana Do Mundaú,270810,AL,Nordeste,PFIZER/BIONTECH,150,150,0
Santana Do Paraíso,315895,MG,Sudeste,FIOCRUZ/ASTRAZENECA,5056,4887,169
Santana Do Paraíso,315895,MG,Sudeste,BUTANTAN/SINOVAC,4421,2234,2187
Santana Do Paraíso,315895,MG,Sudeste,PFIZER/BIONTECH,626,626,0
Santana Do Piauí,220935,PI,Nordeste,BUTANTAN/SINOVAC,825,448,377
Santana Do Piauí,220935,PI,Nordeste,FIOCRUZ/ASTRAZENECA,249,169,80
Santana Do Riacho,315900,MG,Sudeste,BUTANTAN/SINOVAC,1128,568,560
Santana Do Riacho,315900,MG,Sudeste,FIOCRUZ/ASTRAZENECA,734,649,85
Santana Do Riacho,315900,MG,Sudeste,PFIZER/BIONTECH,22,22,0
Santana Do São Francisco,280640,SE,Nordeste,FIOCRUZ/ASTRAZENECA,1109,1051,58
Santana Do São Francisco,280640,SE,Nordeste,BUTANTAN/SINOVAC,1095,579,516
Santana Do São Francisco,280640,SE,Nordeste,PFIZER/BIONTECH,139,139,0
Santana Do Seridó,241142,RN,Nordeste,BUTANTAN/SINOVAC,619,334,285
Santana Do Seridó,241142,RN,Nordeste,FIOCRUZ/ASTRAZENECA,565,534,31
Santana Do Seridó,241142,RN,Nordeste,PFIZER/BIONTECH,93,92,1
Santana Dos Garrotes,251360,PB,Nordeste,BUTANTAN/SINOVAC,2097,1059,1038
Santana Dos Garrotes,251360,PB,Nordeste,FIOCRUZ/ASTRAZENECA,1209,1179,30
Santana Dos Garrotes,251360,PB,Nordeste,PFIZER/BIONTECH,83,83,0
Santana Dos Montes,315910,MG,Sudeste,BUTANTAN/SINOVAC,671,335,336
Santana Dos Montes,315910,MG,Sudeste,FIOCRUZ/ASTRAZENECA,372,205,167
Santanópolis,292830,BA,Nordeste,BUTANTAN/SINOVAC,2124,1086,1038
Santanópolis,292830,BA,Nordeste,FIOCRUZ/ASTRAZENECA,1774,1676,98
Santanópolis,292830,BA,Nordeste,PFIZER/BIONTECH,181,179,2
Santarém,150680,PA,Norte,FIOCRUZ/ASTRAZENECA,65232,47543,17689
Santarém,150680,PA,Norte,BUTANTAN/SINOVAC,20706,11828,8878
Santarém Novo,150690,PA,Norte,FIOCRUZ/ASTRAZENECA,1047,805,242
Santarém Novo,150690,PA,Norte,BUTANTAN/SINOVAC,767,413,354
Santiago,431740,RS,Sul,BUTANTAN/SINOVAC,14967,7781,7186
Santiago,431740,RS,Sul,FIOCRUZ/ASTRAZENECA,13532,12076,1456
Santiago,431740,RS,Sul,PFIZER/BIONTECH,1453,1452,1
Santiago Do Sul,421569,SC,Sul,BUTANTAN/SINOVAC,873,507,366
Santiago Do Sul,421569,SC,Sul,FIOCRUZ/ASTRAZENECA,654,580,74
Santiago Do Sul,421569,SC,Sul,PFIZER/BIONTECH,58,58,0
Santo Afonso,510726,MT,Centro-Oeste,BUTANTAN/SINOVAC,1116,581,535
Santo Afonso,510726,MT,Centro-Oeste,FIOCRUZ/ASTRAZENECA,656,528,128
Santo Afonso,510726,MT,Centro-Oeste,PFIZER/BIONTECH,22,22,0
Santo Amaro,292860,BA,Nordeste,FIOCRUZ/ASTRAZENECA,8505,8185,320
Santo Amaro,292860,BA,Nordeste,BUTANTAN/SINOVAC,7516,4838,2678
Santo Amaro,292860,BA,Nordeste,PFIZER/BIONTECH,2423,2423,0
Santo Amaro Da Imperatriz,421570,SC,Sul,BUTANTAN/SINOVAC,5976,3091,2885
Santo Amaro Da Imperatriz,421570,SC,Sul,FIOCRUZ/ASTRAZENECA,5621,5461,160
Santo Amaro Da Imperatriz,421570,SC,Sul,PFIZER/BIONTECH,617,617,0
Santo Amaro Das Brotas,280660,SE,Nordeste,BUTANTAN/SINOVAC,237,156,81
Santo Amaro Do Maranhão,211027,MA,Nordeste,FIOCRUZ/ASTRAZENECA,2154,2044,110
Santo Amaro Do Maranhão,211027,MA,Nordeste,BUTANTAN/SINOVAC,1374,716,658
Santo Anastácio,354770,SP,Sudeste,BUTANTAN/SINOVAC,5014,2793,2221
Santo Anastácio,354770,SP,Sudeste,FIOCRUZ/ASTRAZENECA,4453,3939,514
Santo Anastácio,354770,SP,Sudeste,PFIZER/BIONTECH,110,110,0
Santo André,251385,PB,Nordeste,BUTANTAN/SINOVAC,826,417,409
Santo André,251385,PB,Nordeste,FIOCRUZ/ASTRAZENECA,627,562,65
Santo André,251385,PB,Nordeste,PFIZER/BIONTECH,41,41,0
Santo André,354780,SP,Sudeste,BUTANTAN/SINOVAC,163281,91292,71989
Santo André,354780,SP,Sudeste,FIOCRUZ/ASTRAZENECA,87711,74140,13571
Santo André,354780,SP,Sudeste,PFIZER/BIONTECH,14484,14484,0
Santo Ângelo,431750,RS,Sul,BUTANTAN/SINOVAC,20683,10998,9685
Santo Ângelo,431750,RS,Sul,FIOCRUZ/ASTRAZENECA,20378,18696,1682
Santo Ângelo,431750,RS,Sul,PFIZER/BIONTECH,2552,2550,2
Santo Antônio,241150,RN,Nordeste,BUTANTAN/SINOVAC,4156,2144,2012
Santo Antônio,241150,RN,Nordeste,FIOCRUZ/ASTRAZENECA,4100,3830,270
Santo Antônio,241150,RN,Nordeste,PFIZER/BIONTECH,234,234,0
Santo Antônio Da Alegria,354790,SP,Sudeste,FIOCRUZ/ASTRAZENECA,1939,1794,145
Santo Antônio Da Alegria,354790,SP,Sudeste,BUTANTAN/SINOVAC,1772,956,816
Santo Antônio Da Alegria,354790,SP,Sudeste,PFIZER/BIONTECH,114,114,0
Santo Antônio Da Barra,521971,GO,Centro-Oeste,FIOCRUZ/ASTRAZENECA,1097,1026,71
Santo Antônio Da Barra,521971,GO,Centro-Oeste,BUTANTAN/SINOVAC,905,479,426
Santo Antônio Da Patrulha,431760,RS,Sul,BUTANTAN/SINOVAC,13248,7062,6186
Santo Antônio Da Patrulha,431760,RS,Sul,FIOCRUZ/ASTRAZENECA,10750,9835,915
Santo Antônio Da Patrulha,431760,RS,Sul,PFIZER/BIONTECH,1139,1139,0
Santo Antônio Da Platina,412410,PR,Sul,FIOCRUZ/ASTRAZENECA,9444,8607,837
Santo Antônio Da Platina,412410,PR,Sul,BUTANTAN/SINOVAC,8788,4569,4219
Santo Antônio Da Platina,412410,PR,Sul,PFIZER/BIONTECH,3546,3545,1
Santo Antônio Das Missões,431770,RS,Sul,BUTANTAN/SINOVAC,3492,2062,1430
Santo Antônio Das Missões,431770,RS,Sul,FIOCRUZ/ASTRAZENECA,2172,2025,147
Santo Antônio Das Missões,431770,RS,Sul,PFIZER/BIONTECH,140,140,0
Santo Antônio De Goiás,521973,GO,Centro-Oeste,FIOCRUZ/ASTRAZENECA,1442,1393,49
Santo Antônio De Goiás,521973,GO,Centro-Oeste,BUTANTAN/SINOVAC,986,515,471
Santo Antônio De Goiás,521973,GO,Centro-Oeste,PFIZER/BIONTECH,52,52,0
Santo Antônio De Jesus,292870,BA,Nordeste,BUTANTAN/SINOVAC,16670,8991,7679
Santo Antônio De Jesus,292870,BA,Nordeste,FIOCRUZ/ASTRAZENECA,11050,10063,987
Santo Antônio De Jesus,292870,BA,Nordeste,PFIZER/BIONTECH,1345,1345,0
Santo Antônio De Lisboa,220940,PI,Nordeste,FIOCRUZ/ASTRAZENECA,1619,1460,159
Santo Antônio De Lisboa,220940,PI,Nordeste,BUTANTAN/SINOVAC,1381,715,666
Santo Antônio De Pádua,330470,RJ,Sudeste,BUTANTAN/SINOVAC,8357,4915,3442
Santo Antônio De Pádua,330470,RJ,Sudeste,FIOCRUZ/ASTRAZENECA,4060,3731,329
Santo Antônio De Posse,354800,SP,Sudeste,FIOCRUZ/ASTRAZENECA,5413,5094,319
Santo Antônio De Posse,354800,SP,Sudeste,BUTANTAN/SINOVAC,4768,2635,2133
Santo Antônio De Posse,354800,SP,Sudeste,PFIZER/BIONTECH,210,210,0
Santo Antônio Do Amparo,315990,MG,Sudeste,FIOCRUZ/ASTRAZENECA,3584,3311,273
Santo Antônio Do Amparo,315990,MG,Sudeste,BUTANTAN/SINOVAC,3317,1691,1626
Santo Antônio Do Amparo,315990,MG,Sudeste,PFIZER/BIONTECH,265,264,1
Santo Antônio Do Aracanguá,354805,SP,Sudeste,BUTANTAN/SINOVAC,1785,1005,780
Santo Antônio Do Aracanguá,354805,SP,Sudeste,FIOCRUZ/ASTRAZENECA,1686,1548,138
Santo Antônio Do Aracanguá,354805,SP,Sudeste,PFIZER/BIONTECH,227,227,0
Santo Antônio Do Aventureiro,316000,MG,Sudeste,BUTANTAN/SINOVAC,962,499,463
Santo Antônio Do Aventureiro,316000,MG,Sudeste,FIOCRUZ/ASTRAZENECA,922,843,79
Santo Antônio Do Aventureiro,316000,MG,Sudeste,PFIZER/BIONTECH,71,71,0
Santo Antônio Do Caiuá,412420,PR,Sul,FIOCRUZ/ASTRAZENECA,915,838,77
Santo Antônio Do Caiuá,412420,PR,Sul,BUTANTAN/SINOVAC,851,459,392
Santo Antônio Do Caiuá,412420,PR,Sul,PFIZER/BIONTECH,12,12,0
Santo Antônio Do Descoberto,521975,GO,Centro-Oeste,BUTANTAN/SINOVAC,8014,4247,3767
Santo Antônio Do Descoberto,521975,GO,Centro-Oeste,FIOCRUZ/ASTRAZENECA,5877,5172,705
Santo Antônio Do Grama,316010,MG,Sudeste,BUTANTAN/SINOVAC,1183,607,576
Santo Antônio Do Grama,316010,MG,Sudeste,FIOCRUZ/ASTRAZENECA,1149,1035,114
Santo Antônio Do Grama,316010,MG,Sudeste,PFIZER/BIONTECH,112,112,0
Santo Antônio Do Içá,130370,AM,Norte,BUTANTAN/SINOVAC,3744,2814,930
Santo Antônio Do Içá,130370,AM,Norte,FIOCRUZ/ASTRAZENECA,784,745,39
Santo Antônio Do Itambé,316020,MG,Sudeste,FIOCRUZ/ASTRAZENECA,983,920,63
Santo Antônio Do Itambé,316020,MG,Sudeste,BUTANTAN/SINOVAC,716,371,345
Santo Antônio Do Itambé,316020,MG,Sudeste,PFIZER/BIONTECH,14,14,0
Santo Antônio Do Jacinto,316030,MG,Sudeste,BUTANTAN/SINOVAC,2755,1427,1328
Santo Antônio Do Jacinto,316030,MG,Sudeste,FIOCRUZ/ASTRAZENECA,1801,1552,249
Santo Antônio Do Jacinto,316030,MG,Sudeste,PFIZER/BIONTECH,58,58,0
Santo Antônio Do Jardim,354810,SP,Sudeste,BUTANTAN/SINOVAC,1668,899,769
Santo Antônio Do Jardim,354810,SP,Sudeste,FIOCRUZ/ASTRAZENECA,1505,1358,147
Santo Antônio Do Jardim,354810,SP,Sudeste,PFIZER/BIONTECH,177,177,0
Santo Antônio Do Leste,510779,MT,Centro-Oeste,BUTANTAN/SINOVAC,743,424,319
Santo Antônio Do Leste,510779,MT,Centro-Oeste,FIOCRUZ/ASTRAZENECA,480,463,17
Santo Antônio Do Leverger,510780,MT,Centro-Oeste,FIOCRUZ/ASTRAZENECA,4834,4227,607
Santo Antônio Do Leverger,510780,MT,Centro-Oeste,BUTANTAN/SINOVAC,2622,1363,1259
Santo Antônio Do Leverger,510780,MT,Centro-Oeste,PFIZER/BIONTECH,23,23,0
Santo Antônio Do Monte,316040,MG,Sudeste,BUTANTAN/SINOVAC,5376,2740,2636
Santo Antônio Do Monte,316040,MG,Sudeste,FIOCRUZ/ASTRAZENECA,5115,4596,519
Santo Antônio Do Monte,316040,MG,Sudeste,PFIZER/BIONTECH,4,4,0
Santo Antônio Do Palma,431755,RS,Sul,FIOCRUZ/ASTRAZENECA,653,570,83
Santo Antônio Do Palma,431755,RS,Sul,BUTANTAN/SINOVAC,627,323,304
Santo Antônio Do Palma,431755,RS,Sul,PFIZER/BIONTECH,104,103,1
Santo Antônio Do Paraíso,412430,PR,Sul,FIOCRUZ/ASTRAZENECA,855,804,51
Santo Antônio Do Paraíso,412430,PR,Sul,BUTANTAN/SINOVAC,611,321,290
Santo Antônio Do Paraíso,412430,PR,Sul,PFIZER/BIONTECH,12,12,0
Santo Antônio Do Pinhal,354820,SP,Sudeste,BUTANTAN/SINOVAC,1703,899,804
Santo Antônio Do Pinhal,354820,SP,Sudeste,FIOCRUZ/ASTRAZENECA,1462,1369,93
Santo Antônio Do Pinhal,354820,SP,Sudeste,PFIZER/BIONTECH,78,78,0
Santo Antônio Do Planalto,431775,RS,Sul,BUTANTAN/SINOVAC,711,366,345
Santo Antônio Do Planalto,431775,RS,Sul,FIOCRUZ/ASTRAZENECA,569,515,54
Santo Antônio Do Planalto,431775,RS,Sul,PFIZER/BIONTECH,60,60,0
Santo Antônio Do Retiro,316045,MG,Sudeste,BUTANTAN/SINOVAC,1665,926,739
Santo Antônio Do Retiro,316045,MG,Sudeste,FIOCRUZ/ASTRAZENECA,826,756,70
Santo Antônio Do Retiro,316045,MG,Sudeste,PFIZER/BIONTECH,28,28,0
Santo Antônio Do Rio Abaixo,316050,MG,Sudeste,FIOCRUZ/ASTRAZENECA,485,450,35
Santo Antônio Do Rio Abaixo,316050,MG,Sudeste,BUTANTAN/SINOVAC,478,240,238
Santo Antônio Do Rio Abaixo,316050,MG,Sudeste,PFIZER/BIONTECH,43,43,0
Santo Antônio Do Sudoeste,412440,PR,Sul,FIOCRUZ/ASTRAZENECA,4680,4451,229
Santo Antônio Do Sudoeste,412440,PR,Sul,BUTANTAN/SINOVAC,3801,1919,1882
Santo Antônio Do Tauá,150700,PA,Norte,FIOCRUZ/ASTRAZENECA,8292,7365,927
Santo Antônio Do Tauá,150700,PA,Norte,BUTANTAN/SINOVAC,3427,1960,1467
Santo Antônio Dos Lopes,211030,MA,Nordeste,FIOCRUZ/ASTRAZENECA,3326,3118,208
Santo Antônio Dos Lopes,211030,MA,Nordeste,BUTANTAN/SINOVAC,2485,1353,1132
Santo Antônio Dos Milagres,220945,PI,Nordeste,FIOCRUZ/ASTRAZENECA,640,611,29
Santo Antônio Dos Milagres,220945,PI,Nordeste,BUTANTAN/SINOVAC,560,294,266
Santo Antônio Dos Milagres,220945,PI,Nordeste,PFIZER/BIONTECH,62,62,0
Santo Augusto,431780,RS,Sul,BUTANTAN/SINOVAC,4290,2211,2079
Santo Augusto,431780,RS,Sul,FIOCRUZ/ASTRAZENECA,3640,3280,360
Santo Augusto,431780,RS,Sul,PFIZER/BIONTECH,407,405,2
Santo Cristo,431790,RS,Sul,BUTANTAN/SINOVAC,4471,2248,2223
Santo Cristo,431790,RS,Sul,FIOCRUZ/ASTRAZENECA,3908,3462,446
Santo Cristo,431790,RS,Sul,PFIZER/BIONTECH,359,359,0
Santo Estêvão,292880,BA,Nordeste,FIOCRUZ/ASTRAZENECA,9692,8622,1070
Santo Estêvão,292880,BA,Nordeste,BUTANTAN/SINOVAC,8492,4392,4100
Santo Estêvão,292880,BA,Nordeste,PFIZER/BIONTECH,454,454,0
Santo Expedito,354830,SP,Sudeste,BUTANTAN/SINOVAC,954,480,474
Santo Expedito,354830,SP,Sudeste,FIOCRUZ/ASTRAZENECA,663,598,65
Santo Expedito,354830,SP,Sudeste,PFIZER/BIONTECH,111,111,0
Santo Expedito Do Sul,431795,RS,Sul,BUTANTAN/SINOVAC,888,457,431
Santo Expedito Do Sul,431795,RS,Sul,FIOCRUZ/ASTRAZENECA,848,740,108
Santo Expedito Do Sul,431795,RS,Sul,PFIZER/BIONTECH,72,72,0
Santo Hipólito,316060,MG,Sudeste,BUTANTAN/SINOVAC,796,406,390
Santo Hipólito,316060,MG,Sudeste,FIOCRUZ/ASTRAZENECA,575,546,29
Santo Hipólito,316060,MG,Sudeste,PFIZER/BIONTECH,18,18,0
Santo Inácio,412450,PR,Sul,FIOCRUZ/ASTRAZENECA,1619,1515,104
Santo Inácio,412450,PR,Sul,BUTANTAN/SINOVAC,1264,658,606
Santo Inácio Do Piauí,220950,PI,Nordeste,FIOCRUZ/ASTRAZENECA,1035,966,69
Santo Inácio Do Piauí,220950,PI,Nordeste,BUTANTAN/SINOVAC,760,382,378
Santópolis Do Aguapeí,354840,SP,Sudeste,FIOCRUZ/ASTRAZENECA,1279,1149,130
Santópolis Do Aguapeí,354840,SP,Sudeste,BUTANTAN/SINOVAC,1274,661,613
Santópolis Do Aguapeí,354840,SP,Sudeste,PFIZER/BIONTECH,121,121,0
Santos,354850,SP,Sudeste,BUTANTAN/SINOVAC,135103,71167,63936
Santos,354850,SP,Sudeste,FIOCRUZ/ASTRAZENECA,117484,104945,12539
Santos,354850,SP,Sudeste,PFIZER/BIONTECH,1544,1544,0
Santos Dumont,316070,MG,Sudeste,BUTANTAN/SINOVAC,8935,4766,4169
Santos Dumont,316070,MG,Sudeste,FIOCRUZ/ASTRAZENECA,4234,3880,354
São Benedito,231230,CE,Nordeste,BUTANTAN/SINOVAC,6834,3500,3334
São Benedito,231230,CE,Nordeste,FIOCRUZ/ASTRAZENECA,4057,3340,717
São Benedito Do Rio Preto,211040,MA,Nordeste,FIOCRUZ/ASTRAZENECA,2626,2400,226
São Benedito Do Rio Preto,211040,MA,Nordeste,BUTANTAN/SINOVAC,2487,1466,1021
São Benedito Do Sul,261290,PE,Nordeste,BUTANTAN/SINOVAC,1758,901,857
São Benedito Do Sul,261290,PE,Nordeste,FIOCRUZ/ASTRAZENECA,1546,1405,141
São Benedito Do Sul,261290,PE,Nordeste,PFIZER/BIONTECH,63,63,0
São Bentinho,251392,PB,Nordeste,BUTANTAN/SINOVAC,1423,745,678
São Bentinho,251392,PB,Nordeste,FIOCRUZ/ASTRAZENECA,440,349,91
São Bento,211050,MA,Nordeste,FIOCRUZ/ASTRAZENECA,8910,8059,851
São Bento,211050,MA,Nordeste,BUTANTAN/SINOVAC,5298,2914,2384
São Bento,251390,PB,Nordeste,BUTANTAN/SINOVAC,5647,3094,2553
São Bento,251390,PB,Nordeste,FIOCRUZ/ASTRAZENECA,4552,4176,376
São Bento,251390,PB,Nordeste,PFIZER/BIONTECH,59,59,0
São Bento Abade,316080,MG,Sudeste,BUTANTAN/SINOVAC,770,411,359
São Bento Abade,316080,MG,Sudeste,FIOCRUZ/ASTRAZENECA,247,218,29
São Bento Do Norte,241160,RN,Nordeste,BUTANTAN/SINOVAC,1061,577,484
São Bento Do Norte,241160,RN,Nordeste,FIOCRUZ/ASTRAZENECA,748,684,64
São Bento Do Norte,241160,RN,Nordeste,PFIZER/BIONTECH,81,81,0
São Bento Do Sapucaí,354860,SP,Sudeste,BUTANTAN/SINOVAC,3001,1542,1459
São Bento Do Sapucaí,354860,SP,Sudeste,FIOCRUZ/ASTRAZENECA,2723,2468,255
São Bento Do Sapucaí,354860,SP,Sudeste,PFIZER/BIONTECH,214,214,0
São Bento Do Sul,421580,SC,Sul,FIOCRUZ/ASTRAZENECA,15645,14709,936
São Bento Do Sul,421580,SC,Sul,BUTANTAN/SINOVAC,11636,6339,5297
São Bento Do Sul,421580,SC,Sul,PFIZER/BIONTECH,869,869,0
São Bento Do Tocantins,172010,TO,Norte,BUTANTAN/SINOVAC,715,442,273
São Bento Do Tocantins,172010,TO,Norte,FIOCRUZ/ASTRAZENECA,381,358,23
São Bento Do Trairí,241170,RN,Nordeste,BUTANTAN/SINOVAC,968,496,472
São Bento Do Trairí,241170,RN,Nordeste,FIOCRUZ/ASTRAZENECA,872,822,50
São Bento Do Trairí,241170,RN,Nordeste,PFIZER/BIONTECH,169,169,0
São Bento Do Una,261300,PE,Nordeste,FIOCRUZ/ASTRAZENECA,12157,11217,940
São Bento Do Una,261300,PE,Nordeste,BUTANTAN/SINOVAC,8865,4516,4349
São Bento Do Una,261300,PE,Nordeste,PFIZER/BIONTECH,793,792,1
São Bernardino,421575,SC,Sul,FIOCRUZ/ASTRAZENECA,711,649,62
São Bernardino,421575,SC,Sul,BUTANTAN/SINOVAC,705,381,324
São Bernardo,211060,MA,Nordeste,FIOCRUZ/ASTRAZENECA,4603,4281,322
São Bernardo,211060,MA,Nordeste,BUTANTAN/SINOVAC,3705,1947,1758
São Bernardo Do Campo,354870,SP,Sudeste,FIOCRUZ/ASTRAZENECA,194692,182400,12292
São Bernardo Do Campo,354870,SP,Sudeste,BUTANTAN/SINOVAC,162821,88671,74150
São Bernardo Do Campo,354870,SP,Sudeste,PFIZER/BIONTECH,15537,15507,30
São Bonifácio,421590,SC,Sul,FIOCRUZ/ASTRAZENECA,888,815,73
São Bonifácio,421590,SC,Sul,BUTANTAN/SINOVAC,871,487,384
São Bonifácio,421590,SC,Sul,PFIZER/BIONTECH,30,30,0
São Borja,431800,RS,Sul,FIOCRUZ/ASTRAZENECA,16255,15024,1231
São Borja,431800,RS,Sul,BUTANTAN/SINOVAC,16017,8081,7936
São Borja,431800,RS,Sul,PFIZER/BIONTECH,1892,1891,1
São Brás,270820,AL,Nordeste,FIOCRUZ/ASTRAZENECA,1365,1191,174
São Brás,270820,AL,Nordeste,BUTANTAN/SINOVAC,1315,672,643
São Brás Do Suaçuí,316090,MG,Sudeste,BUTANTAN/SINOVAC,765,388,377
São Brás Do Suaçuí,316090,MG,Sudeste,FIOCRUZ/ASTRAZENECA,748,559,189
São Braz Do Piauí,220955,PI,Nordeste,BUTANTAN/SINOVAC,790,416,374
São Braz Do Piauí,220955,PI,Nordeste,FIOCRUZ/ASTRAZENECA,785,738,47
São Braz Do Piauí,220955,PI,Nordeste,PFIZER/BIONTECH,91,91,0
São Caetano De Odivelas,150710,PA,Norte,FIOCRUZ/ASTRAZENECA,3025,2507,518
São Caetano De Odivelas,150710,PA,Norte,BUTANTAN/SINOVAC,2160,1129,1031
São Caetano Do Sul,354880,SP,Sudeste,BUTANTAN/SINOVAC,43731,24353,19378
São Caetano Do Sul,354880,SP,Sudeste,FIOCRUZ/ASTRAZENECA,21649,18877,2772
São Caetano Do Sul,354880,SP,Sudeste,PFIZER/BIONTECH,677,677,0
São Caitano,261310,PE,Nordeste,FIOCRUZ/ASTRAZENECA,8461,7885,576
São Caitano,261310,PE,Nordeste,BUTANTAN/SINOVAC,5953,3211,2742
São Caitano,261310,PE,Nordeste,PFIZER/BIONTECH,259,259,0
São Carlos,354890,SP,Sudeste,BUTANTAN/SINOVAC,62737,31596,31141
São Carlos,354890,SP,Sudeste,FIOCRUZ/ASTRAZENECA,59559,53733,5826
São Carlos,354890,SP,Sudeste,PFIZER/BIONTECH,2661,2657,4
São Carlos,421600,SC,Sul,FIOCRUZ/ASTRAZENECA,2879,2651,228
São Carlos,421600,SC,Sul,BUTANTAN/SINOVAC,2427,1247,1180
São Carlos,421600,SC,Sul,PFIZER/BIONTECH,79,79,0
São Carlos Do Ivaí,412460,PR,Sul,FIOCRUZ/ASTRAZENECA,1552,1454,98
São Carlos Do Ivaí,412460,PR,Sul,BUTANTAN/SINOVAC,1439,734,705
São Cristóvão,280670,SE,Nordeste,FIOCRUZ/ASTRAZENECA,3573,3570,3
São Cristóvão,280670,SE,Nordeste,BUTANTAN/SINOVAC,999,999,0
São Cristóvão,280670,SE,Nordeste,PFIZER/BIONTECH,259,253,6
São Cristóvão Do Sul,421605,SC,Sul,FIOCRUZ/ASTRAZENECA,1522,1456,66
São Cristóvão Do Sul,421605,SC,Sul,BUTANTAN/SINOVAC,1122,593,529
São Cristóvão Do Sul,421605,SC,Sul,PFIZER/BIONTECH,23,23,0
São Desidério,292890,BA,Nordeste,FIOCRUZ/ASTRAZENECA,6608,5979,629
São Desidério,292890,BA,Nordeste,BUTANTAN/SINOVAC,5702,2978,2724
São Desidério,292890,BA,Nordeste,PFIZER/BIONTECH,836,836,0
São Domingos,251396,PB,Nordeste,BUTANTAN/SINOVAC,1005,506,499
São Domingos,251396,PB,Nordeste,FIOCRUZ/ASTRAZENECA,607,545,62
São Domingos,251396,PB,Nordeste,PFIZER/BIONTECH,84,84,0
São Domingos,280680,SE,Nordeste,BUTANTAN/SINOVAC,2558,1306,1252
São Domingos,280680,SE,Nordeste,FIOCRUZ/ASTRAZENECA,1809,1806,3
São Domingos,280680,SE,Nordeste,PFIZER/BIONTECH,138,138,0
São Domingos,292895,BA,Nordeste,FIOCRUZ/ASTRAZENECA,2659,2270,389
São Domingos,292895,BA,Nordeste,BUTANTAN/SINOVAC,2162,1123,1039
São Domingos,292895,BA,Nordeste,PFIZER/BIONTECH,228,223,5
São Domingos,421610,SC,Sul,FIOCRUZ/ASTRAZENECA,2507,2288,219
São Domingos,421610,SC,Sul,BUTANTAN/SINOVAC,2078,1122,956
São Domingos,421610,SC,Sul,PFIZER/BIONTECH,120,120,0
São Domingos,521980,GO,Centro-Oeste,FIOCRUZ/ASTRAZENECA,2998,2853,145
São Domingos,521980,GO,Centro-Oeste,BUTANTAN/SINOVAC,750,391,359
São Domingos Das Dores,316095,MG,Sudeste,FIOCRUZ/ASTRAZENECA,1083,1008,75
São Domingos Das Dores,316095,MG,Sudeste,BUTANTAN/SINOVAC,853,468,385
São Domingos Das Dores,316095,MG,Sudeste,PFIZER/BIONTECH,30,30,0
São Domingos Do Araguaia,150715,PA,Norte,FIOCRUZ/ASTRAZENECA,3322,3030,292
São Domingos Do Araguaia,150715,PA,Norte,BUTANTAN/SINOVAC,1210,637,573
São Domingos Do Azeitão,211065,MA,Nordeste,FIOCRUZ/ASTRAZENECA,1847,1694,153
São Domingos Do Azeitão,211065,MA,Nordeste,BUTANTAN/SINOVAC,1176,616,560
São Domingos Do Capim,150720,PA,Norte,FIOCRUZ/ASTRAZENECA,11660,9021,2639
São Domingos Do Capim,150720,PA,Norte,BUTANTAN/SINOVAC,3977,2094,1883
São Domingos Do Cariri,251394,PB,Nordeste,FIOCRUZ/ASTRAZENECA,641,532,109
São Domingos Do Cariri,251394,PB,Nordeste,BUTANTAN/SINOVAC,626,323,303
São Domingos Do Cariri,251394,PB,Nordeste,PFIZER/BIONTECH,22,22,0
São Domingos Do Maranhão,211070,MA,Nordeste,BUTANTAN/SINOVAC,5826,3109,2717
São Domingos Do Maranhão,211070,MA,Nordeste,FIOCRUZ/ASTRAZENECA,5793,5477,316
São Domingos Do Norte,320465,ES,Sudeste,BUTANTAN/SINOVAC,2211,1217,994
São Domingos Do Norte,320465,ES,Sudeste,FIOCRUZ/ASTRAZENECA,2200,2110,90
São Domingos Do Norte,320465,ES,Sudeste,PFIZER/BIONTECH,330,330,0
São Domingos Do Prata,316100,MG,Sudeste,BUTANTAN/SINOVAC,4991,2707,2284
São Domingos Do Prata,316100,MG,Sudeste,FIOCRUZ/ASTRAZENECA,4093,3764,329
São Domingos Do Prata,316100,MG,Sudeste,PFIZER/BIONTECH,267,267,0
São Domingos Do Sul,431805,RS,Sul,BUTANTAN/SINOVAC,1211,611,600
São Domingos Do Sul,431805,RS,Sul,FIOCRUZ/ASTRAZENECA,961,836,125
São Domingos Do Sul,431805,RS,Sul,PFIZER/BIONTECH,102,102,0
São Felipe,292910,BA,Nordeste,BUTANTAN/SINOVAC,3451,1858,1593
São Felipe,292910,BA,Nordeste,FIOCRUZ/ASTRAZENECA,2845,2747,98
São Felipe,292910,BA,Nordeste,PFIZER/BIONTECH,422,422,0
São Felipe D'Oeste,110148,RO,Norte,BUTANTAN/SINOVAC,1427,724,703
São Felipe D'Oeste,110148,RO,Norte,FIOCRUZ/ASTRAZENECA,1222,1169,53
São Felipe D'Oeste,110148,RO,Norte,PFIZER/BIONTECH,201,201,0
São Félix,292900,BA,Nordeste,FIOCRUZ/ASTRAZENECA,3198,2960,238
São Félix,292900,BA,Nordeste,BUTANTAN/SINOVAC,2279,1222,1057
São Félix,292900,BA,Nordeste,PFIZER/BIONTECH,184,184,0
São Félix De Balsas,211080,MA,Nordeste,BUTANTAN/SINOVAC,1350,815,535
São Félix De Balsas,211080,MA,Nordeste,FIOCRUZ/ASTRAZENECA,1124,1045,79
São Félix De Minas,316105,MG,Sudeste,BUTANTAN/SINOVAC,732,365,367
São Félix De Minas,316105,MG,Sudeste,FIOCRUZ/ASTRAZENECA,717,653,64
São Félix De Minas,316105,MG,Sudeste,PFIZER/BIONTECH,28,28,0
São Félix Do Araguaia,510785,MT,Centro-Oeste,BUTANTAN/SINOVAC,6105,3775,2330
São Félix Do Araguaia,510785,MT,Centro-Oeste,FIOCRUZ/ASTRAZENECA,1506,1400,106
São Félix Do Coribe,292905,BA,Nordeste,FIOCRUZ/ASTRAZENECA,3082,2836,246
São Félix Do Coribe,292905,BA,Nordeste,BUTANTAN/SINOVAC,2557,1319,1238
São Félix Do Coribe,292905,BA,Nordeste,PFIZER/BIONTECH,350,350,0
São Félix Do Piauí,220960,PI,Nordeste,FIOCRUZ/ASTRAZENECA,957,844,113
São Félix Do Piauí,220960,PI,Nordeste,BUTANTAN/SINOVAC,940,489,451
São Félix Do Piauí,220960,PI,Nordeste,PFIZER/BIONTECH,64,64,0
São Félix Do Tocantins,172015,TO,Norte,FIOCRUZ/ASTRAZENECA,402,382,20
São Félix Do Tocantins,172015,TO,Norte,BUTANTAN/SINOVAC,365,202,163
São Félix Do Xingu,150730,PA,Norte,BUTANTAN/SINOVAC,4970,2924,2046
São Félix Do Xingu,150730,PA,Norte,FIOCRUZ/ASTRAZENECA,2898,2673,225
São Félix Do Xingu,150730,PA,Norte,PFIZER/BIONTECH,8,6,2
São Fernando,241180,RN,Nordeste,BUTANTAN/SINOVAC,813,459,354
São Fernando,241180,RN,Nordeste,FIOCRUZ/ASTRAZENECA,653,609,44
São Fernando,241180,RN,Nordeste,PFIZER/BIONTECH,151,151,0
São Fidélis,330480,RJ,Sudeste,FIOCRUZ/ASTRAZENECA,4066,3852,214
São Fidélis,330480,RJ,Sudeste,BUTANTAN/SINOVAC,3323,2476,847
São Francisco,251398,PB,Nordeste,BUTANTAN/SINOVAC,1512,775,737
São Francisco,251398,PB,Nordeste,FIOCRUZ/ASTRAZENECA,924,845,79
São Francisco,251398,PB,Nordeste,PFIZER/BIONTECH,118,118,0
São Francisco,280690,SE,Nordeste,BUTANTAN/SINOVAC,751,385,366
São Francisco,280690,SE,Nordeste,FIOCRUZ/ASTRAZENECA,636,599,37
São Francisco,280690,SE,Nordeste,PFIZER/BIONTECH,18,18,0
São Francisco,316110,MG,Sudeste,BUTANTAN/SINOVAC,8481,5223,3258
São Francisco,316110,MG,Sudeste,FIOCRUZ/ASTRAZENECA,3587,3498,89
São Francisco,316110,MG,Sudeste,PFIZER/BIONTECH,33,33,0
São Francisco,354900,SP,Sudeste,BUTANTAN/SINOVAC,891,481,410
São Francisco,354900,SP,Sudeste,FIOCRUZ/ASTRAZENECA,785,709,76
São Francisco,354900,SP,Sudeste,PFIZER/BIONTECH,71,71,0
São Francisco De Assis,431810,RS,Sul,FIOCRUZ/ASTRAZENECA,5349,4605,744
São Francisco De Assis,431810,RS,Sul,BUTANTAN/SINOVAC,5323,2717,2606
São Francisco De Assis,431810,RS,Sul,PFIZER/BIONTECH,631,631,0
São Francisco De Assis Do Piauí,220965,PI,Nordeste,FIOCRUZ/ASTRAZENECA,1343,1258,85
São Francisco De Assis Do Piauí,220965,PI,Nordeste,BUTANTAN/SINOVAC,783,398,385
São Francisco De Assis Do Piauí,220965,PI,Nordeste,PFIZER/BIONTECH,155,155,0
São Francisco De Goiás,521990,GO,Centro-Oeste,FIOCRUZ/ASTRAZENECA,1765,1688,77
São Francisco De Goiás,521990,GO,Centro-Oeste,BUTANTAN/SINOVAC,1204,621,583
São Francisco De Goiás,521990,GO,Centro-Oeste,PFIZER/BIONTECH,74,74,0
São Francisco De Itabapoana,330475,RJ,Sudeste,BUTANTAN/SINOVAC,8032,4205,3827
São Francisco De Itabapoana,330475,RJ,Sudeste,FIOCRUZ/ASTRAZENECA,7426,7174,252
São Francisco De Itabapoana,330475,RJ,Sudeste,PFIZER/BIONTECH,639,639,0
São Francisco De Paula,316120,MG,Sudeste,BUTANTAN/SINOVAC,1844,990,854
São Francisco De Paula,316120,MG,Sudeste,FIOCRUZ/ASTRAZENECA,1614,1514,100
São Francisco De Paula,316120,MG,Sudeste,PFIZER/BIONTECH,57,57,0
São Francisco De Paula,431820,RS,Sul,FIOCRUZ/ASTRAZENECA,5380,5047,333
São Francisco De Paula,431820,RS,Sul,BUTANTAN/SINOVAC,5056,2785,2271
São Francisco De Paula,431820,RS,Sul,PFIZER/BIONTECH,632,630,2
São Francisco De Sales,316130,MG,Sudeste,BUTANTAN/SINOVAC,693,536,157
São Francisco De Sales,316130,MG,Sudeste,FIOCRUZ/ASTRAZENECA,97,96,1
São Francisco Do Brejão,211085,MA,Nordeste,BUTANTAN/SINOVAC,1593,814,779
São Francisco Do Brejão,211085,MA,Nordeste,FIOCRUZ/ASTRAZENECA,1305,1213,92
São Francisco Do Conde,292920,BA,Nordeste,FIOCRUZ/ASTRAZENECA,5796,5246,550
São Francisco Do Conde,292920,BA,Nordeste,BUTANTAN/SINOVAC,5674,3009,2665
São Francisco Do Conde,292920,BA,Nordeste,PFIZER/BIONTECH,1625,1623,2
São Francisco Do Glória,316140,MG,Sudeste,FIOCRUZ/ASTRAZENECA,1236,1089,147
São Francisco Do Glória,316140,MG,Sudeste,BUTANTAN/SINOVAC,1190,620,570
São Francisco Do Glória,316140,MG,Sudeste,PFIZER/BIONTECH,92,92,0
São Francisco Do Guaporé,110149,RO,Norte,BUTANTAN/SINOVAC,3071,1723,1348
São Francisco Do Guaporé,110149,RO,Norte,FIOCRUZ/ASTRAZENECA,2370,2273,97
São Francisco Do Guaporé,110149,RO,Norte,PFIZER/BIONTECH,342,342,0
São Francisco Do Maranhão,211090,MA,Nordeste,BUTANTAN/SINOVAC,2081,1088,993
São Francisco Do Maranhão,211090,MA,Nordeste,FIOCRUZ/ASTRAZENECA,2060,1926,134
São Francisco Do Oeste,241190,RN,Nordeste,FIOCRUZ/ASTRAZENECA,2305,2197,108
São Francisco Do Oeste,241190,RN,Nordeste,BUTANTAN/SINOVAC,2168,1127,1041
São Francisco Do Oeste,241190,RN,Nordeste,PFIZER/BIONTECH,496,496,0
São Francisco Do Pará,150740,PA,Norte,FIOCRUZ/ASTRAZENECA,2578,2074,504
São Francisco Do Pará,150740,PA,Norte,BUTANTAN/SINOVAC,2452,1374,1078
São Francisco Do Piauí,220970,PI,Nordeste,BUTANTAN/SINOVAC,1516,905,611
São Francisco Do Piauí,220970,PI,Nordeste,FIOCRUZ/ASTRAZENECA,1176,1103,73
São Francisco Do Sul,421620,SC,Sul,FIOCRUZ/ASTRAZENECA,10557,9044,1513
São Francisco Do Sul,421620,SC,Sul,BUTANTAN/SINOVAC,1264,325,939
São Gabriel,292925,BA,Nordeste,FIOCRUZ/ASTRAZENECA,4822,4630,192
São Gabriel,292925,BA,Nordeste,BUTANTAN/SINOVAC,3492,1826,1666
São Gabriel,292925,BA,Nordeste,PFIZER/BIONTECH,28,28,0
São Gabriel,431830,RS,Sul,FIOCRUZ/ASTRAZENECA,16383,14716,1667
São Gabriel,431830,RS,Sul,BUTANTAN/SINOVAC,16352,8402,7950
São Gabriel,431830,RS,Sul,PFIZER/BIONTECH,2190,2189,1
São Gabriel Da Cachoeira,130380,AM,Norte,BUTANTAN/SINOVAC,23229,13286,9943
São Gabriel Da Cachoeira,130380,AM,Norte,FIOCRUZ/ASTRAZENECA,2726,2634,92
São Gabriel Da Palha,320470,ES,Sudeste,BUTANTAN/SINOVAC,7465,4129,3336
São Gabriel Da Palha,320470,ES,Sudeste,FIOCRUZ/ASTRAZENECA,7202,6887,315
São Gabriel Da Palha,320470,ES,Sudeste,PFIZER/BIONTECH,868,868,0
São Gabriel Do Oeste,500769,MS,Centro-Oeste,FIOCRUZ/ASTRAZENECA,5746,5377,369
São Gabriel Do Oeste,500769,MS,Centro-Oeste,BUTANTAN/SINOVAC,4741,2501,2240
São Gabriel Do Oeste,500769,MS,Centro-Oeste,PFIZER/BIONTECH,624,623,1
São Geraldo,316150,MG,Sudeste,BUTANTAN/SINOVAC,2590,1296,1294
São Geraldo,316150,MG,Sudeste,FIOCRUZ/ASTRAZENECA,1507,1307,200
São Geraldo Da Piedade,316160,MG,Sudeste,BUTANTAN/SINOVAC,963,490,473
São Geraldo Da Piedade,316160,MG,Sudeste,FIOCRUZ/ASTRAZENECA,916,831,85
São Geraldo Da Piedade,316160,MG,Sudeste,PFIZER/BIONTECH,48,48,0
São Geraldo Do Araguaia,150745,PA,Norte,FIOCRUZ/ASTRAZENECA,3489,3152,337
São Geraldo Do Araguaia,150745,PA,Norte,BUTANTAN/SINOVAC,1550,853,697
São Geraldo Do Baixio,316165,MG,Sudeste,BUTANTAN/SINOVAC,717,405,312
São Geraldo Do Baixio,316165,MG,Sudeste,FIOCRUZ/ASTRAZENECA,505,430,75
São Geraldo Do Baixio,316165,MG,Sudeste,PFIZER/BIONTECH,56,56,0
São Gonçalo,330490,RJ,Sudeste,BUTANTAN/SINOVAC,192578,113847,78731
São Gonçalo,330490,RJ,Sudeste,FIOCRUZ/ASTRAZENECA,78562,67526,11036
São Gonçalo,330490,RJ,Sudeste,PFIZER/BIONTECH,5495,5452,43
São Gonçalo Do Abaeté,316170,MG,Sudeste,FIOCRUZ/ASTRAZENECA,1614,1518,96
São Gonçalo Do Abaeté,316170,MG,Sudeste,BUTANTAN/SINOVAC,1414,741,673
São Gonçalo Do Abaeté,316170,MG,Sudeste,PFIZER/BIONTECH,170,170,0
São Gonçalo Do Amarante,231240,CE,Nordeste,BUTANTAN/SINOVAC,7088,3785,3303
São Gonçalo Do Amarante,231240,CE,Nordeste,FIOCRUZ/ASTRAZENECA,3820,3314,506
São Gonçalo Do Amarante,241200,RN,Nordeste,FIOCRUZ/ASTRAZENECA,19985,19079,906
São Gonçalo Do Amarante,241200,RN,Nordeste,BUTANTAN/SINOVAC,14001,7389,6612
São Gonçalo Do Amarante,241200,RN,Nordeste,PFIZER/BIONTECH,5364,5360,4
São Gonçalo Do Gurguéia,220975,PI,Nordeste,BUTANTAN/SINOVAC,404,213,191
São Gonçalo Do Gurguéia,220975,PI,Nordeste,FIOCRUZ/ASTRAZENECA,357,340,17
São Gonçalo Do Pará,316180,MG,Sudeste,FIOCRUZ/ASTRAZENECA,2264,2077,187
São Gonçalo Do Pará,316180,MG,Sudeste,BUTANTAN/SINOVAC,2195,1187,1008
São Gonçalo Do Pará,316180,MG,Sudeste,PFIZER/BIONTECH,344,344,0
São Gonçalo Do Piauí,220980,PI,Nordeste,BUTANTAN/SINOVAC,1383,719,664
São Gonçalo Do Piauí,220980,PI,Nordeste,FIOCRUZ/ASTRAZENECA,597,551,46
São Gonçalo Do Rio Abaixo,316190,MG,Sudeste,FIOCRUZ/ASTRAZENECA,2697,2421,276
São Gonçalo Do Rio Abaixo,316190,MG,Sudeste,BUTANTAN/SINOVAC,2402,1224,1178
São Gonçalo Do Rio Abaixo,316190,MG,Sudeste,PFIZER/BIONTECH,75,75,0
São Gonçalo Do Rio Preto,312550,MG,Sudeste,FIOCRUZ/ASTRAZENECA,941,855,86
São Gonçalo Do Rio Preto,312550,MG,Sudeste,BUTANTAN/SINOVAC,888,456,432
São Gonçalo Do Rio Preto,312550,MG,Sudeste,PFIZER/BIONTECH,73,73,0
São Gonçalo Do Sapucaí,316200,MG,Sudeste,FIOCRUZ/ASTRAZENECA,4834,4419,415
São Gonçalo Do Sapucaí,316200,MG,Sudeste,BUTANTAN/SINOVAC,4392,2230,2162
São Gonçalo Do Sapucaí,316200,MG,Sudeste,PFIZER/BIONTECH,236,236,0
São Gonçalo Dos Campos,292930,BA,Nordeste,BUTANTAN/SINOVAC,5784,3179,2605
São Gonçalo Dos Campos,292930,BA,Nordeste,FIOCRUZ/ASTRAZENECA,5030,4634,396
São Gonçalo Dos Campos,292930,BA,Nordeste,PFIZER/BIONTECH,196,196,0
São Gotardo,316210,MG,Sudeste,BUTANTAN/SINOVAC,5836,2999,2837
São Gotardo,316210,MG,Sudeste,FIOCRUZ/ASTRAZENECA,4519,4104,415
São Gotardo,316210,MG,Sudeste,PFIZER/BIONTECH,163,163,0
São Jerônimo,431840,RS,Sul,BUTANTAN/SINOVAC,6401,3371,3030
São Jerônimo,431840,RS,Sul,FIOCRUZ/ASTRAZENECA,5772,5295,477
São Jerônimo,431840,RS,Sul,PFIZER/BIONTECH,609,609,0
São Jerônimo Da Serra,412470,PR,Sul,BUTANTAN/SINOVAC,3619,1904,1715
São Jerônimo Da Serra,412470,PR,Sul,FIOCRUZ/ASTRAZENECA,2748,2621,127
São Jerônimo Da Serra,412470,PR,Sul,PFIZER/BIONTECH,1,0,1
São João,261320,PE,Nordeste,FIOCRUZ/ASTRAZENECA,4296,3942,354
São João,261320,PE,Nordeste,BUTANTAN/SINOVAC,3403,1781,1622
São João,261320,PE,Nordeste,PFIZER/BIONTECH,392,392,0
São João,412480,PR,Sul,FIOCRUZ/ASTRAZENECA,3212,2912,300
São João,412480,PR,Sul,BUTANTAN/SINOVAC,2496,1260,1236
São João Batista,211100,MA,Nordeste,FIOCRUZ/ASTRAZENECA,5602,5239,363
São João Batista,211100,MA,Nordeste,BUTANTAN/SINOVAC,3220,1653,1567
São João Batista,421630,SC,Sul,BUTANTAN/SINOVAC,4714,2424,2290
São João Batista,421630,SC,Sul,FIOCRUZ/ASTRAZENECA,2594,2480,114
São João Batista Do Glória,316220,MG,Sudeste,BUTANTAN/SINOVAC,1907,974,933
São João Batista Do Glória,316220,MG,Sudeste,FIOCRUZ/ASTRAZENECA,1773,1645,128
São João Batista Do Glória,316220,MG,Sudeste,PFIZER/BIONTECH,101,101,0
São João D'Aliança,522000,GO,Centro-Oeste,FIOCRUZ/ASTRAZENECA,2901,2720,181
São João D'Aliança,522000,GO,Centro-Oeste,BUTANTAN/SINOVAC,1393,783,610
São João Da Baliza,140050,RR,Norte,BUTANTAN/SINOVAC,1291,666,625
São João Da Baliza,140050,RR,Norte,FIOCRUZ/ASTRAZENECA,646,623,23
São João Da Barra,330500,RJ,Sudeste,BUTANTAN/SINOVAC,9473,4856,4617
São João Da Barra,330500,RJ,Sudeste,FIOCRUZ/ASTRAZENECA,8609,7919,690
São João Da Barra,330500,RJ,Sudeste,PFIZER/BIONTECH,623,622,1
São João Da Boa Vista,354910,SP,Sudeste,BUTANTAN/SINOVAC,25358,13274,12084
São João Da Boa Vista,354910,SP,Sudeste,FIOCRUZ/ASTRAZENECA,24453,21994,2459
São João Da Boa Vista,354910,SP,Sudeste,PFIZER/BIONTECH,2163,2162,1
São João Da Canabrava,220985,PI,Nordeste,BUTANTAN/SINOVAC,1006,526,480
São João Da Canabrava,220985,PI,Nordeste,FIOCRUZ/ASTRAZENECA,776,714,62
São João Da Fronteira,220987,PI,Nordeste,BUTANTAN/SINOVAC,1194,626,568
São João Da Fronteira,220987,PI,Nordeste,FIOCRUZ/ASTRAZENECA,566,544,22
São João Da Lagoa,316225,MG,Sudeste,BUTANTAN/SINOVAC,878,465,413
São João Da Lagoa,316225,MG,Sudeste,FIOCRUZ/ASTRAZENECA,638,585,53
São João Da Mata,316230,MG,Sudeste,BUTANTAN/SINOVAC,632,324,308
São João Da Mata,316230,MG,Sudeste,FIOCRUZ/ASTRAZENECA,600,552,48
São João Da Mata,316230,MG,Sudeste,PFIZER/BIONTECH,24,24,0
São João Da Paraúna,522005,GO,Centro-Oeste,FIOCRUZ/ASTRAZENECA,904,842,62
São João Da Paraúna,522005,GO,Centro-Oeste,BUTANTAN/SINOVAC,515,266,249
São João Da Ponta,150746,PA,Norte,BUTANTAN/SINOVAC,799,487,312
São João Da Ponta,150746,PA,Norte,FIOCRUZ/ASTRAZENECA,576,477,99
São João Da Ponte,316240,MG,Sudeste,FIOCRUZ/ASTRAZENECA,6429,6165,264
São João Da Ponte,316240,MG,Sudeste,BUTANTAN/SINOVAC,4150,2132,2018
São João Da Ponte,316240,MG,Sudeste,PFIZER/BIONTECH,22,22,0
São João Da Serra,220990,PI,Nordeste,BUTANTAN/SINOVAC,1377,738,639
São João Da Serra,220990,PI,Nordeste,FIOCRUZ/ASTRAZENECA,1030,1020,10
São João Da Serra,220990,PI,Nordeste,PFIZER/BIONTECH,154,154,0
São João Da Urtiga,431842,RS,Sul,BUTANTAN/SINOVAC,1826,935,891
São João Da Urtiga,431842,RS,Sul,FIOCRUZ/ASTRAZENECA,1461,1212,249
São João Da Urtiga,431842,RS,Sul,PFIZER/BIONTECH,162,162,0
São João Da Varjota,220995,PI,Nordeste,FIOCRUZ/ASTRAZENECA,1808,1547,261
São João Da Varjota,220995,PI,Nordeste,BUTANTAN/SINOVAC,894,456,438
São João Da Varjota,220995,PI,Nordeste,PFIZER/BIONTECH,42,42,0
São João Das Duas Pontes,354920,SP,Sudeste,BUTANTAN/SINOVAC,678,332,346
São João Das Duas Pontes,354920,SP,Sudeste,FIOCRUZ/ASTRAZENECA,557,471,86
São João Das Duas Pontes,354920,SP,Sudeste,PFIZER/BIONTECH,18,18,0
São João Das Missões,316245,MG,Sudeste,BUTANTAN/SINOVAC,12987,7326,5661
São João Das Missões,316245,MG,Sudeste,FIOCRUZ/ASTRAZENECA,662,581,81
São João Das Missões,316245,MG,Sudeste,PFIZER/BIONTECH,37,37,0
São João De Iracema,354925,SP,Sudeste,BUTANTAN/SINOVAC,549,285,264
São João De Iracema,354925,SP,Sudeste,FIOCRUZ/ASTRAZENECA,428,383,45
São João De Iracema,354925,SP,Sudeste,PFIZER/BIONTECH,43,43,0
São João De Meriti,330510,RJ,Sudeste,BUTANTAN/SINOVAC,88851,46225,42626
São João De Meriti,330510,RJ,Sudeste,FIOCRUZ/ASTRAZENECA,60663,51250,9413
São João De Meriti,330510,RJ,Sudeste,PFIZER/BIONTECH,6456,6393,63
São João De Pirabas,150747,PA,Norte,FIOCRUZ/ASTRAZENECA,4532,3673,859
São João De Pirabas,150747,PA,Norte,BUTANTAN/SINOVAC,2882,1693,1189
São João Del Rei,316250,MG,Sudeste,BUTANTAN/SINOVAC,21800,11161,10639
São João Del Rei,316250,MG,Sudeste,FIOCRUZ/ASTRAZENECA,18591,16694,1897
São João Del Rei,316250,MG,Sudeste,PFIZER/BIONTECH,596,595,1
São João Do Araguaia,150750,PA,Norte,FIOCRUZ/ASTRAZENECA,1637,1528,109
São João Do Araguaia,150750,PA,Norte,BUTANTAN/SINOVAC,580,305,275
São João Do Arraial,220997,PI,Nordeste,BUTANTAN/SINOVAC,1219,619,600
São João Do Arraial,220997,PI,Nordeste,FIOCRUZ/ASTRAZENECA,1066,1002,64
São João Do Caiuá,412490,PR,Sul,FIOCRUZ/ASTRAZENECA,1997,1853,144
São João Do Caiuá,412490,PR,Sul,BUTANTAN/SINOVAC,1347,691,656
São João Do Caiuá,412490,PR,Sul,PFIZER/BIONTECH,32,32,0
São João Do Cariri,251400,PB,Nordeste,BUTANTAN/SINOVAC,1439,808,631
São João Do Cariri,251400,PB,Nordeste,FIOCRUZ/ASTRAZENECA,771,684,87
São João Do Cariri,251400,PB,Nordeste,PFIZER/BIONTECH,52,52,0
São João Do Carú,211102,MA,Nordeste,FIOCRUZ/ASTRAZENECA,2103,1859,244
São João Do Carú,211102,MA,Nordeste,BUTANTAN/SINOVAC,1724,976,748
São João Do Itaperiú,421635,SC,Sul,FIOCRUZ/ASTRAZENECA,1106,989,117
São João Do Itaperiú,421635,SC,Sul,BUTANTAN/SINOVAC,583,289,294
São João Do Itaperiú,421635,SC,Sul,PFIZER/BIONTECH,34,34,0
São João Do Ivaí,412500,PR,Sul,BUTANTAN/SINOVAC,2744,1400,1344
São João Do Ivaí,412500,PR,Sul,FIOCRUZ/ASTRAZENECA,2466,2269,197
São João Do Jaguaribe,231250,CE,Nordeste,BUTANTAN/SINOVAC,2375,1333,1042
São João Do Jaguaribe,231250,CE,Nordeste,FIOCRUZ/ASTRAZENECA,1070,833,237
São João Do Manhuaçu,316255,MG,Sudeste,BUTANTAN/SINOVAC,1593,834,759
São João Do Manhuaçu,316255,MG,Sudeste,FIOCRUZ/ASTRAZENECA,1471,1329,142
São João Do Manhuaçu,316255,MG,Sudeste,PFIZER/BIONTECH,2,2,0
São João Do Manteninha,316257,MG,Sudeste,BUTANTAN/SINOVAC,1190,627,563
São João Do Manteninha,316257,MG,Sudeste,FIOCRUZ/ASTRAZENECA,1058,968,90
São João Do Manteninha,316257,MG,Sudeste,PFIZER/BIONTECH,59,59,0
São João Do Oeste,421625,SC,Sul,BUTANTAN/SINOVAC,1840,933,907
São João Do Oeste,421625,SC,Sul,FIOCRUZ/ASTRAZENECA,1465,1327,138
São João Do Oeste,421625,SC,Sul,PFIZER/BIONTECH,156,156,0
São João Do Oriente,316260,MG,Sudeste,BUTANTAN/SINOVAC,1777,899,878
São João Do Oriente,316260,MG,Sudeste,FIOCRUZ/ASTRAZENECA,1420,1277,143
São João Do Oriente,316260,MG,Sudeste,PFIZER/BIONTECH,56,56,0
São João Do Pacuí,316265,MG,Sudeste,BUTANTAN/SINOVAC,913,483,430
São João Do Pacuí,316265,MG,Sudeste,FIOCRUZ/ASTRAZENECA,735,658,77
São João Do Pacuí,316265,MG,Sudeste,PFIZER/BIONTECH,38,38,0
São João Do Paraíso,211105,MA,Nordeste,FIOCRUZ/ASTRAZENECA,1981,1849,132
São João Do Paraíso,211105,MA,Nordeste,BUTANTAN/SINOVAC,1766,923,843
São João Do Paraíso,316270,MG,Sudeste,BUTANTAN/SINOVAC,4246,2156,2090
São João Do Paraíso,316270,MG,Sudeste,FIOCRUZ/ASTRAZENECA,4175,3851,324
São João Do Paraíso,316270,MG,Sudeste,PFIZER/BIONTECH,705,705,0
São João Do Pau D'Alho,354930,SP,Sudeste,BUTANTAN/SINOVAC,762,397,365
São João Do Pau D'Alho,354930,SP,Sudeste,FIOCRUZ/ASTRAZENECA,714,616,98
São João Do Pau D'Alho,354930,SP,Sudeste,PFIZER/BIONTECH,74,74,0
São João Do Piauí,221000,PI,Nordeste,FIOCRUZ/ASTRAZENECA,5871,5307,564
São João Do Piauí,221000,PI,Nordeste,BUTANTAN/SINOVAC,3236,1646,1590
São João Do Piauí,221000,PI,Nordeste,PFIZER/BIONTECH,115,115,0
São João Do Polêsine,431843,RS,Sul,BUTANTAN/SINOVAC,1214,611,603
São João Do Polêsine,431843,RS,Sul,FIOCRUZ/ASTRAZENECA,941,766,175
São João Do Polêsine,431843,RS,Sul,PFIZER/BIONTECH,106,106,0
São João Do Rio Do Peixe,250070,PB,Nordeste,BUTANTAN/SINOVAC,4733,2412,2321
São João Do Rio Do Peixe,250070,PB,Nordeste,FIOCRUZ/ASTRAZENECA,3585,3225,360
São João Do Rio Do Peixe,250070,PB,Nordeste,PFIZER/BIONTECH,356,356,0
São João Do Sabugi,241210,RN,Nordeste,BUTANTAN/SINOVAC,2288,1137,1151
São João Do Sabugi,241210,RN,Nordeste,FIOCRUZ/ASTRAZENECA,1805,1695,110
São João Do Sabugi,241210,RN,Nordeste,PFIZER/BIONTECH,59,59,0
São João Do Soter,211107,MA,Nordeste,FIOCRUZ/ASTRAZENECA,4464,4274,190
São João Do Soter,211107,MA,Nordeste,BUTANTAN/SINOVAC,2707,1435,1272
São João Do Sul,421640,SC,Sul,FIOCRUZ/ASTRAZENECA,1583,1521,62
São João Do Sul,421640,SC,Sul,BUTANTAN/SINOVAC,1033,640,393
São João Do Sul,421640,SC,Sul,PFIZER/BIONTECH,15,15,0
São João Do Tigre,251410,PB,Nordeste,BUTANTAN/SINOVAC,1160,588,572
São João Do Tigre,251410,PB,Nordeste,FIOCRUZ/ASTRAZENECA,1153,1083,70
São João Do Tigre,251410,PB,Nordeste,PFIZER/BIONTECH,60,60,0
São João Do Triunfo,412510,PR,Sul,FIOCRUZ/ASTRAZENECA,3044,2912,132
São João Do Triunfo,412510,PR,Sul,BUTANTAN/SINOVAC,2493,1299,1194
São João Do Triunfo,412510,PR,Sul,PFIZER/BIONTECH,15,15,0
São João Dos Patos,211110,MA,Nordeste,FIOCRUZ/ASTRAZENECA,10177,9637,540
São João Dos Patos,211110,MA,Nordeste,BUTANTAN/SINOVAC,4724,2412,2312
São João Dos Patos,211110,MA,Nordeste,PFIZER/BIONTECH,671,671,0
São João Evangelista,316280,MG,Sudeste,BUTANTAN/SINOVAC,3504,1788,1716
São João Evangelista,316280,MG,Sudeste,FIOCRUZ/ASTRAZENECA,2684,2514,170
São João Evangelista,316280,MG,Sudeste,PFIZER/BIONTECH,21,21,0
São João Nepomuceno,316290,MG,Sudeste,FIOCRUZ/ASTRAZENECA,6052,5610,442
São João Nepomuceno,316290,MG,Sudeste,BUTANTAN/SINOVAC,6022,3095,2927
São João Nepomuceno,316290,MG,Sudeste,PFIZER/BIONTECH,530,530,0
São Joaquim,421650,SC,Sul,FIOCRUZ/ASTRAZENECA,7406,6826,580
São Joaquim,421650,SC,Sul,BUTANTAN/SINOVAC,4849,2671,2178
São Joaquim,421650,SC,Sul,PFIZER/BIONTECH,363,363,0
São Joaquim Da Barra,354940,SP,Sudeste,BUTANTAN/SINOVAC,13131,6665,6466
São Joaquim Da Barra,354940,SP,Sudeste,FIOCRUZ/ASTRAZENECA,11417,10055,1362
São Joaquim Da Barra,354940,SP,Sudeste,PFIZER/BIONTECH,884,878,6
São Joaquim De Bicas,316292,MG,Sudeste,FIOCRUZ/ASTRAZENECA,5028,4673,355
São Joaquim De Bicas,316292,MG,Sudeste,BUTANTAN/SINOVAC,4244,2168,2076
São Joaquim De Bicas,316292,MG,Sudeste,PFIZER/BIONTECH,734,733,1
São Joaquim Do Monte,261330,PE,Nordeste,FIOCRUZ/ASTRAZENECA,3923,3566,357
São Joaquim Do Monte,261330,PE,Nordeste,BUTANTAN/SINOVAC,3791,1999,1792
São Joaquim Do Monte,261330,PE,Nordeste,PFIZER/BIONTECH,301,300,1
São Jorge,431844,RS,Sul,FIOCRUZ/ASTRAZENECA,895,743,152
São Jorge,431844,RS,Sul,BUTANTAN/SINOVAC,880,440,440
São Jorge,431844,RS,Sul,PFIZER/BIONTECH,114,114,0
São Jorge D'Oeste,412520,PR,Sul,FIOCRUZ/ASTRAZENECA,2619,2449,170
São Jorge D'Oeste,412520,PR,Sul,BUTANTAN/SINOVAC,2063,1061,1002
São Jorge D'Oeste,412520,PR,Sul,PFIZER/BIONTECH,137,137,0
São Jorge Do Ivaí,412530,PR,Sul,FIOCRUZ/ASTRAZENECA,2069,1968,101
São Jorge Do Ivaí,412530,PR,Sul,BUTANTAN/SINOVAC,1613,825,788
São Jorge Do Ivaí,412530,PR,Sul,PFIZER/BIONTECH,24,24,0
São Jorge Do Patrocínio,412535,PR,Sul,BUTANTAN/SINOVAC,1782,926,856
São Jorge Do Patrocínio,412535,PR,Sul,FIOCRUZ/ASTRAZENECA,1591,1453,138
São José,421660,SC,Sul,BUTANTAN/SINOVAC,47112,26642,20470
São José,421660,SC,Sul,FIOCRUZ/ASTRAZENECA,15858,14616,1242
São José,421660,SC,Sul,PFIZER/BIONTECH,5747,5733,14
São José Da Barra,316294,MG,Sudeste,BUTANTAN/SINOVAC,1217,663,554
São José Da Barra,316294,MG,Sudeste,FIOCRUZ/ASTRAZENECA,1086,1017,69
São José Da Bela Vista,354950,SP,Sudeste,BUTANTAN/SINOVAC,1985,994,991
São José Da Bela Vista,354950,SP,Sudeste,FIOCRUZ/ASTRAZENECA,1723,1566,157
São José Da Bela Vista,354950,SP,Sudeste,PFIZER/BIONTECH,192,192,0
São José Da Boa Vista,412540,PR,Sul,FIOCRUZ/ASTRAZENECA,1609,1507,102
São José Da Boa Vista,412540,PR,Sul,BUTANTAN/SINOVAC,1462,769,693
São José Da Boa Vista,412540,PR,Sul,PFIZER/BIONTECH,30,30,0
São José Da Coroa Grande,261340,PE,Nordeste,BUTANTAN/SINOVAC,4094,2423,1671
São José Da Coroa Grande,261340,PE,Nordeste,FIOCRUZ/ASTRAZENECA,4002,3778,224
São José Da Coroa Grande,261340,PE,Nordeste,PFIZER/BIONTECH,98,93,5
São José Da Lagoa Tapada,251420,PB,Nordeste,BUTANTAN/SINOVAC,2573,1325,1248
São José Da Lagoa Tapada,251420,PB,Nordeste,FIOCRUZ/ASTRAZENECA,1418,1297,121
São José Da Lagoa Tapada,251420,PB,Nordeste,PFIZER/BIONTECH,58,58,0
São José Da Laje,270830,AL,Nordeste,FIOCRUZ/ASTRAZENECA,3864,3595,269
São José Da Laje,270830,AL,Nordeste,BUTANTAN/SINOVAC,3541,1946,1595
São José Da Laje,270830,AL,Nordeste,PFIZER/BIONTECH,51,51,0
São José Da Lapa,316295,MG,Sudeste,BUTANTAN/SINOVAC,782,474,308
São José Da Lapa,316295,MG,Sudeste,FIOCRUZ/ASTRAZENECA,357,335,22
São José Da Safira,316300,MG,Sudeste,BUTANTAN/SINOVAC,677,363,314
São José Da Safira,316300,MG,Sudeste,FIOCRUZ/ASTRAZENECA,568,502,66
São José Da Safira,316300,MG,Sudeste,PFIZER/BIONTECH,131,131,0
São José Da Tapera,270840,AL,Nordeste,FIOCRUZ/ASTRAZENECA,6083,5543,540
São José Da Tapera,270840,AL,Nordeste,BUTANTAN/SINOVAC,3914,2054,1860
São José Da Varginha,316310,MG,Sudeste,BUTANTAN/SINOVAC,1150,607,543
São José Da Varginha,316310,MG,Sudeste,FIOCRUZ/ASTRAZENECA,958,843,115
São José Da Varginha,316310,MG,Sudeste,PFIZER/BIONTECH,4,4,0
São José Da Vitória,292935,BA,Nordeste,BUTANTAN/SINOVAC,1372,746,626
São José Da Vitória,292935,BA,Nordeste,FIOCRUZ/ASTRAZENECA,1042,1007,35
São José Da Vitória,292935,BA,Nordeste,PFIZER/BIONTECH,106,106,0
São José Das Missões,431845,RS,Sul,BUTANTAN/SINOVAC,786,393,393
São José Das Missões,431845,RS,Sul,FIOCRUZ/ASTRAZENECA,682,620,62
São José Das Missões,431845,RS,Sul,PFIZER/BIONTECH,96,95,1
São José Das Palmeiras,412545,PR,Sul,FIOCRUZ/ASTRAZENECA,875,816,59
São José Das Palmeiras,412545,PR,Sul,BUTANTAN/SINOVAC,858,442,416
São José Das Palmeiras,412545,PR,Sul,PFIZER/BIONTECH,16,16,0
São José De Caiana,251430,PB,Nordeste,BUTANTAN/SINOVAC,1229,627,602
São José De Caiana,251430,PB,Nordeste,FIOCRUZ/ASTRAZENECA,925,852,73
São José De Caiana,251430,PB,Nordeste,PFIZER/BIONTECH,126,126,0
São José De Espinharas,251440,PB,Nordeste,BUTANTAN/SINOVAC,1160,584,576
São José De Espinharas,251440,PB,Nordeste,FIOCRUZ/ASTRAZENECA,854,776,78
São José De Espinharas,251440,PB,Nordeste,PFIZER/BIONTECH,120,120,0
São José De Mipibu,241220,RN,Nordeste,FIOCRUZ/ASTRAZENECA,6123,5367,756
São José De Mipibu,241220,RN,Nordeste,BUTANTAN/SINOVAC,6002,3029,2973
São José De Mipibu,241220,RN,Nordeste,PFIZER/BIONTECH,478,478,0
São José De Piranhas,251450,PB,Nordeste,BUTANTAN/SINOVAC,4652,2374,2278
São José De Piranhas,251450,PB,Nordeste,FIOCRUZ/ASTRAZENECA,3415,3100,315
São José De Piranhas,251450,PB,Nordeste,PFIZER/BIONTECH,576,576,0
São José De Princesa,251455,PB,Nordeste,BUTANTAN/SINOVAC,1074,540,534
São José De Princesa,251455,PB,Nordeste,FIOCRUZ/ASTRAZENECA,662,601,61
São José De Princesa,251455,PB,Nordeste,PFIZER/BIONTECH,104,104,0
São José De Ribamar,211120,MA,Nordeste,FIOCRUZ/ASTRAZENECA,61855,60789,1066
São José De Ribamar,211120,MA,Nordeste,BUTANTAN/SINOVAC,16206,8941,7265
São José De Ribamar,211120,MA,Nordeste,PFIZER/BIONTECH,627,627,0
São José De Ubá,330513,RJ,Sudeste,BUTANTAN/SINOVAC,2011,1086,925
São José De Ubá,330513,RJ,Sudeste,FIOCRUZ/ASTRAZENECA,944,882,62
São José Do Alegre,316320,MG,Sudeste,FIOCRUZ/ASTRAZENECA,934,894,40
São José Do Alegre,316320,MG,Sudeste,BUTANTAN/SINOVAC,817,421,396
São José Do Alegre,316320,MG,Sudeste,PFIZER/BIONTECH,86,86,0
São José Do Barreiro,354960,SP,Sudeste,FIOCRUZ/ASTRAZENECA,851,769,82
São José Do Barreiro,354960,SP,Sudeste,BUTANTAN/SINOVAC,818,384,434
São José Do Barreiro,354960,SP,Sudeste,PFIZER/BIONTECH,3,3,0
São José Do Belmonte,261350,PE,Nordeste,FIOCRUZ/ASTRAZENECA,7048,6469,579
São José Do Belmonte,261350,PE,Nordeste,BUTANTAN/SINOVAC,6067,3211,2856
São José Do Belmonte,261350,PE,Nordeste,PFIZER/BIONTECH,975,975,0
São José Do Bonfim,251460,PB,Nordeste,BUTANTAN/SINOVAC,698,355,343
São José Do Bonfim,251460,PB,Nordeste,FIOCRUZ/ASTRAZENECA,521,463,58
São José Do Bonfim,251460,PB,Nordeste,PFIZER/BIONTECH,47,47,0
São José Do Brejo Do Cruz,251465,PB,Nordeste,BUTANTAN/SINOVAC,705,394,311
São José Do Brejo Do Cruz,251465,PB,Nordeste,FIOCRUZ/ASTRAZENECA,409,362,47
São José Do Brejo Do Cruz,251465,PB,Nordeste,PFIZER/BIONTECH,60,60,0
São José Do Calçado,320480,ES,Sudeste,BUTANTAN/SINOVAC,3858,2143,1715
São José Do Calçado,320480,ES,Sudeste,FIOCRUZ/ASTRAZENECA,2499,2343,156
São José Do Calçado,320480,ES,Sudeste,PFIZER/BIONTECH,387,385,2
São José Do Campestre,241230,RN,Nordeste,BUTANTAN/SINOVAC,2928,1447,1481
São José Do Campestre,241230,RN,Nordeste,FIOCRUZ/ASTRAZENECA,1856,1708,148
São José Do Campestre,241230,RN,Nordeste,PFIZER/BIONTECH,117,117,0
São José Do Cedro,421670,SC,Sul,FIOCRUZ/ASTRAZENECA,3799,3540,259
São José Do Cedro,421670,SC,Sul,BUTANTAN/SINOVAC,3498,1934,1564
São José Do Cedro,421670,SC,Sul,PFIZER/BIONTECH,231,231,0
São José Do Cerrito,421680,SC,Sul,FIOCRUZ/ASTRAZENECA,2518,2367,151
São José Do Cerrito,421680,SC,Sul,BUTANTAN/SINOVAC,2195,1143,1052
São José Do Cerrito,421680,SC,Sul,PFIZER/BIONTECH,126,126,0
São José Do Divino,221005,PI,Nordeste,BUTANTAN/SINOVAC,793,483,310
São José Do Divino,221005,PI,Nordeste,FIOCRUZ/ASTRAZENECA,428,404,24
São José Do Divino,316330,MG,Sudeste,BUTANTAN/SINOVAC,891,446,445
São José Do Divino,316330,MG,Sudeste,FIOCRUZ/ASTRAZENECA,592,501,91
São José Do Divino,316330,MG,Sudeste,PFIZER/BIONTECH,30,30,0
São José Do Egito,261360,PE,Nordeste,FIOCRUZ/ASTRAZENECA,12052,10355,1697
São José Do Egito,261360,PE,Nordeste,BUTANTAN/SINOVAC,6754,3441,3313
São José Do Egito,261360,PE,Nordeste,PFIZER/BIONTECH,495,495,0
São José Do Goiabal,316340,MG,Sudeste,FIOCRUZ/ASTRAZENECA,1590,1473,117
São José Do Goiabal,316340,MG,Sudeste,BUTANTAN/SINOVAC,1507,769,738
São José Do Goiabal,316340,MG,Sudeste,PFIZER/BIONTECH,64,64,0
São José Do Herval,431846,RS,Sul,FIOCRUZ/ASTRAZENECA,527,498,29
São José Do Herval,431846,RS,Sul,BUTANTAN/SINOVAC,518,257,261
São José Do Herval,431846,RS,Sul,PFIZER/BIONTECH,60,60,0
São José Do Hortêncio,431848,RS,Sul,BUTANTAN/SINOVAC,1354,681,673
São José Do Hortêncio,431848,RS,Sul,FIOCRUZ/ASTRAZENECA,1055,970,85
São José Do Hortêncio,431848,RS,Sul,PFIZER/BIONTECH,175,174,1
São José Do Inhacorá,431849,RS,Sul,BUTANTAN/SINOVAC,983,501,482
São José Do Inhacorá,431849,RS,Sul,FIOCRUZ/ASTRAZENECA,702,617,85
São José Do Inhacorá,431849,RS,Sul,PFIZER/BIONTECH,88,88,0
São José Do Jacuípe,292937,BA,Nordeste,BUTANTAN/SINOVAC,2510,1298,1212
São José Do Jacuípe,292937,BA,Nordeste,FIOCRUZ/ASTRAZENECA,2272,2091,181
São José Do Jacuípe,292937,BA,Nordeste,PFIZER/BIONTECH,134,132,2
São José Do Jacuri,316350,MG,Sudeste,BUTANTAN/SINOVAC,1411,709,702
São José Do Jacuri,316350,MG,Sudeste,FIOCRUZ/ASTRAZENECA,1304,1160,144
São José Do Jacuri,316350,MG,Sudeste,PFIZER/BIONTECH,83,83,0
São José Do Mantimento,316360,MG,Sudeste,BUTANTAN/SINOVAC,622,325,297
São José Do Mantimento,316360,MG,Sudeste,FIOCRUZ/ASTRAZENECA,415,413,2
São José Do Mantimento,316360,MG,Sudeste,PFIZER/BIONTECH,15,15,0
São José Do Norte,431850,RS,Sul,FIOCRUZ/ASTRAZENECA,7337,6838,499
São José Do Norte,431850,RS,Sul,BUTANTAN/SINOVAC,6929,3523,3406
São José Do Norte,431850,RS,Sul,PFIZER/BIONTECH,996,992,4
São José Do Ouro,431860,RS,Sul,FIOCRUZ/ASTRAZENECA,2156,1891,265
São José Do Ouro,431860,RS,Sul,BUTANTAN/SINOVAC,2094,1072,1022
São José Do Ouro,431860,RS,Sul,PFIZER/BIONTECH,226,226,0
São José Do Peixe,221010,PI,Nordeste,BUTANTAN/SINOVAC,573,339,234
São José Do Peixe,221010,PI,Nordeste,FIOCRUZ/ASTRAZENECA,429,429,0
São José Do Piauí,221020,PI,Nordeste,FIOCRUZ/ASTRAZENECA,1708,1598,110
São José Do Piauí,221020,PI,Nordeste,BUTANTAN/SINOVAC,1420,729,691
São José Do Povo,510729,MT,Centro-Oeste,BUTANTAN/SINOVAC,1019,530,489
São José Do Povo,510729,MT,Centro-Oeste,FIOCRUZ/ASTRAZENECA,926,875,51
São José Do Povo,510729,MT,Centro-Oeste,PFIZER/BIONTECH,1,1,0
São José Do Rio Claro,510730,MT,Centro-Oeste,BUTANTAN/SINOVAC,2880,1564,1316
São José Do Rio Claro,510730,MT,Centro-Oeste,FIOCRUZ/ASTRAZENECA,2516,2183,333
São José Do Rio Claro,510730,MT,Centro-Oeste,PFIZER/BIONTECH,20,20,0
São José Do Rio Pardo,354970,SP,Sudeste,BUTANTAN/SINOVAC,13155,7310,5845
São José Do Rio Pardo,354970,SP,Sudeste,FIOCRUZ/ASTRAZENECA,12235,11482,753
São José Do Rio Pardo,354970,SP,Sudeste,PFIZER/BIONTECH,413,413,0
São José Do Rio Preto,354980,SP,Sudeste,FIOCRUZ/ASTRAZENECA,118755,109925,8830
São José Do Rio Preto,354980,SP,Sudeste,BUTANTAN/SINOVAC,112969,60826,52143
São José Do Rio Preto,354980,SP,Sudeste,PFIZER/BIONTECH,6976,6965,11
São José Do Sabugi,251470,PB,Nordeste,BUTANTAN/SINOVAC,1010,510,500
São José Do Sabugi,251470,PB,Nordeste,FIOCRUZ/ASTRAZENECA,754,687,67
São José Do Sabugi,251470,PB,Nordeste,PFIZER/BIONTECH,43,43,0
São José Do Seridó,241240,RN,Nordeste,FIOCRUZ/ASTRAZENECA,1148,1092,56
São José Do Seridó,241240,RN,Nordeste,BUTANTAN/SINOVAC,1052,573,479
São José Do Seridó,241240,RN,Nordeste,PFIZER/BIONTECH,252,252,0
São José Do Sul,431861,RS,Sul,BUTANTAN/SINOVAC,923,469,454
São José Do Sul,431861,RS,Sul,FIOCRUZ/ASTRAZENECA,571,515,56
São José Do Sul,431861,RS,Sul,PFIZER/BIONTECH,102,102,0
São José Do Vale Do Rio Preto,330515,RJ,Sudeste,BUTANTAN/SINOVAC,4852,2562,2290
São José Do Vale Do Rio Preto,330515,RJ,Sudeste,FIOCRUZ/ASTRAZENECA,3425,3043,382
São José Do Vale Do Rio Preto,330515,RJ,Sudeste,PFIZER/BIONTECH,377,377,0
São José Do Xingu,510735,MT,Centro-Oeste,BUTANTAN/SINOVAC,737,395,342
São José Do Xingu,510735,MT,Centro-Oeste,FIOCRUZ/ASTRAZENECA,727,668,59
São José Do Xingu,510735,MT,Centro-Oeste,PFIZER/BIONTECH,79,79,0
São José Dos Ausentes,431862,RS,Sul,FIOCRUZ/ASTRAZENECA,986,897,89
São José Dos Ausentes,431862,RS,Sul,BUTANTAN/SINOVAC,622,326,296
São José Dos Ausentes,431862,RS,Sul,PFIZER/BIONTECH,100,100,0
São José Dos Basílios,211125,MA,Nordeste,FIOCRUZ/ASTRAZENECA,1722,1617,105
São José Dos Basílios,211125,MA,Nordeste,BUTANTAN/SINOVAC,1460,763,697
São José Dos Campos,354990,SP,Sudeste,FIOCRUZ/ASTRAZENECA,237066,223819,13247
São José Dos Campos,354990,SP,Sudeste,BUTANTAN/SINOVAC,185486,101551,83935
São José Dos Campos,354990,SP,Sudeste,PFIZER/BIONTECH,13594,13594,0
São José Dos Cordeiros,251480,PB,Nordeste,BUTANTAN/SINOVAC,1050,537,513
São José Dos Cordeiros,251480,PB,Nordeste,FIOCRUZ/ASTRAZENECA,1031,947,84
São José Dos Cordeiros,251480,PB,Nordeste,PFIZER/BIONTECH,89,89,0
São José Dos Pinhais,412550,PR,Sul,BUTANTAN/SINOVAC,70300,36933,33367
São José Dos Pinhais,412550,PR,Sul,FIOCRUZ/ASTRAZENECA,66228,61506,4722
São José Dos Pinhais,412550,PR,Sul,PFIZER/BIONTECH,9595,9593,2
São José Dos Quatro Marcos,510710,MT,Centro-Oeste,FIOCRUZ/ASTRAZENECA,3697,3436,261
São José Dos Quatro Marcos,510710,MT,Centro-Oeste,BUTANTAN/SINOVAC,3408,1814,1594
São José Dos Quatro Marcos,510710,MT,Centro-Oeste,PFIZER/BIONTECH,25,25,0
São José Dos Ramos,251445,PB,Nordeste,BUTANTAN/SINOVAC,1157,584,573
São José Dos Ramos,251445,PB,Nordeste,FIOCRUZ/ASTRAZENECA,1031,928,103
São Julião,221030,PI,Nordeste,FIOCRUZ/ASTRAZENECA,1511,1306,205
São Julião,221030,PI,Nordeste,BUTANTAN/SINOVAC,1357,705,652
São Leopoldo,431870,RS,Sul,BUTANTAN/SINOVAC,47711,24960,22751
São Leopoldo,431870,RS,Sul,FIOCRUZ/ASTRAZENECA,45542,42447,3095
São Leopoldo,431870,RS,Sul,PFIZER/BIONTECH,2130,2129,1
São Lourenço,316370,MG,Sudeste,BUTANTAN/SINOVAC,11433,5820,5613
São Lourenço,316370,MG,Sudeste,FIOCRUZ/ASTRAZENECA,9350,8530,820
São Lourenço,316370,MG,Sudeste,PFIZER/BIONTECH,552,540,12
São Lourenço Da Mata,261370,PE,Nordeste,BUTANTAN/SINOVAC,13835,7547,6288
São Lourenço Da Mata,261370,PE,Nordeste,FIOCRUZ/ASTRAZENECA,10976,10099,877
São Lourenço Da Mata,261370,PE,Nordeste,PFIZER/BIONTECH,348,348,0
São Lourenço Da Serra,354995,SP,Sudeste,FIOCRUZ/ASTRAZENECA,3901,3728,173
São Lourenço Da Serra,354995,SP,Sudeste,BUTANTAN/SINOVAC,3111,1876,1235
São Lourenço Da Serra,354995,SP,Sudeste,PFIZER/BIONTECH,369,369,0
São Lourenço Do Oeste,421690,SC,Sul,BUTANTAN/SINOVAC,2961,1847,1114
São Lourenço Do Oeste,421690,SC,Sul,FIOCRUZ/ASTRAZENECA,1989,1713,276
São Lourenço Do Piauí,221035,PI,Nordeste,FIOCRUZ/ASTRAZENECA,1610,1464,146
São Lourenço Do Piauí,221035,PI,Nordeste,BUTANTAN/SINOVAC,1058,543,515
São Lourenço Do Piauí,221035,PI,Nordeste,PFIZER/BIONTECH,54,54,0
São Lourenço Do Sul,431880,RS,Sul,FIOCRUZ/ASTRAZENECA,12665,11348,1317
São Lourenço Do Sul,431880,RS,Sul,BUTANTAN/SINOVAC,11677,5996,5681
São Lourenço Do Sul,431880,RS,Sul,PFIZER/BIONTECH,984,984,0
São Ludgero,421700,SC,Sul,FIOCRUZ/ASTRAZENECA,3864,3609,255
São Ludgero,421700,SC,Sul,BUTANTAN/SINOVAC,1690,947,743
São Ludgero,421700,SC,Sul,PFIZER/BIONTECH,365,365,0
São Luís,211130,MA,Nordeste,FIOCRUZ/ASTRAZENECA,383576,358694,24882
São Luís,211130,MA,Nordeste,BUTANTAN/SINOVAC,194763,100049,94714
São Luís,211130,MA,Nordeste,PFIZER/BIONTECH,74669,74615,54
São Luís De Montes Belos,522010,GO,Centro-Oeste,FIOCRUZ/ASTRAZENECA,6676,6014,662
São Luís De Montes Belos,522010,GO,Centro-Oeste,BUTANTAN/SINOVAC,6527,3357,3170
São Luís De Montes Belos,522010,GO,Centro-Oeste,PFIZER/BIONTECH,1396,1396,0
São Luís Do Curu,231260,CE,Nordeste,BUTANTAN/SINOVAC,1732,1121,611
São Luís Do Curu,231260,CE,Nordeste,FIOCRUZ/ASTRAZENECA,265,259,6
São Luis Do Piauí,221037,PI,Nordeste,BUTANTAN/SINOVAC,534,273,261
São Luis Do Piauí,221037,PI,Nordeste,FIOCRUZ/ASTRAZENECA,431,403,28
São Luís Do Quitunde,270850,AL,Nordeste,FIOCRUZ/ASTRAZENECA,4983,4686,297
São Luís Do Quitunde,270850,AL,Nordeste,BUTANTAN/SINOVAC,3583,1864,1719
São Luís Gonzaga Do Maranhão,211140,MA,Nordeste,FIOCRUZ/ASTRAZENECA,3801,3619,182
São Luís Gonzaga Do Maranhão,211140,MA,Nordeste,BUTANTAN/SINOVAC,2388,1260,1128
São Luiz,140060,RR,Norte,BUTANTAN/SINOVAC,1203,668,535
São Luiz,140060,RR,Norte,FIOCRUZ/ASTRAZENECA,346,322,24
São Luiz Do Norte,522015,GO,Centro-Oeste,FIOCRUZ/ASTRAZENECA,1373,1333,40
São Luiz Do Norte,522015,GO,Centro-Oeste,BUTANTAN/SINOVAC,820,427,393
São Luiz Do Norte,522015,GO,Centro-Oeste,PFIZER/BIONTECH,62,62,0
São Luiz Do Paraitinga,355000,SP,Sudeste,FIOCRUZ/ASTRAZENECA,2756,2513,243
São Luiz Do Paraitinga,355000,SP,Sudeste,BUTANTAN/SINOVAC,2696,1386,1310
São Luiz Do Paraitinga,355000,SP,Sudeste,PFIZER/BIONTECH,156,156,0
São Luiz Gonzaga,431890,RS,Sul,BUTANTAN/SINOVAC,9857,5139,4718
São Luiz Gonzaga,431890,RS,Sul,FIOCRUZ/ASTRAZENECA,8933,8192,741
São Luiz Gonzaga,431890,RS,Sul,PFIZER/BIONTECH,1239,1239,0
São Mamede,251490,PB,Nordeste,BUTANTAN/SINOVAC,2235,1172,1063
São Mamede,251490,PB,Nordeste,FIOCRUZ/ASTRAZENECA,1607,1472,135
São Mamede,251490,PB,Nordeste,PFIZER/BIONTECH,192,192,0
São Manoel Do Paraná,412555,PR,Sul,FIOCRUZ/ASTRAZENECA,802,771,31
São Manoel Do Paraná,412555,PR,Sul,BUTANTAN/SINOVAC,643,341,302
São Manoel Do Paraná,412555,PR,Sul,PFIZER/BIONTECH,11,11,0
São Manuel,355010,SP,Sudeste,FIOCRUZ/ASTRAZENECA,9522,8447,1075
São Manuel,355010,SP,Sudeste,BUTANTAN/SINOVAC,8518,4274,4244
São Manuel,355010,SP,Sudeste,PFIZER/BIONTECH,190,190,0
São Marcos,431900,RS,Sul,BUTANTAN/SINOVAC,5207,2628,2579
São Marcos,431900,RS,Sul,FIOCRUZ/ASTRAZENECA,4593,4130,463
São Marcos,431900,RS,Sul,PFIZER/BIONTECH,108,108,0
São Martinho,421710,SC,Sul,FIOCRUZ/ASTRAZENECA,1178,974,204
São Martinho,421710,SC,Sul,BUTANTAN/SINOVAC,901,476,425
São Martinho,421710,SC,Sul,PFIZER/BIONTECH,34,34,0
São Martinho,431910,RS,Sul,BUTANTAN/SINOVAC,2042,1016,1026
São Martinho,431910,RS,Sul,FIOCRUZ/ASTRAZENECA,1710,1487,223
São Martinho,431910,RS,Sul,PFIZER/BIONTECH,219,218,1
São Martinho Da Serra,431912,RS,Sul,BUTANTAN/SINOVAC,980,592,388
São Martinho Da Serra,431912,RS,Sul,FIOCRUZ/ASTRAZENECA,796,744,52
São Martinho Da Serra,431912,RS,Sul,PFIZER/BIONTECH,28,28,0
São Mateus,320490,ES,Sudeste,FIOCRUZ/ASTRAZENECA,37162,34591,2571
São Mateus,320490,ES,Sudeste,BUTANTAN/SINOVAC,25208,13922,11286
São Mateus,320490,ES,Sudeste,PFIZER/BIONTECH,1761,1758,3
São Mateus Do Maranhão,211150,MA,Nordeste,FIOCRUZ/ASTRAZENECA,6799,6369,430
São Mateus Do Maranhão,211150,MA,Nordeste,BUTANTAN/SINOVAC,5599,2907,2692
São Mateus Do Sul,412560,PR,Sul,FIOCRUZ/ASTRAZENECA,9832,9301,531
São Mateus Do Sul,412560,PR,Sul,BUTANTAN/SINOVAC,7431,3796,3635
São Mateus Do Sul,412560,PR,Sul,PFIZER/BIONTECH,1851,1851,0
São Miguel,241250,RN,Nordeste,FIOCRUZ/ASTRAZENECA,5750,5367,383
São Miguel,241250,RN,Nordeste,BUTANTAN/SINOVAC,4662,2522,2140
São Miguel,241250,RN,Nordeste,PFIZER/BIONTECH,304,302,2
São Miguel Arcanjo,355020,SP,Sudeste,FIOCRUZ/ASTRAZENECA,6961,6514,447
São Miguel Arcanjo,355020,SP,Sudeste,BUTANTAN/SINOVAC,6095,3063,3032
São Miguel Arcanjo,355020,SP,Sudeste,PFIZER/BIONTECH,248,248,0
São Miguel Da Baixa Grande,221038,PI,Nordeste,FIOCRUZ/ASTRAZENECA,577,533,44
São Miguel Da Baixa Grande,221038,PI,Nordeste,BUTANTAN/SINOVAC,567,301,266
São Miguel Da Baixa Grande,221038,PI,Nordeste,PFIZER/BIONTECH,59,59,0
São Miguel Da Boa Vista,421715,SC,Sul,BUTANTAN/SINOVAC,1127,599,528
São Miguel Da Boa Vista,421715,SC,Sul,FIOCRUZ/ASTRAZENECA,810,734,76
São Miguel Da Boa Vista,421715,SC,Sul,PFIZER/BIONTECH,31,31,0
São Miguel Das Matas,292940,BA,Nordeste,BUTANTAN/SINOVAC,2004,1036,968
São Miguel Das Matas,292940,BA,Nordeste,FIOCRUZ/ASTRAZENECA,1670,1551,119
São Miguel Das Matas,292940,BA,Nordeste,PFIZER/BIONTECH,200,200,0
São Miguel Das Missões,431915,RS,Sul,BUTANTAN/SINOVAC,2539,1301,1238
São Miguel Das Missões,431915,RS,Sul,FIOCRUZ/ASTRAZENECA,1800,1643,157
São Miguel Das Missões,431915,RS,Sul,PFIZER/BIONTECH,282,282,0
São Miguel De Taipu,251500,PB,Nordeste,BUTANTAN/SINOVAC,1344,690,654
São Miguel De Taipu,251500,PB,Nordeste,FIOCRUZ/ASTRAZENECA,1047,967,80
São Miguel De Taipu,251500,PB,Nordeste,PFIZER/BIONTECH,62,62,0
São Miguel Do Aleixo,280700,SE,Nordeste,BUTANTAN/SINOVAC,971,532,439
São Miguel Do Aleixo,280700,SE,Nordeste,FIOCRUZ/ASTRAZENECA,616,616,0
São Miguel Do Aleixo,280700,SE,Nordeste,PFIZER/BIONTECH,65,65,0
São Miguel Do Anta,316380,MG,Sudeste,BUTANTAN/SINOVAC,1654,840,814
São Miguel Do Anta,316380,MG,Sudeste,FIOCRUZ/ASTRAZENECA,1554,1398,156
São Miguel Do Anta,316380,MG,Sudeste,PFIZER/BIONTECH,181,181,0
São Miguel Do Araguaia,522020,GO,Centro-Oeste,FIOCRUZ/ASTRAZENECA,5863,5462,401
São Miguel Do Araguaia,522020,GO,Centro-Oeste,BUTANTAN/SINOVAC,3122,1588,1534
São Miguel Do Fidalgo,221039,PI,Nordeste,BUTANTAN/SINOVAC,487,293,194
São Miguel Do Fidalgo,221039,PI,Nordeste,FIOCRUZ/ASTRAZENECA,399,378,21
São Miguel Do Gostoso,241255,RN,Nordeste,BUTANTAN/SINOVAC,1732,864,868
São Miguel Do Gostoso,241255,RN,Nordeste,FIOCRUZ/ASTRAZENECA,1114,1053,61
São Miguel Do Gostoso,241255,RN,Nordeste,PFIZER/BIONTECH,184,184,0
São Miguel Do Guamá,150760,PA,Norte,FIOCRUZ/ASTRAZENECA,13851,12953,898
São Miguel Do Guamá,150760,PA,Norte,BUTANTAN/SINOVAC,12030,6565,5465
São Miguel Do Guaporé,110032,RO,Norte,BUTANTAN/SINOVAC,2896,1458,1438
São Miguel Do Guaporé,110032,RO,Norte,FIOCRUZ/ASTRAZENECA,1380,1321,59
São Miguel Do Iguaçu,412570,PR,Sul,BUTANTAN/SINOVAC,6736,3436,3300
São Miguel Do Iguaçu,412570,PR,Sul,FIOCRUZ/ASTRAZENECA,5626,5340,286
São Miguel Do Iguaçu,412570,PR,Sul,PFIZER/BIONTECH,419,419,0
São Miguel Do Oeste,421720,SC,Sul,FIOCRUZ/ASTRAZENECA,13093,11480,1613
São Miguel Do Oeste,421720,SC,Sul,BUTANTAN/SINOVAC,8403,4472,3931
São Miguel Do Oeste,421720,SC,Sul,PFIZER/BIONTECH,682,682,0
São Miguel Do Passa Quatro,522026,GO,Centro-Oeste,FIOCRUZ/ASTRAZENECA,1079,999,80
São Miguel Do Passa Quatro,522026,GO,Centro-Oeste,BUTANTAN/SINOVAC,1025,548,477
São Miguel Do Tapuio,221040,PI,Nordeste,BUTANTAN/SINOVAC,2192,1267,925
São Miguel Do Tapuio,221040,PI,Nordeste,FIOCRUZ/ASTRAZENECA,2031,1892,139
São Miguel Do Tocantins,172020,TO,Norte,BUTANTAN/SINOVAC,1726,888,838
São Miguel Do Tocantins,172020,TO,Norte,FIOCRUZ/ASTRAZENECA,1138,1068,70
São Miguel Dos Campos,270860,AL,Nordeste,FIOCRUZ/ASTRAZENECA,9182,8760,422
São Miguel Dos Campos,270860,AL,Nordeste,BUTANTAN/SINOVAC,7531,3889,3642
São Miguel Dos Campos,270860,AL,Nordeste,PFIZER/BIONTECH,3458,3458,0
São Miguel Dos Milagres,270870,AL,Nordeste,BUTANTAN/SINOVAC,1133,635,498
São Miguel Dos Milagres,270870,AL,Nordeste,FIOCRUZ/ASTRAZENECA,1018,913,105
São Nicolau,431920,RS,Sul,BUTANTAN/SINOVAC,1719,859,860
São Nicolau,431920,RS,Sul,FIOCRUZ/ASTRAZENECA,1407,1223,184
São Nicolau,431920,RS,Sul,PFIZER/BIONTECH,186,186,0
São Patrício,522028,GO,Centro-Oeste,FIOCRUZ/ASTRAZENECA,730,703,27
São Patrício,522028,GO,Centro-Oeste,BUTANTAN/SINOVAC,636,406,230
São Patrício,522028,GO,Centro-Oeste,PFIZER/BIONTECH,1,1,0
São Paulo,355030,SP,Sudeste,BUTANTAN/SINOVAC,2787683,1586038,1201645
São Paulo,355030,SP,Sudeste,FIOCRUZ/ASTRAZENECA,2290909,2017453,273456
São Paulo,355030,SP,Sudeste,PFIZER/BIONTECH,836601,835175,1426
São Paulo Das Missões,431930,RS,Sul,BUTANTAN/SINOVAC,2116,1064,1052
São Paulo Das Missões,431930,RS,Sul,FIOCRUZ/ASTRAZENECA,1764,1624,140
São Paulo Das Missões,431930,RS,Sul,PFIZER/BIONTECH,102,102,0
São Paulo De Olivença,130390,AM,Norte,BUTANTAN/SINOVAC,8389,6791,1598
São Paulo De Olivença,130390,AM,Norte,FIOCRUZ/ASTRAZENECA,3460,2852,608
São Paulo Do Potengi,241260,RN,Nordeste,BUTANTAN/SINOVAC,2686,1610,1076
São Paulo Do Potengi,241260,RN,Nordeste,FIOCRUZ/ASTRAZENECA,1928,1698,230
São Paulo Do Potengi,241260,RN,Nordeste,PFIZER/BIONTECH,121,121,0
São Pedro,241270,RN,Nordeste,BUTANTAN/SINOVAC,1364,734,630
São Pedro,241270,RN,Nordeste,FIOCRUZ/ASTRAZENECA,1098,1045,53
São Pedro,241270,RN,Nordeste,PFIZER/BIONTECH,70,70,0
São Pedro,355040,SP,Sudeste,FIOCRUZ/ASTRAZENECA,9556,8798,758
São Pedro,355040,SP,Sudeste,BUTANTAN/SINOVAC,9045,5002,4043
São Pedro,355040,SP,Sudeste,PFIZER/BIONTECH,220,220,0
São Pedro Da Água Branca,211153,MA,Nordeste,BUTANTAN/SINOVAC,1391,718,673
São Pedro Da Água Branca,211153,MA,Nordeste,FIOCRUZ/ASTRAZENECA,1083,1026,57
São Pedro Da Aldeia,330520,RJ,Sudeste,BUTANTAN/SINOVAC,16653,9246,7407
São Pedro Da Aldeia,330520,RJ,Sudeste,FIOCRUZ/ASTRAZENECA,11261,10230,1031
São Pedro Da Cipa,510740,MT,Centro-Oeste,BUTANTAN/SINOVAC,664,342,322
São Pedro Da Cipa,510740,MT,Centro-Oeste,FIOCRUZ/ASTRAZENECA,458,424,34
São Pedro Da Cipa,510740,MT,Centro-Oeste,PFIZER/BIONTECH,23,23,0
São Pedro Da Serra,431935,RS,Sul,BUTANTAN/SINOVAC,880,463,417
São Pedro Da Serra,431935,RS,Sul,FIOCRUZ/ASTRAZENECA,760,736,24
São Pedro Da Serra,431935,RS,Sul,PFIZER/BIONTECH,148,148,0
São Pedro Da União,316390,MG,Sudeste,FIOCRUZ/ASTRAZENECA,1501,1398,103
São Pedro Da União,316390,MG,Sudeste,BUTANTAN/SINOVAC,1314,666,648
São Pedro Da União,316390,MG,Sudeste,PFIZER/BIONTECH,83,83,0
São Pedro Das Missões,431936,RS,Sul,BUTANTAN/SINOVAC,597,304,293
São Pedro Das Missões,431936,RS,Sul,FIOCRUZ/ASTRAZENECA,584,510,74
São Pedro Das Missões,431936,RS,Sul,PFIZER/BIONTECH,97,97,0
São Pedro De Alcântara,421725,SC,Sul,BUTANTAN/SINOVAC,1682,974,708
São Pedro De Alcântara,421725,SC,Sul,FIOCRUZ/ASTRAZENECA,1208,1095,113
São Pedro Do Butiá,431937,RS,Sul,FIOCRUZ/ASTRAZENECA,867,795,72
São Pedro Do Butiá,431937,RS,Sul,BUTANTAN/SINOVAC,816,412,404
São Pedro Do Butiá,431937,RS,Sul,PFIZER/BIONTECH,127,126,1
São Pedro Do Iguaçu,412575,PR,Sul,BUTANTAN/SINOVAC,1797,944,853
São Pedro Do Iguaçu,412575,PR,Sul,FIOCRUZ/ASTRAZENECA,1006,967,39
São Pedro Do Ivaí,412580,PR,Sul,FIOCRUZ/ASTRAZENECA,2468,2284,184
São Pedro Do Ivaí,412580,PR,Sul,BUTANTAN/SINOVAC,2188,1129,1059
São Pedro Do Ivaí,412580,PR,Sul,PFIZER/BIONTECH,59,59,0
São Pedro Do Paraná,412590,PR,Sul,FIOCRUZ/ASTRAZENECA,915,859,56
São Pedro Do Paraná,412590,PR,Sul,BUTANTAN/SINOVAC,701,385,316
São Pedro Do Paraná,412590,PR,Sul,PFIZER/BIONTECH,18,18,0
São Pedro Do Piauí,221050,PI,Nordeste,BUTANTAN/SINOVAC,2013,1219,794
São Pedro Do Piauí,221050,PI,Nordeste,FIOCRUZ/ASTRAZENECA,1772,1714,58
São Pedro Do Piauí,221050,PI,Nordeste,PFIZER/BIONTECH,321,321,0
São Pedro Do Suaçuí,316410,MG,Sudeste,BUTANTAN/SINOVAC,1407,727,680
São Pedro Do Suaçuí,316410,MG,Sudeste,FIOCRUZ/ASTRAZENECA,1082,969,113
São Pedro Do Suaçuí,316410,MG,Sudeste,PFIZER/BIONTECH,52,52,0
São Pedro Do Sul,431940,RS,Sul,BUTANTAN/SINOVAC,5317,2721,2596
São Pedro Do Sul,431940,RS,Sul,FIOCRUZ/ASTRAZENECA,4912,4197,715
São Pedro Do Sul,431940,RS,Sul,PFIZER/BIONTECH,336,336,0
São Pedro Do Turvo,355050,SP,Sudeste,BUTANTAN/SINOVAC,2517,1086,1431
São Pedro Do Turvo,355050,SP,Sudeste,FIOCRUZ/ASTRAZENECA,2500,2318,182
São Pedro Do Turvo,355050,SP,Sudeste,PFIZER/BIONTECH,74,74,0
São Pedro Dos Crentes,211157,MA,Nordeste,FIOCRUZ/ASTRAZENECA,893,817,76
São Pedro Dos Crentes,211157,MA,Nordeste,BUTANTAN/SINOVAC,776,432,344
São Pedro Dos Ferros,316400,MG,Sudeste,BUTANTAN/SINOVAC,2116,1191,925
São Pedro Dos Ferros,316400,MG,Sudeste,FIOCRUZ/ASTRAZENECA,1981,1840,141
São Pedro Dos Ferros,316400,MG,Sudeste,PFIZER/BIONTECH,134,133,1
São Rafael,241280,RN,Nordeste,BUTANTAN/SINOVAC,2433,1262,1171
São Rafael,241280,RN,Nordeste,FIOCRUZ/ASTRAZENECA,2100,1971,129
São Rafael,241280,RN,Nordeste,PFIZER/BIONTECH,130,130,0
São Raimundo Das Mangabeiras,211160,MA,Nordeste,FIOCRUZ/ASTRAZENECA,3315,3085,230
São Raimundo Das Mangabeiras,211160,MA,Nordeste,BUTANTAN/SINOVAC,3047,1634,1413
São Raimundo Do Doca Bezerra,211163,MA,Nordeste,FIOCRUZ/ASTRAZENECA,829,768,61
São Raimundo Do Doca Bezerra,211163,MA,Nordeste,BUTANTAN/SINOVAC,629,343,286
São Raimundo Nonato,221060,PI,Nordeste,FIOCRUZ/ASTRAZENECA,8395,8164,231
São Raimundo Nonato,221060,PI,Nordeste,BUTANTAN/SINOVAC,4955,2515,2440
São Raimundo Nonato,221060,PI,Nordeste,PFIZER/BIONTECH,249,249,0
São Roberto,211167,MA,Nordeste,FIOCRUZ/ASTRAZENECA,753,713,40
São Roberto,211167,MA,Nordeste,BUTANTAN/SINOVAC,677,392,285
São Romão,316420,MG,Sudeste,FIOCRUZ/ASTRAZENECA,1964,1846,118
São Romão,316420,MG,Sudeste,BUTANTAN/SINOVAC,1406,728,678
São Romão,316420,MG,Sudeste,PFIZER/BIONTECH,243,243,0
São Roque,355060,SP,Sudeste,BUTANTAN/SINOVAC,18352,10076,8276
São Roque,355060,SP,Sudeste,FIOCRUZ/ASTRAZENECA,17090,15381,1709
São Roque De Minas,316430,MG,Sudeste,BUTANTAN/SINOVAC,1637,826,811
São Roque De Minas,316430,MG,Sudeste,FIOCRUZ/ASTRAZENECA,1228,1099,129
São Roque De Minas,316430,MG,Sudeste,PFIZER/BIONTECH,72,72,0
São Roque Do Canaã,320495,ES,Sudeste,BUTANTAN/SINOVAC,3494,1781,1713
São Roque Do Canaã,320495,ES,Sudeste,FIOCRUZ/ASTRAZENECA,2978,2839,139
São Roque Do Canaã,320495,ES,Sudeste,PFIZER/BIONTECH,506,506,0
São Salvador Do Tocantins,172025,TO,Norte,FIOCRUZ/ASTRAZENECA,792,759,33
São Salvador Do Tocantins,172025,TO,Norte,BUTANTAN/SINOVAC,485,250,235
São Sebastião,270880,AL,Nordeste,FIOCRUZ/ASTRAZENECA,6951,6453,498
São Sebastião,270880,AL,Nordeste,BUTANTAN/SINOVAC,6280,3195,3085
São Sebastião,355070,SP,Sudeste,FIOCRUZ/ASTRAZENECA,18738,17670,1068
São Sebastião,355070,SP,Sudeste,BUTANTAN/SINOVAC,13851,8261,5590
São Sebastião,355070,SP,Sudeste,PFIZER/BIONTECH,1428,1427,1
São Sebastião Da Amoreira,412600,PR,Sul,FIOCRUZ/ASTRAZENECA,2771,2662,109
São Sebastião Da Amoreira,412600,PR,Sul,BUTANTAN/SINOVAC,1910,981,929
São Sebastião Da Bela Vista,316440,MG,Sudeste,FIOCRUZ/ASTRAZENECA,1174,1111,63
São Sebastião Da Bela Vista,316440,MG,Sudeste,BUTANTAN/SINOVAC,1108,564,544
São Sebastião Da Bela Vista,316440,MG,Sudeste,PFIZER/BIONTECH,66,66,0
São Sebastião Da Boa Vista,150770,PA,Norte,FIOCRUZ/ASTRAZENECA,2524,2429,95
São Sebastião Da Boa Vista,150770,PA,Norte,BUTANTAN/SINOVAC,1392,754,638
São Sebastião Da Grama,355080,SP,Sudeste,FIOCRUZ/ASTRAZENECA,3300,2973,327
São Sebastião Da Grama,355080,SP,Sudeste,BUTANTAN/SINOVAC,2810,1378,1432
São Sebastião Da Grama,355080,SP,Sudeste,PFIZER/BIONTECH,126,126,0
São Sebastião Da Vargem Alegre,316443,MG,Sudeste,BUTANTAN/SINOVAC,1014,608,406
São Sebastião Da Vargem Alegre,316443,MG,Sudeste,FIOCRUZ/ASTRAZENECA,812,750,62
São Sebastião Da Vargem Alegre,316443,MG,Sudeste,PFIZER/BIONTECH,61,61,0
São Sebastião De Lagoa De Roça,251510,PB,Nordeste,BUTANTAN/SINOVAC,2753,1494,1259
São Sebastião De Lagoa De Roça,251510,PB,Nordeste,FIOCRUZ/ASTRAZENECA,1095,967,128
São Sebastião Do Alto,330530,RJ,Sudeste,FIOCRUZ/ASTRAZENECA,1198,1187,11
São Sebastião Do Alto,330530,RJ,Sudeste,BUTANTAN/SINOVAC,958,594,364
São Sebastião Do Anta,316447,MG,Sudeste,BUTANTAN/SINOVAC,1090,584,506
São Sebastião Do Anta,316447,MG,Sudeste,FIOCRUZ/ASTRAZENECA,1026,896,130
São Sebastião Do Anta,316447,MG,Sudeste,PFIZER/BIONTECH,87,87,0
São Sebastião Do Caí,431950,RS,Sul,BUTANTAN/SINOVAC,6027,3061,2966
São Sebastião Do Caí,431950,RS,Sul,FIOCRUZ/ASTRAZENECA,5665,5228,437
São Sebastião Do Caí,431950,RS,Sul,PFIZER/BIONTECH,392,392,0
São Sebastião Do Maranhão,316450,MG,Sudeste,BUTANTAN/SINOVAC,1911,986,925
São Sebastião Do Maranhão,316450,MG,Sudeste,FIOCRUZ/ASTRAZENECA,1433,1340,93
São Sebastião Do Maranhão,316450,MG,Sudeste,PFIZER/BIONTECH,87,87,0
São Sebastião Do Oeste,316460,MG,Sudeste,BUTANTAN/SINOVAC,1461,748,713
São Sebastião Do Oeste,316460,MG,Sudeste,FIOCRUZ/ASTRAZENECA,1237,1143,94
São Sebastião Do Oeste,316460,MG,Sudeste,PFIZER/BIONTECH,46,46,0
São Sebastião Do Paraíso,316470,MG,Sudeste,BUTANTAN/SINOVAC,15180,7905,7275
São Sebastião Do Paraíso,316470,MG,Sudeste,FIOCRUZ/ASTRAZENECA,12305,11352,953
São Sebastião Do Paraíso,316470,MG,Sudeste,PFIZER/BIONTECH,519,519,0
São Sebastião Do Passé,292950,BA,Nordeste,BUTANTAN/SINOVAC,7512,3930,3582
São Sebastião Do Passé,292950,BA,Nordeste,FIOCRUZ/ASTRAZENECA,6057,5492,565
São Sebastião Do Passé,292950,BA,Nordeste,PFIZER/BIONTECH,1454,1449,5
São Sebastião Do Rio Preto,316480,MG,Sudeste,BUTANTAN/SINOVAC,643,353,290
São Sebastião Do Rio Preto,316480,MG,Sudeste,FIOCRUZ/ASTRAZENECA,621,561,60
São Sebastião Do Rio Preto,316480,MG,Sudeste,PFIZER/BIONTECH,47,47,0
São Sebastião Do Rio Verde,316490,MG,Sudeste,BUTANTAN/SINOVAC,490,294,196
São Sebastião Do Rio Verde,316490,MG,Sudeste,FIOCRUZ/ASTRAZENECA,360,357,3
São Sebastião Do Tocantins,172030,TO,Norte,BUTANTAN/SINOVAC,763,417,346
São Sebastião Do Tocantins,172030,TO,Norte,FIOCRUZ/ASTRAZENECA,585,544,41
São Sebastião Do Uatumã,130395,AM,Norte,FIOCRUZ/ASTRAZENECA,1529,1322,207
São Sebastião Do Uatumã,130395,AM,Norte,BUTANTAN/SINOVAC,1367,756,611
São Sebastião Do Umbuzeiro,251520,PB,Nordeste,BUTANTAN/SINOVAC,1184,631,553
São Sebastião Do Umbuzeiro,251520,PB,Nordeste,FIOCRUZ/ASTRAZENECA,679,595,84
São Sebastião Do Umbuzeiro,251520,PB,Nordeste,PFIZER/BIONTECH,22,22,0
São Sepé,431960,RS,Sul,BUTANTAN/SINOVAC,6597,3489,3108
São Sepé,431960,RS,Sul,FIOCRUZ/ASTRAZENECA,6051,5540,511
São Sepé,431960,RS,Sul,PFIZER/BIONTECH,256,256,0
São Simão,355090,SP,Sudeste,BUTANTAN/SINOVAC,3538,1845,1693
São Simão,355090,SP,Sudeste,FIOCRUZ/ASTRAZENECA,3209,2869,340
São Simão,355090,SP,Sudeste,PFIZER/BIONTECH,229,229,0
São Simão,522040,GO,Centro-Oeste,FIOCRUZ/ASTRAZENECA,4155,3904,251
São Simão,522040,GO,Centro-Oeste,BUTANTAN/SINOVAC,3081,1570,1511
São Thomé Das Letras,316520,MG,Sudeste,FIOCRUZ/ASTRAZENECA,1502,1391,111
São Thomé Das Letras,316520,MG,Sudeste,BUTANTAN/SINOVAC,964,511,453
São Thomé Das Letras,316520,MG,Sudeste,PFIZER/BIONTECH,78,78,0
São Tiago,316500,MG,Sudeste,BUTANTAN/SINOVAC,2119,1068,1051
São Tiago,316500,MG,Sudeste,FIOCRUZ/ASTRAZENECA,1830,1607,223
São Tiago,316500,MG,Sudeste,PFIZER/BIONTECH,77,77,0
São Tomás De Aquino,316510,MG,Sudeste,BUTANTAN/SINOVAC,1835,927,908
São Tomás De Aquino,316510,MG,Sudeste,FIOCRUZ/ASTRAZENECA,1353,1313,40
São Tomé,241290,RN,Nordeste,FIOCRUZ/ASTRAZENECA,2791,2379,412
São Tomé,241290,RN,Nordeste,BUTANTAN/SINOVAC,2579,1336,1243
São Tomé,241290,RN,Nordeste,PFIZER/BIONTECH,259,259,0
São Tomé,412610,PR,Sul,FIOCRUZ/ASTRAZENECA,1606,1522,84
São Tomé,412610,PR,Sul,BUTANTAN/SINOVAC,1149,598,551
São Tomé,412610,PR,Sul,PFIZER/BIONTECH,30,30,0
São Valentim,431970,RS,Sul,BUTANTAN/SINOVAC,1441,727,714
São Valentim,431970,RS,Sul,FIOCRUZ/ASTRAZENECA,1014,877,137
São Valentim,431970,RS,Sul,PFIZER/BIONTECH,63,62,1
São Valentim Do Sul,431971,RS,Sul,BUTANTAN/SINOVAC,797,424,373
São Valentim Do Sul,431971,RS,Sul,FIOCRUZ/ASTRAZENECA,660,601,59
São Valentim Do Sul,431971,RS,Sul,PFIZER/BIONTECH,99,99,0
São Valério,172049,TO,Norte,BUTANTAN/SINOVAC,926,470,456
São Valério,172049,TO,Norte,FIOCRUZ/ASTRAZENECA,651,619,32
São Valério Do Sul,431973,RS,Sul,BUTANTAN/SINOVAC,2194,1120,1074
São Valério Do Sul,431973,RS,Sul,FIOCRUZ/ASTRAZENECA,348,309,39
São Valério Do Sul,431973,RS,Sul,PFIZER/BIONTECH,70,70,0
São Vendelino,431975,RS,Sul,FIOCRUZ/ASTRAZENECA,634,545,89
São Vendelino,431975,RS,Sul,BUTANTAN/SINOVAC,516,264,252
São Vendelino,431975,RS,Sul,PFIZER/BIONTECH,106,106,0
São Vicente,241300,RN,Nordeste,BUTANTAN/SINOVAC,1436,780,656
São Vicente,241300,RN,Nordeste,FIOCRUZ/ASTRAZENECA,1370,1281,89
São Vicente,241300,RN,Nordeste,PFIZER/BIONTECH,189,189,0
São Vicente,355100,SP,Sudeste,BUTANTAN/SINOVAC,65926,36838,29088
São Vicente,355100,SP,Sudeste,FIOCRUZ/ASTRAZENECA,65707,62083,3624
São Vicente,355100,SP,Sudeste,PFIZER/BIONTECH,1404,1401,3
São Vicente De Minas,316530,MG,Sudeste,BUTANTAN/SINOVAC,1669,839,830
São Vicente De Minas,316530,MG,Sudeste,FIOCRUZ/ASTRAZENECA,1479,1333,146
São Vicente De Minas,316530,MG,Sudeste,PFIZER/BIONTECH,96,96,0
São Vicente Do Sul,431980,RS,Sul,FIOCRUZ/ASTRAZENECA,2465,2274,191
São Vicente Do Sul,431980,RS,Sul,BUTANTAN/SINOVAC,2240,1131,1109
São Vicente Do Sul,431980,RS,Sul,PFIZER/BIONTECH,240,240,0
São Vicente Ferrer,211170,MA,Nordeste,FIOCRUZ/ASTRAZENECA,6137,5820,317
São Vicente Ferrer,211170,MA,Nordeste,BUTANTAN/SINOVAC,2627,1409,1218
São Vicente Férrer,261380,PE,Nordeste,FIOCRUZ/ASTRAZENECA,4615,4287,328
São Vicente Férrer,261380,PE,Nordeste,BUTANTAN/SINOVAC,3250,1700,1550
São Vicente Férrer,261380,PE,Nordeste,PFIZER/BIONTECH,262,262,0
Sapé,251530,PB,Nordeste,BUTANTAN/SINOVAC,13006,7577,5429
Sapé,251530,PB,Nordeste,FIOCRUZ/ASTRAZENECA,7207,6694,513
Sapé,251530,PB,Nordeste,PFIZER/BIONTECH,529,529,0
Sapeaçu,292960,BA,Nordeste,FIOCRUZ/ASTRAZENECA,4393,4002,391
Sapeaçu,292960,BA,Nordeste,BUTANTAN/SINOVAC,3485,1807,1678
Sapeaçu,292960,BA,Nordeste,PFIZER/BIONTECH,775,775,0
Sapezal,510787,MT,Centro-Oeste,FIOCRUZ/ASTRAZENECA,2474,2235,239
Sapezal,510787,MT,Centro-Oeste,BUTANTAN/SINOVAC,1424,743,681
Sapezal,510787,MT,Centro-Oeste,PFIZER/BIONTECH,142,142,0
Sapiranga,431990,RS,Sul,FIOCRUZ/ASTRAZENECA,18735,17696,1039
Sapiranga,431990,RS,Sul,BUTANTAN/SINOVAC,14543,7341,7202
Sapiranga,431990,RS,Sul,PFIZER/BIONTECH,1612,1609,3
Sapopema,412620,PR,Sul,FIOCRUZ/ASTRAZENECA,1746,1645,101
Sapopema,412620,PR,Sul,BUTANTAN/SINOVAC,1498,777,721
Sapopema,412620,PR,Sul,PFIZER/BIONTECH,1,1,0
Sapucaí-Mirim,316540,MG,Sudeste,BUTANTAN/SINOVAC,1243,631,612
Sapucaí-Mirim,316540,MG,Sudeste,FIOCRUZ/ASTRAZENECA,1157,1080,77
Sapucaí-Mirim,316540,MG,Sudeste,PFIZER/BIONTECH,26,26,0
Sapucaia,150775,PA,Norte,FIOCRUZ/ASTRAZENECA,932,795,137
Sapucaia,150775,PA,Norte,BUTANTAN/SINOVAC,782,433,349
Sapucaia,330540,RJ,Sudeste,BUTANTAN/SINOVAC,4266,2223,2043
Sapucaia,330540,RJ,Sudeste,FIOCRUZ/ASTRAZENECA,3768,3447,321
Sapucaia Do Sul,432000,RS,Sul,FIOCRUZ/ASTRAZENECA,32264,30597,1667
Sapucaia Do Sul,432000,RS,Sul,BUTANTAN/SINOVAC,31603,16535,15068
Sapucaia Do Sul,432000,RS,Sul,PFIZER/BIONTECH,1114,1114,0
Saquarema,330550,RJ,Sudeste,BUTANTAN/SINOVAC,19558,10400,9158
Saquarema,330550,RJ,Sudeste,FIOCRUZ/ASTRAZENECA,15068,14131,937
Sarandi,412625,PR,Sul,FIOCRUZ/ASTRAZENECA,19221,18331,890
Sarandi,412625,PR,Sul,BUTANTAN/SINOVAC,14242,7624,6618
Sarandi,412625,PR,Sul,PFIZER/BIONTECH,653,653,0
Sarandi,432010,RS,Sul,BUTANTAN/SINOVAC,5597,2912,2685
Sarandi,432010,RS,Sul,FIOCRUZ/ASTRAZENECA,4710,4320,390
Sarandi,432010,RS,Sul,PFIZER/BIONTECH,219,219,0
Sarapuí,355110,SP,Sudeste,BUTANTAN/SINOVAC,2077,1122,955
Sarapuí,355110,SP,Sudeste,FIOCRUZ/ASTRAZENECA,1866,1734,132
Sarapuí,355110,SP,Sudeste,PFIZER/BIONTECH,117,117,0
Sardoá,316550,MG,Sudeste,BUTANTAN/SINOVAC,1204,608,596
Sardoá,316550,MG,Sudeste,FIOCRUZ/ASTRAZENECA,929,779,150
Sardoá,316550,MG,Sudeste,PFIZER/BIONTECH,66,65,1
Sarutaiá,355120,SP,Sudeste,BUTANTAN/SINOVAC,929,447,482
Sarutaiá,355120,SP,Sudeste,FIOCRUZ/ASTRAZENECA,891,802,89
Sarutaiá,355120,SP,Sudeste,PFIZER/BIONTECH,121,121,0
Sarzedo,316553,MG,Sudeste,BUTANTAN/SINOVAC,4727,2600,2127
Sarzedo,316553,MG,Sudeste,FIOCRUZ/ASTRAZENECA,3630,3187,443
Sátiro Dias,292970,BA,Nordeste,FIOCRUZ/ASTRAZENECA,3188,3046,142
Sátiro Dias,292970,BA,Nordeste,BUTANTAN/SINOVAC,2390,1531,859
Sátiro Dias,292970,BA,Nordeste,PFIZER/BIONTECH,21,21,0
Satuba,270890,AL,Nordeste,FIOCRUZ/ASTRAZENECA,2191,2044,147
Satuba,270890,AL,Nordeste,BUTANTAN/SINOVAC,1833,976,857
Satubinha,211172,MA,Nordeste,FIOCRUZ/ASTRAZENECA,1565,1421,144
Satubinha,211172,MA,Nordeste,BUTANTAN/SINOVAC,1349,775,574
Saubara,292975,BA,Nordeste,BUTANTAN/SINOVAC,2334,1296,1038
Saubara,292975,BA,Nordeste,FIOCRUZ/ASTRAZENECA,2156,2087,69
Saubara,292975,BA,Nordeste,PFIZER/BIONTECH,580,580,0
Saudade Do Iguaçu,412627,PR,Sul,FIOCRUZ/ASTRAZENECA,1469,1385,84
Saudade Do Iguaçu,412627,PR,Sul,BUTANTAN/SINOVAC,1357,719,638
Saudade Do Iguaçu,412627,PR,Sul,PFIZER/BIONTECH,22,22,0
Saudades,421730,SC,Sul,FIOCRUZ/ASTRAZENECA,2247,2016,231
Saudades,421730,SC,Sul,BUTANTAN/SINOVAC,1976,1012,964
Saudades,421730,SC,Sul,PFIZER/BIONTECH,226,226,0
Saúde,292980,BA,Nordeste,BUTANTAN/SINOVAC,2209,1236,973
Saúde,292980,BA,Nordeste,FIOCRUZ/ASTRAZENECA,2103,2010,93
Saúde,292980,BA,Nordeste,PFIZER/BIONTECH,46,46,0
Schroeder,421740,SC,Sul,FIOCRUZ/ASTRAZENECA,3332,3141,191
Schroeder,421740,SC,Sul,BUTANTAN/SINOVAC,2430,1375,1055
Schroeder,421740,SC,Sul,PFIZER/BIONTECH,239,239,0
Seabra,292990,BA,Nordeste,BUTANTAN/SINOVAC,8998,4774,4224
Seabra,292990,BA,Nordeste,FIOCRUZ/ASTRAZENECA,8674,7671,1003
Seabra,292990,BA,Nordeste,PFIZER/BIONTECH,622,622,0
Seara,421750,SC,Sul,BUTANTAN/SINOVAC,3511,1860,1651
Seara,421750,SC,Sul,FIOCRUZ/ASTRAZENECA,3479,3272,207
Seara,421750,SC,Sul,PFIZER/BIONTECH,453,453,0
Sebastianópolis Do Sul,355130,SP,Sudeste,FIOCRUZ/ASTRAZENECA,911,808,103
Sebastianópolis Do Sul,355130,SP,Sudeste,BUTANTAN/SINOVAC,894,487,407
Sebastianópolis Do Sul,355130,SP,Sudeste,PFIZER/BIONTECH,88,87,1
Sebastião Barros,221062,PI,Nordeste,BUTANTAN/SINOVAC,752,391,361
Sebastião Barros,221062,PI,Nordeste,FIOCRUZ/ASTRAZENECA,322,291,31
Sebastião Laranjeiras,293000,BA,Nordeste,BUTANTAN/SINOVAC,2210,1113,1097
Sebastião Laranjeiras,293000,BA,Nordeste,FIOCRUZ/ASTRAZENECA,2127,1953,174
Sebastião Laranjeiras,293000,BA,Nordeste,PFIZER/BIONTECH,208,208,0
Sebastião Leal,221063,PI,Nordeste,FIOCRUZ/ASTRAZENECA,854,773,81
Sebastião Leal,221063,PI,Nordeste,BUTANTAN/SINOVAC,726,422,304
Sebastião Leal,221063,PI,Nordeste,PFIZER/BIONTECH,102,102,0
Seberi,432020,RS,Sul,BUTANTAN/SINOVAC,3206,1706,1500
Seberi,432020,RS,Sul,FIOCRUZ/ASTRAZENECA,1689,1596,93
Seberi,432020,RS,Sul,PFIZER/BIONTECH,17,17,0
Sede Nova,432023,RS,Sul,BUTANTAN/SINOVAC,758,389,369
Sede Nova,432023,RS,Sul,FIOCRUZ/ASTRAZENECA,746,670,76
Sede Nova,432023,RS,Sul,PFIZER/BIONTECH,119,119,0
Segredo,432026,RS,Sul,FIOCRUZ/ASTRAZENECA,1799,1676,123
Segredo,432026,RS,Sul,BUTANTAN/SINOVAC,1602,811,791
Segredo,432026,RS,Sul,PFIZER/BIONTECH,196,196,0
Selbach,432030,RS,Sul,BUTANTAN/SINOVAC,1725,920,805
Selbach,432030,RS,Sul,FIOCRUZ/ASTRAZENECA,1538,1381,157
Selbach,432030,RS,Sul,PFIZER/BIONTECH,207,207,0
Selvíria,500780,MS,Centro-Oeste,BUTANTAN/SINOVAC,1915,1009,906
Selvíria,500780,MS,Centro-Oeste,FIOCRUZ/ASTRAZENECA,1644,1462,182
Selvíria,500780,MS,Centro-Oeste,PFIZER/BIONTECH,247,247,0
Sem-Peixe,316556,MG,Sudeste,BUTANTAN/SINOVAC,1119,585,534
Sem-Peixe,316556,MG,Sudeste,FIOCRUZ/ASTRAZENECA,964,867,97
Sem-Peixe,316556,MG,Sudeste,PFIZER/BIONTECH,56,55,1
Sena Madureira,120050,AC,Norte,FIOCRUZ/ASTRAZENECA,8406,7411,995
Sena Madureira,120050,AC,Norte,BUTANTAN/SINOVAC,3686,2002,1684
Sena Madureira,120050,AC,Norte,PFIZER/BIONTECH,340,340,0
Senador Alexandre Costa,211174,MA,Nordeste,FIOCRUZ/ASTRAZENECA,1950,1807,143
Senador Alexandre Costa,211174,MA,Nordeste,BUTANTAN/SINOVAC,1566,815,751
Senador Amaral,316557,MG,Sudeste,FIOCRUZ/ASTRAZENECA,1047,980,67
Senador Amaral,316557,MG,Sudeste,BUTANTAN/SINOVAC,885,450,435
Senador Amaral,316557,MG,Sudeste,PFIZER/BIONTECH,46,46,0
Senador Canedo,522045,GO,Centro-Oeste,FIOCRUZ/ASTRAZENECA,16706,15321,1385
Senador Canedo,522045,GO,Centro-Oeste,BUTANTAN/SINOVAC,14016,7176,6840
Senador Canedo,522045,GO,Centro-Oeste,PFIZER/BIONTECH,1195,1194,1
Senador Cortes,316560,MG,Sudeste,FIOCRUZ/ASTRAZENECA,514,475,39
Senador Cortes,316560,MG,Sudeste,BUTANTAN/SINOVAC,494,252,242
Senador Cortes,316560,MG,Sudeste,PFIZER/BIONTECH,42,42,0
Senador Elói De Souza,241310,RN,Nordeste,BUTANTAN/SINOVAC,495,296,199
Senador Elói De Souza,241310,RN,Nordeste,FIOCRUZ/ASTRAZENECA,327,310,17
Senador Elói De Souza,241310,RN,Nordeste,PFIZER/BIONTECH,22,22,0
Senador Firmino,316570,MG,Sudeste,FIOCRUZ/ASTRAZENECA,2233,2030,203
Senador Firmino,316570,MG,Sudeste,BUTANTAN/SINOVAC,2082,1060,1022
Senador Firmino,316570,MG,Sudeste,PFIZER/BIONTECH,98,98,0
Senador Georgino Avelino,241320,RN,Nordeste,FIOCRUZ/ASTRAZENECA,682,645,37
Senador Georgino Avelino,241320,RN,Nordeste,BUTANTAN/SINOVAC,675,349,326
Senador Georgino Avelino,241320,RN,Nordeste,PFIZER/BIONTECH,147,147,0
Senador Guiomard,120045,AC,Norte,FIOCRUZ/ASTRAZENECA,3907,3534,373
Senador Guiomard,120045,AC,Norte,BUTANTAN/SINOVAC,2334,1262,1072
Senador José Bento,316580,MG,Sudeste,BUTANTAN/SINOVAC,564,286,278
Senador José Bento,316580,MG,Sudeste,FIOCRUZ/ASTRAZENECA,436,401,35
Senador José Bento,316580,MG,Sudeste,PFIZER/BIONTECH,33,33,0
Senador José Porfírio,150780,PA,Norte,FIOCRUZ/ASTRAZENECA,5059,4856,203
Senador José Porfírio,150780,PA,Norte,BUTANTAN/SINOVAC,1090,635,455
Senador La Rocque,211176,MA,Nordeste,FIOCRUZ/ASTRAZENECA,3059,2872,187
Senador La Rocque,211176,MA,Nordeste,BUTANTAN/SINOVAC,2355,1277,1078
Senador Modestino Gonçalves,316590,MG,Sudeste,BUTANTAN/SINOVAC,1071,544,527
Senador Modestino Gonçalves,316590,MG,Sudeste,FIOCRUZ/ASTRAZENECA,988,921,67
Senador Modestino Gonçalves,316590,MG,Sudeste,PFIZER/BIONTECH,48,48,0
Senador Pompeu,231270,CE,Nordeste,BUTANTAN/SINOVAC,6393,3525,2868
Senador Pompeu,231270,CE,Nordeste,FIOCRUZ/ASTRAZENECA,3529,2937,592
Senador Rui Palmeira,270895,AL,Nordeste,FIOCRUZ/ASTRAZENECA,2228,2054,174
Senador Rui Palmeira,270895,AL,Nordeste,BUTANTAN/SINOVAC,1613,836,777
Senador Sá,231280,CE,Nordeste,BUTANTAN/SINOVAC,1115,533,582
Senador Sá,231280,CE,Nordeste,FIOCRUZ/ASTRAZENECA,457,385,72
Senador Salgado Filho,432032,RS,Sul,FIOCRUZ/ASTRAZENECA,827,732,95
Senador Salgado Filho,432032,RS,Sul,BUTANTAN/SINOVAC,790,402,388
Senador Salgado Filho,432032,RS,Sul,PFIZER/BIONTECH,123,123,0
Sengés,412630,PR,Sul,FIOCRUZ/ASTRAZENECA,3554,3394,160
Sengés,412630,PR,Sul,BUTANTAN/SINOVAC,2515,1308,1207
Sengés,412630,PR,Sul,PFIZER/BIONTECH,151,151,0
Senhor Do Bonfim,293010,BA,Nordeste,FIOCRUZ/ASTRAZENECA,33706,31409,2297
Senhor Do Bonfim,293010,BA,Nordeste,BUTANTAN/SINOVAC,13686,7064,6622
Senhor Do Bonfim,293010,BA,Nordeste,PFIZER/BIONTECH,170,169,1
Senhora De Oliveira,316600,MG,Sudeste,BUTANTAN/SINOVAC,1322,658,664
Senhora De Oliveira,316600,MG,Sudeste,FIOCRUZ/ASTRAZENECA,1020,868,152
Senhora De Oliveira,316600,MG,Sudeste,PFIZER/BIONTECH,21,21,0
Senhora Do Porto,316610,MG,Sudeste,BUTANTAN/SINOVAC,740,434,306
Senhora Do Porto,316610,MG,Sudeste,FIOCRUZ/ASTRAZENECA,228,204,24
Senhora Do Porto,316610,MG,Sudeste,PFIZER/BIONTECH,2,2,0
Senhora Dos Remédios,316620,MG,Sudeste,BUTANTAN/SINOVAC,2052,1108,944
Senhora Dos Remédios,316620,MG,Sudeste,FIOCRUZ/ASTRAZENECA,1880,1533,347
Senhora Dos Remédios,316620,MG,Sudeste,PFIZER/BIONTECH,122,122,0
Sentinela Do Sul,432035,RS,Sul,BUTANTAN/SINOVAC,1633,863,770
Sentinela Do Sul,432035,RS,Sul,FIOCRUZ/ASTRAZENECA,1562,1437,125
Sentinela Do Sul,432035,RS,Sul,PFIZER/BIONTECH,99,99,0
Sento Sé,293020,BA,Nordeste,FIOCRUZ/ASTRAZENECA,7544,6777,767
Sento Sé,293020,BA,Nordeste,BUTANTAN/SINOVAC,5465,2900,2565
Sento Sé,293020,BA,Nordeste,PFIZER/BIONTECH,159,159,0
Serafina Corrêa,432040,RS,Sul,FIOCRUZ/ASTRAZENECA,4585,4084,501
Serafina Corrêa,432040,RS,Sul,BUTANTAN/SINOVAC,3598,1808,1790
Serafina Corrêa,432040,RS,Sul,PFIZER/BIONTECH,569,568,1
Sericita,316630,MG,Sudeste,BUTANTAN/SINOVAC,1404,708,696
Sericita,316630,MG,Sudeste,FIOCRUZ/ASTRAZENECA,1146,1057,89
Sericita,316630,MG,Sudeste,PFIZER/BIONTECH,23,23,0
Seridó,251540,PB,Nordeste,BUTANTAN/SINOVAC,1835,952,883
Seridó,251540,PB,Nordeste,FIOCRUZ/ASTRAZENECA,1233,1105,128
Seridó,251540,PB,Nordeste,PFIZER/BIONTECH,60,60,0
Seringueiras,110150,RO,Norte,BUTANTAN/SINOVAC,1656,905,751
Seringueiras,110150,RO,Norte,FIOCRUZ/ASTRAZENECA,1331,1283,48
Seringueiras,110150,RO,Norte,PFIZER/BIONTECH,32,32,0
Sério,432045,RS,Sul,BUTANTAN/SINOVAC,665,334,331
Sério,432045,RS,Sul,FIOCRUZ/ASTRAZENECA,600,534,66
Sério,432045,RS,Sul,PFIZER/BIONTECH,64,64,0
Seritinga,316640,MG,Sudeste,BUTANTAN/SINOVAC,578,293,285
Seritinga,316640,MG,Sudeste,FIOCRUZ/ASTRAZENECA,485,438,47
Seritinga,316640,MG,Sudeste,PFIZER/BIONTECH,55,55,0
Seropédica,330555,RJ,Sudeste,BUTANTAN/SINOVAC,17169,9436,7733
Seropédica,330555,RJ,Sudeste,FIOCRUZ/ASTRAZENECA,7947,6793,1154
Seropédica,330555,RJ,Sudeste,PFIZER/BIONTECH,1291,1268,23
Serra,320500,ES,Sudeste,FIOCRUZ/ASTRAZENECA,99548,91993,7555
Serra,320500,ES,Sudeste,BUTANTAN/SINOVAC,93858,47831,46027
Serra,320500,ES,Sudeste,PFIZER/BIONTECH,7734,7724,10
Serra Alta,421755,SC,Sul,FIOCRUZ/ASTRAZENECA,978,873,105
Serra Alta,421755,SC,Sul,BUTANTAN/SINOVAC,788,398,390
Serra Azul,355140,SP,Sudeste,FIOCRUZ/ASTRAZENECA,2858,2617,241
Serra Azul,355140,SP,Sudeste,BUTANTAN/SINOVAC,2686,1298,1388
Serra Azul,355140,SP,Sudeste,PFIZER/BIONTECH,212,212,0
Serra Azul De Minas,316650,MG,Sudeste,BUTANTAN/SINOVAC,78,52,26
Serra Azul De Minas,316650,MG,Sudeste,FIOCRUZ/ASTRAZENECA,45,45,0
Serra Branca,251550,PB,Nordeste,BUTANTAN/SINOVAC,3398,1912,1486
Serra Branca,251550,PB,Nordeste,FIOCRUZ/ASTRAZENECA,3236,3011,225
Serra Branca,251550,PB,Nordeste,PFIZER/BIONTECH,35,35,0
Serra Caiada,241030,RN,Nordeste,FIOCRUZ/ASTRAZENECA,1713,1623,90
Serra Caiada,241030,RN,Nordeste,BUTANTAN/SINOVAC,1418,706,712
Serra Caiada,241030,RN,Nordeste,PFIZER/BIONTECH,173,173,0
Serra Da Raiz,251560,PB,Nordeste,BUTANTAN/SINOVAC,891,467,424
Serra Da Raiz,251560,PB,Nordeste,FIOCRUZ/ASTRAZENECA,698,625,73
Serra Da Raiz,251560,PB,Nordeste,PFIZER/BIONTECH,18,18,0
Serra Da Saudade,316660,MG,Sudeste,BUTANTAN/SINOVAC,318,164,154
Serra Da Saudade,316660,MG,Sudeste,FIOCRUZ/ASTRAZENECA,264,218,46
Serra Da Saudade,316660,MG,Sudeste,PFIZER/BIONTECH,23,23,0
Serra De São Bento,241330,RN,Nordeste,BUTANTAN/SINOVAC,1477,863,614
Serra De São Bento,241330,RN,Nordeste,FIOCRUZ/ASTRAZENECA,868,807,61
Serra De São Bento,241330,RN,Nordeste,PFIZER/BIONTECH,120,120,0
Serra Do Mel,241335,RN,Nordeste,FIOCRUZ/ASTRAZENECA,1744,1654,90
Serra Do Mel,241335,RN,Nordeste,BUTANTAN/SINOVAC,1741,876,865
Serra Do Mel,241335,RN,Nordeste,PFIZER/BIONTECH,231,231,0
Serra Do Navio,160005,AP,Norte,FIOCRUZ/ASTRAZENECA,760,751,9
Serra Do Navio,160005,AP,Norte,BUTANTAN/SINOVAC,740,376,364
Serra Do Ramalho,293015,BA,Nordeste,BUTANTAN/SINOVAC,4658,2985,1673
Serra Do Ramalho,293015,BA,Nordeste,FIOCRUZ/ASTRAZENECA,2546,2463,83
Serra Do Ramalho,293015,BA,Nordeste,PFIZER/BIONTECH,324,324,0
Serra Do Salitre,316680,MG,Sudeste,FIOCRUZ/ASTRAZENECA,4190,3265,925
Serra Do Salitre,316680,MG,Sudeste,BUTANTAN/SINOVAC,1926,975,951
Serra Do Salitre,316680,MG,Sudeste,PFIZER/BIONTECH,168,168,0
Serra Dos Aimorés,316670,MG,Sudeste,BUTANTAN/SINOVAC,1893,984,909
Serra Dos Aimorés,316670,MG,Sudeste,FIOCRUZ/ASTRAZENECA,1342,1198,144
Serra Dos Aimorés,316670,MG,Sudeste,PFIZER/BIONTECH,167,167,0
Serra Dourada,293030,BA,Nordeste,BUTANTAN/SINOVAC,3777,2022,1755
Serra Dourada,293030,BA,Nordeste,FIOCRUZ/ASTRAZENECA,3479,3256,223
Serra Dourada,293030,BA,Nordeste,PFIZER/BIONTECH,197,197,0
Serra Grande,251570,PB,Nordeste,BUTANTAN/SINOVAC,726,368,358
Serra Grande,251570,PB,Nordeste,FIOCRUZ/ASTRAZENECA,446,397,49
Serra Grande,251570,PB,Nordeste,PFIZER/BIONTECH,17,17,0
Serra Negra,355160,SP,Sudeste,BUTANTAN/SINOVAC,7743,3947,3796
Serra Negra,355160,SP,Sudeste,FIOCRUZ/ASTRAZENECA,7637,6895,742
Serra Negra,355160,SP,Sudeste,PFIZER/BIONTECH,662,662,0
Serra Negra Do Norte,241340,RN,Nordeste,FIOCRUZ/ASTRAZENECA,1694,1604,90
Serra Negra Do Norte,241340,RN,Nordeste,BUTANTAN/SINOVAC,1465,751,714
Serra Negra Do Norte,241340,RN,Nordeste,PFIZER/BIONTECH,99,99,0
Serra Nova Dourada,510788,MT,Centro-Oeste,FIOCRUZ/ASTRAZENECA,409,367,42
Serra Nova Dourada,510788,MT,Centro-Oeste,BUTANTAN/SINOVAC,360,192,168
Serra Nova Dourada,510788,MT,Centro-Oeste,PFIZER/BIONTECH,30,30,0
Serra Preta,293040,BA,Nordeste,BUTANTAN/SINOVAC,4138,2156,1982
Serra Preta,293040,BA,Nordeste,FIOCRUZ/ASTRAZENECA,3153,2677,476
Serra Preta,293040,BA,Nordeste,PFIZER/BIONTECH,584,584,0
Serra Redonda,251580,PB,Nordeste,FIOCRUZ/ASTRAZENECA,2044,1869,175
Serra Redonda,251580,PB,Nordeste,BUTANTAN/SINOVAC,1880,956,924
Serra Redonda,251580,PB,Nordeste,PFIZER/BIONTECH,125,125,0
Serra Talhada,261390,PE,Nordeste,FIOCRUZ/ASTRAZENECA,18996,17580,1416
Serra Talhada,261390,PE,Nordeste,BUTANTAN/SINOVAC,17691,9215,8476
Serra Talhada,261390,PE,Nordeste,PFIZER/BIONTECH,2747,2747,0
Serrana,355150,SP,Sudeste,BUTANTAN/SINOVAC,6081,3738,2343
Serrana,355150,SP,Sudeste,FIOCRUZ/ASTRAZENECA,638,404,234
Serrana,355150,SP,Sudeste,PFIZER/BIONTECH,54,54,0
Serrania,316690,MG,Sudeste,FIOCRUZ/ASTRAZENECA,1781,1573,208
Serrania,316690,MG,Sudeste,BUTANTAN/SINOVAC,1639,836,803
Serrania,316690,MG,Sudeste,PFIZER/BIONTECH,63,63,0
Serrano Do Maranhão,211178,MA,Nordeste,FIOCRUZ/ASTRAZENECA,4415,4309,106
Serrano Do Maranhão,211178,MA,Nordeste,BUTANTAN/SINOVAC,1273,653,620
Serranópolis,522050,GO,Centro-Oeste,FIOCRUZ/ASTRAZENECA,1628,1516,112
Serranópolis,522050,GO,Centro-Oeste,BUTANTAN/SINOVAC,1273,656,617
Serranópolis De Minas,316695,MG,Sudeste,FIOCRUZ/ASTRAZENECA,1100,1024,76
Serranópolis De Minas,316695,MG,Sudeste,BUTANTAN/SINOVAC,962,497,465
Serranópolis Do Iguaçu,412635,PR,Sul,BUTANTAN/SINOVAC,1334,702,632
Serranópolis Do Iguaçu,412635,PR,Sul,FIOCRUZ/ASTRAZENECA,1215,1131,84
Serranópolis Do Iguaçu,412635,PR,Sul,PFIZER/BIONTECH,11,11,0
Serranos,316700,MG,Sudeste,BUTANTAN/SINOVAC,556,281,275
Serranos,316700,MG,Sudeste,FIOCRUZ/ASTRAZENECA,406,367,39
Serranos,316700,MG,Sudeste,PFIZER/BIONTECH,42,42,0
Serraria,251590,PB,Nordeste,BUTANTAN/SINOVAC,1345,679,666
Serraria,251590,PB,Nordeste,FIOCRUZ/ASTRAZENECA,920,822,98
Serraria,251590,PB,Nordeste,PFIZER/BIONTECH,113,113,0
Serrinha,241350,RN,Nordeste,BUTANTAN/SINOVAC,681,368,313
Serrinha,241350,RN,Nordeste,FIOCRUZ/ASTRAZENECA,262,241,21
Serrinha,241350,RN,Nordeste,PFIZER/BIONTECH,18,18,0
Serrinha,293050,BA,Nordeste,FIOCRUZ/ASTRAZENECA,14927,13641,1286
Serrinha,293050,BA,Nordeste,BUTANTAN/SINOVAC,13218,6685,6533
Serrinha,293050,BA,Nordeste,PFIZER/BIONTECH,1205,1203,2
Serrinha Dos Pintos,241355,RN,Nordeste,BUTANTAN/SINOVAC,1665,995,670
Serrinha Dos Pintos,241355,RN,Nordeste,FIOCRUZ/ASTRAZENECA,1529,1478,51
Serrinha Dos Pintos,241355,RN,Nordeste,PFIZER/BIONTECH,141,141,0
Serrita,261400,PE,Nordeste,FIOCRUZ/ASTRAZENECA,3524,3155,369
Serrita,261400,PE,Nordeste,BUTANTAN/SINOVAC,3126,1590,1536
Serrita,261400,PE,Nordeste,PFIZER/BIONTECH,528,528,0
Serro,316710,MG,Sudeste,FIOCRUZ/ASTRAZENECA,5590,4732,858
Serro,316710,MG,Sudeste,BUTANTAN/SINOVAC,4085,2128,1957
Serro,316710,MG,Sudeste,PFIZER/BIONTECH,151,151,0
Serrolândia,293060,BA,Nordeste,BUTANTAN/SINOVAC,2781,1543,1238
Serrolândia,293060,BA,Nordeste,FIOCRUZ/ASTRAZENECA,2658,2275,383
Serrolândia,293060,BA,Nordeste,PFIZER/BIONTECH,311,309,2
Sertaneja,412640,PR,Sul,FIOCRUZ/ASTRAZENECA,2208,2092,116
Sertaneja,412640,PR,Sul,BUTANTAN/SINOVAC,1609,825,784
Sertaneja,412640,PR,Sul,PFIZER/BIONTECH,23,23,0
Sertânia,261410,PE,Nordeste,FIOCRUZ/ASTRAZENECA,6855,6198,657
Sertânia,261410,PE,Nordeste,BUTANTAN/SINOVAC,4949,2547,2402
Sertânia,261410,PE,Nordeste,PFIZER/BIONTECH,730,730,0
Sertanópolis,412650,PR,Sul,FIOCRUZ/ASTRAZENECA,4275,3945,330
Sertanópolis,412650,PR,Sul,BUTANTAN/SINOVAC,3754,1884,1870
Sertanópolis,412650,PR,Sul,PFIZER/BIONTECH,185,185,0
Sertão,432050,RS,Sul,FIOCRUZ/ASTRAZENECA,2040,1798,242
Sertão,432050,RS,Sul,BUTANTAN/SINOVAC,1798,907,891
Sertão,432050,RS,Sul,PFIZER/BIONTECH,218,218,0
Sertão Santana,432055,RS,Sul,BUTANTAN/SINOVAC,1988,1059,929
Sertão Santana,432055,RS,Sul,FIOCRUZ/ASTRAZENECA,1711,1590,121
Sertão Santana,432055,RS,Sul,PFIZER/BIONTECH,222,222,0
Sertãozinho,251593,PB,Nordeste,BUTANTAN/SINOVAC,1489,758,731
Sertãozinho,251593,PB,Nordeste,FIOCRUZ/ASTRAZENECA,796,700,96
Sertãozinho,251593,PB,Nordeste,PFIZER/BIONTECH,18,18,0
Sertãozinho,355170,SP,Sudeste,FIOCRUZ/ASTRAZENECA,24181,22490,1691
Sertãozinho,355170,SP,Sudeste,BUTANTAN/SINOVAC,20532,11341,9191
Sertãozinho,355170,SP,Sudeste,PFIZER/BIONTECH,919,917,2
Sete Barras,355180,SP,Sudeste,FIOCRUZ/ASTRAZENECA,4349,4046,303
Sete Barras,355180,SP,Sudeste,BUTANTAN/SINOVAC,3660,1948,1712
Sete Barras,355180,SP,Sudeste,PFIZER/BIONTECH,370,365,5
Sete De Setembro,432057,RS,Sul,BUTANTAN/SINOVAC,728,363,365
Sete De Setembro,432057,RS,Sul,FIOCRUZ/ASTRAZENECA,540,461,79
Sete De Setembro,432057,RS,Sul,PFIZER/BIONTECH,96,96,0
Sete Lagoas,316720,MG,Sudeste,BUTANTAN/SINOVAC,40745,23727,17018
Sete Lagoas,316720,MG,Sudeste,FIOCRUZ/ASTRAZENECA,24532,22883,1649
Sete Lagoas,316720,MG,Sudeste,PFIZER/BIONTECH,1,1,0
Sete Quedas,500770,MS,Centro-Oeste,FIOCRUZ/ASTRAZENECA,3175,2792,383
Sete Quedas,500770,MS,Centro-Oeste,BUTANTAN/SINOVAC,2486,1341,1145
Sete Quedas,500770,MS,Centro-Oeste,PFIZER/BIONTECH,392,392,0
Setubinha,316555,MG,Sudeste,BUTANTAN/SINOVAC,2047,1042,1005
Setubinha,316555,MG,Sudeste,FIOCRUZ/ASTRAZENECA,951,844,107
Setubinha,316555,MG,Sudeste,PFIZER/BIONTECH,54,54,0
Severiano De Almeida,432060,RS,Sul,BUTANTAN/SINOVAC,1543,782,761
Severiano De Almeida,432060,RS,Sul,FIOCRUZ/ASTRAZENECA,1313,1158,155
Severiano De Almeida,432060,RS,Sul,PFIZER/BIONTECH,165,165,0
Severiano Melo,241360,RN,Nordeste,FIOCRUZ/ASTRAZENECA,1448,1430,18
Severiano Melo,241360,RN,Nordeste,BUTANTAN/SINOVAC,408,214,194
Severiano Melo,241360,RN,Nordeste,PFIZER/BIONTECH,72,72,0
Severínia,355190,SP,Sudeste,FIOCRUZ/ASTRAZENECA,6105,5689,416
Severínia,355190,SP,Sudeste,BUTANTAN/SINOVAC,4981,2606,2375
Severínia,355190,SP,Sudeste,PFIZER/BIONTECH,195,193,2
Siderópolis,421760,SC,Sul,BUTANTAN/SINOVAC,2827,1530,1297
Siderópolis,421760,SC,Sul,FIOCRUZ/ASTRAZENECA,2819,2573,246
Siderópolis,421760,SC,Sul,PFIZER/BIONTECH,144,144,0
Sidrolândia,500790,MS,Centro-Oeste,BUTANTAN/SINOVAC,10601,5616,4985
Sidrolândia,500790,MS,Centro-Oeste,FIOCRUZ/ASTRAZENECA,6207,5671,536
Sidrolândia,500790,MS,Centro-Oeste,PFIZER/BIONTECH,610,610,0
Sigefredo Pacheco,221065,PI,Nordeste,BUTANTAN/SINOVAC,1760,917,843
Sigefredo Pacheco,221065,PI,Nordeste,FIOCRUZ/ASTRAZENECA,1463,1359,104
Silva Jardim,330560,RJ,Sudeste,BUTANTAN/SINOVAC,4953,2606,2347
Silva Jardim,330560,RJ,Sudeste,FIOCRUZ/ASTRAZENECA,3895,3435,460
Silva Jardim,330560,RJ,Sudeste,PFIZER/BIONTECH,332,332,0
Silvânia,522060,GO,Centro-Oeste,BUTANTAN/SINOVAC,5026,2679,2347
Silvânia,522060,GO,Centro-Oeste,FIOCRUZ/ASTRAZENECA,4687,4334,353
Silvanópolis,172065,TO,Norte,BUTANTAN/SINOVAC,1318,676,642
Silvanópolis,172065,TO,Norte,FIOCRUZ/ASTRAZENECA,851,781,70
Silveira Martins,432065,RS,Sul,BUTANTAN/SINOVAC,926,473,453
Silveira Martins,432065,RS,Sul,FIOCRUZ/ASTRAZENECA,707,623,84
Silveira Martins,432065,RS,Sul,PFIZER/BIONTECH,103,103,0
Silveirânia,316730,MG,Sudeste,FIOCRUZ/ASTRAZENECA,945,881,64
Silveirânia,316730,MG,Sudeste,BUTANTAN/SINOVAC,567,301,266
Silveirânia,316730,MG,Sudeste,PFIZER/BIONTECH,47,47,0
Silveiras,355200,SP,Sudeste,FIOCRUZ/ASTRAZENECA,1626,1500,126
Silveiras,355200,SP,Sudeste,BUTANTAN/SINOVAC,1524,784,740
Silveiras,355200,SP,Sudeste,PFIZER/BIONTECH,150,150,0
Silves,130400,AM,Norte,FIOCRUZ/ASTRAZENECA,4380,4213,167
Silves,130400,AM,Norte,BUTANTAN/SINOVAC,1779,1040,739
Silvianópolis,316740,MG,Sudeste,BUTANTAN/SINOVAC,1844,939,905
Silvianópolis,316740,MG,Sudeste,FIOCRUZ/ASTRAZENECA,1017,909,108
Silvianópolis,316740,MG,Sudeste,PFIZER/BIONTECH,44,44,0
Simão Dias,280710,SE,Nordeste,BUTANTAN/SINOVAC,6978,3920,3058
Simão Dias,280710,SE,Nordeste,FIOCRUZ/ASTRAZENECA,6221,5732,489
Simão Dias,280710,SE,Nordeste,PFIZER/BIONTECH,39,39,0
Simão Pereira,316750,MG,Sudeste,BUTANTAN/SINOVAC,748,390,358
Simão Pereira,316750,MG,Sudeste,FIOCRUZ/ASTRAZENECA,715,633,82
Simão Pereira,316750,MG,Sudeste,PFIZER/BIONTECH,30,30,0
Simões,221070,PI,Nordeste,FIOCRUZ/ASTRAZENECA,3117,2382,735
Simões,221070,PI,Nordeste,BUTANTAN/SINOVAC,2208,1173,1035
Simões,221070,PI,Nordeste,PFIZER/BIONTECH,126,126,0
Simões Filho,293070,BA,Nordeste,BUTANTAN/SINOVAC,8307,5219,3088
Simões Filho,293070,BA,Nordeste,FIOCRUZ/ASTRAZENECA,6071,5752,319
Simões Filho,293070,BA,Nordeste,PFIZER/BIONTECH,1141,1141,0
Simolândia,522068,GO,Centro-Oeste,FIOCRUZ/ASTRAZENECA,2086,1973,113
Simolândia,522068,GO,Centro-Oeste,BUTANTAN/SINOVAC,584,374,210
Simonésia,316760,MG,Sudeste,FIOCRUZ/ASTRAZENECA,3000,2814,186
Simonésia,316760,MG,Sudeste,BUTANTAN/SINOVAC,2548,1342,1206
Simonésia,316760,MG,Sudeste,PFIZER/BIONTECH,139,139,0
Simplício Mendes,221080,PI,Nordeste,BUTANTAN/SINOVAC,3075,1560,1515
Simplício Mendes,221080,PI,Nordeste,FIOCRUZ/ASTRAZENECA,2526,2413,113
Sinimbu,432067,RS,Sul,BUTANTAN/SINOVAC,2788,1456,1332
Sinimbu,432067,RS,Sul,FIOCRUZ/ASTRAZENECA,2489,2262,227
Sinimbu,432067,RS,Sul,PFIZER/BIONTECH,337,337,0
Sinop,510790,MT,Centro-Oeste,FIOCRUZ/ASTRAZENECA,20758,18934,1824
Sinop,510790,MT,Centro-Oeste,BUTANTAN/SINOVAC,18418,9479,8939
Sinop,510790,MT,Centro-Oeste,PFIZER/BIONTECH,1461,1461,0
Siqueira Campos,412660,PR,Sul,FIOCRUZ/ASTRAZENECA,4471,4178,293
Siqueira Campos,412660,PR,Sul,BUTANTAN/SINOVAC,3945,2019,1926
Siqueira Campos,412660,PR,Sul,PFIZER/BIONTECH,180,180,0
Sirinhaém,261420,PE,Nordeste,BUTANTAN/SINOVAC,5837,3048,2789
Sirinhaém,261420,PE,Nordeste,FIOCRUZ/ASTRAZENECA,5172,4680,492
Sirinhaém,261420,PE,Nordeste,PFIZER/BIONTECH,466,464,2
Siriri,280720,SE,Nordeste,BUTANTAN/SINOVAC,1875,956,919
Siriri,280720,SE,Nordeste,FIOCRUZ/ASTRAZENECA,1381,1381,0
Siriri,280720,SE,Nordeste,PFIZER/BIONTECH,178,178,0
Sítio D'Abadia,522070,GO,Centro-Oeste,FIOCRUZ/ASTRAZENECA,932,757,175
Sítio D'Abadia,522070,GO,Centro-Oeste,BUTANTAN/SINOVAC,246,147,99
Sítio Do Mato,293075,BA,Nordeste,FIOCRUZ/ASTRAZENECA,2435,2269,166
Sítio Do Mato,293075,BA,Nordeste,BUTANTAN/SINOVAC,1768,929,839
Sítio Do Mato,293075,BA,Nordeste,PFIZER/BIONTECH,205,205,0
Sítio Do Quinto,293076,BA,Nordeste,BUTANTAN/SINOVAC,2924,1767,1157
Sítio Do Quinto,293076,BA,Nordeste,FIOCRUZ/ASTRAZENECA,1647,1538,109
Sítio Do Quinto,293076,BA,Nordeste,PFIZER/BIONTECH,18,18,0
Sítio Novo,211180,MA,Nordeste,FIOCRUZ/ASTRAZENECA,2505,2327,178
Sítio Novo,211180,MA,Nordeste,BUTANTAN/SINOVAC,2108,1105,1003
Sítio Novo,241370,RN,Nordeste,BUTANTAN/SINOVAC,1338,753,585
Sítio Novo,241370,RN,Nordeste,FIOCRUZ/ASTRAZENECA,752,660,92
Sítio Novo,241370,RN,Nordeste,PFIZER/BIONTECH,140,140,0
Sítio Novo Do Tocantins,172080,TO,Norte,FIOCRUZ/ASTRAZENECA,2014,1932,82
Sítio Novo Do Tocantins,172080,TO,Norte,BUTANTAN/SINOVAC,1818,960,858
Sobradinho,293077,BA,Nordeste,BUTANTAN/SINOVAC,4927,2570,2357
Sobradinho,293077,BA,Nordeste,FIOCRUZ/ASTRAZENECA,4886,4385,501
Sobradinho,293077,BA,Nordeste,PFIZER/BIONTECH,114,114,0
Sobradinho,432070,RS,Sul,BUTANTAN/SINOVAC,4020,2034,1986
Sobradinho,432070,RS,Sul,FIOCRUZ/ASTRAZENECA,3810,3388,422
Sobradinho,432070,RS,Sul,PFIZER/BIONTECH,482,478,4
Sobrado,251597,PB,Nordeste,BUTANTAN/SINOVAC,1592,848,744
Sobrado,251597,PB,Nordeste,FIOCRUZ/ASTRAZENECA,984,897,87
Sobrado,251597,PB,Nordeste,PFIZER/BIONTECH,39,39,0
Sobral,231290,CE,Nordeste,FIOCRUZ/ASTRAZENECA,52071,49875,2196
Sobral,231290,CE,Nordeste,BUTANTAN/SINOVAC,43620,22501,21119
Sobral,231290,CE,Nordeste,PFIZER/BIONTECH,6447,6447,0
Sobrália,316770,MG,Sudeste,BUTANTAN/SINOVAC,1537,784,753
Sobrália,316770,MG,Sudeste,FIOCRUZ/ASTRAZENECA,1111,991,120
Sobrália,316770,MG,Sudeste,PFIZER/BIONTECH,143,143,0
Socorro,355210,SP,Sudeste,BUTANTAN/SINOVAC,10946,5862,5084
Socorro,355210,SP,Sudeste,FIOCRUZ/ASTRAZENECA,8100,7312,788
Socorro,355210,SP,Sudeste,PFIZER/BIONTECH,1031,1031,0
Socorro Do Piauí,221090,PI,Nordeste,FIOCRUZ/ASTRAZENECA,1082,1008,74
Socorro Do Piauí,221090,PI,Nordeste,BUTANTAN/SINOVAC,898,459,439
Solânea,251600,PB,Nordeste,BUTANTAN/SINOVAC,7519,4293,3226
Solânea,251600,PB,Nordeste,FIOCRUZ/ASTRAZENECA,1878,1486,392
Solânea,251600,PB,Nordeste,PFIZER/BIONTECH,18,18,0
Soledade,251610,PB,Nordeste,BUTANTAN/SINOVAC,3279,1652,1627
Soledade,251610,PB,Nordeste,FIOCRUZ/ASTRAZENECA,2658,2382,276
Soledade,251610,PB,Nordeste,PFIZER/BIONTECH,375,375,0
Soledade,432080,RS,Sul,FIOCRUZ/ASTRAZENECA,7957,7350,607
Soledade,432080,RS,Sul,BUTANTAN/SINOVAC,7289,3840,3449
Soledade,432080,RS,Sul,PFIZER/BIONTECH,933,933,0
Soledade De Minas,316780,MG,Sudeste,BUTANTAN/SINOVAC,964,570,394
Soledade De Minas,316780,MG,Sudeste,FIOCRUZ/ASTRAZENECA,501,471,30
Solidão,261440,PE,Nordeste,FIOCRUZ/ASTRAZENECA,1382,1291,91
Solidão,261440,PE,Nordeste,BUTANTAN/SINOVAC,1215,621,594
Solidão,261440,PE,Nordeste,PFIZER/BIONTECH,239,239,0
Solonópole,231300,CE,Nordeste,BUTANTAN/SINOVAC,3053,1742,1311
Solonópole,231300,CE,Nordeste,FIOCRUZ/ASTRAZENECA,989,878,111
Sombrio,421770,SC,Sul,BUTANTAN/SINOVAC,4041,2309,1732
Sombrio,421770,SC,Sul,FIOCRUZ/ASTRAZENECA,3482,3135,347
Sonora,500793,MS,Centro-Oeste,FIOCRUZ/ASTRAZENECA,3504,3171,333
Sonora,500793,MS,Centro-Oeste,BUTANTAN/SINOVAC,1854,1203,651
Sonora,500793,MS,Centro-Oeste,PFIZER/BIONTECH,619,618,1
Sooretama,320501,ES,Sudeste,BUTANTAN/SINOVAC,4623,2401,2222
Sooretama,320501,ES,Sudeste,FIOCRUZ/ASTRAZENECA,3952,3837,115
Sooretama,320501,ES,Sudeste,PFIZER/BIONTECH,755,753,2
Sorocaba,355220,SP,Sudeste,BUTANTAN/SINOVAC,124578,68005,56573
Sorocaba,355220,SP,Sudeste,FIOCRUZ/ASTRAZENECA,94746,85482,9264
Sorocaba,355220,SP,Sudeste,PFIZER/BIONTECH,1580,1580,0
Sorriso,510792,MT,Centro-Oeste,FIOCRUZ/ASTRAZENECA,13259,12481,778
Sorriso,510792,MT,Centro-Oeste,BUTANTAN/SINOVAC,9502,4963,4539
Sorriso,510792,MT,Centro-Oeste,PFIZER/BIONTECH,1183,1182,1
Sossêgo,251615,PB,Nordeste,BUTANTAN/SINOVAC,790,399,391
Sossêgo,251615,PB,Nordeste,FIOCRUZ/ASTRAZENECA,650,585,65
Sossêgo,251615,PB,Nordeste,PFIZER/BIONTECH,54,54,0
Soure,150790,PA,Norte,FIOCRUZ/ASTRAZENECA,5937,4299,1638
Soure,150790,PA,Norte,BUTANTAN/SINOVAC,2353,1321,1032
Sousa,251620,PB,Nordeste,BUTANTAN/SINOVAC,16988,9044,7944
Sousa,251620,PB,Nordeste,FIOCRUZ/ASTRAZENECA,12343,11459,884
Sousa,251620,PB,Nordeste,PFIZER/BIONTECH,1743,1743,0
Souto Soares,293080,BA,Nordeste,FIOCRUZ/ASTRAZENECA,4575,3776,799
Souto Soares,293080,BA,Nordeste,BUTANTAN/SINOVAC,3509,2001,1508
Souto Soares,293080,BA,Nordeste,PFIZER/BIONTECH,217,216,1
Sucupira,172085,TO,Norte,FIOCRUZ/ASTRAZENECA,377,367,10
Sucupira,172085,TO,Norte,BUTANTAN/SINOVAC,337,201,136
Sucupira Do Norte,211190,MA,Nordeste,FIOCRUZ/ASTRAZENECA,1704,1563,141
Sucupira Do Norte,211190,MA,Nordeste,BUTANTAN/SINOVAC,1631,848,783
Sucupira Do Riachão,211195,MA,Nordeste,FIOCRUZ/ASTRAZENECA,1320,1240,80
Sucupira Do Riachão,211195,MA,Nordeste,BUTANTAN/SINOVAC,1020,549,471
Sud Mennucci,355230,SP,Sudeste,BUTANTAN/SINOVAC,2048,1080,968
Sud Mennucci,355230,SP,Sudeste,FIOCRUZ/ASTRAZENECA,2029,1852,177
Sud Mennucci,355230,SP,Sudeste,PFIZER/BIONTECH,103,103,0
Sul Brasil,421775,SC,Sul,FIOCRUZ/ASTRAZENECA,812,737,75
Sul Brasil,421775,SC,Sul,BUTANTAN/SINOVAC,689,350,339
Sulina,412665,PR,Sul,FIOCRUZ/ASTRAZENECA,1358,1306,52
Sulina,412665,PR,Sul,BUTANTAN/SINOVAC,847,433,414
Sumaré,355240,SP,Sudeste,FIOCRUZ/ASTRAZENECA,45786,43442,2344
Sumaré,355240,SP,Sudeste,BUTANTAN/SINOVAC,42473,23361,19112
Sumaré,355240,SP,Sudeste,PFIZER/BIONTECH,904,904,0
Sumé,251630,PB,Nordeste,BUTANTAN/SINOVAC,4311,2173,2138
Sumé,251630,PB,Nordeste,FIOCRUZ/ASTRAZENECA,3440,3088,352
Sumé,251630,PB,Nordeste,PFIZER/BIONTECH,398,398,0
Sumidouro,330570,RJ,Sudeste,FIOCRUZ/ASTRAZENECA,3622,3288,334
Sumidouro,330570,RJ,Sudeste,BUTANTAN/SINOVAC,3409,1791,1618
Surubim,261450,PE,Nordeste,FIOCRUZ/ASTRAZENECA,13408,12363,1045
Surubim,261450,PE,Nordeste,BUTANTAN/SINOVAC,11571,5905,5666
Surubim,261450,PE,Nordeste,PFIZER/BIONTECH,1618,1616,2
Sussuapara,221093,PI,Nordeste,FIOCRUZ/ASTRAZENECA,1319,1129,190
Sussuapara,221093,PI,Nordeste,BUTANTAN/SINOVAC,1300,664,636
Suzanápolis,355255,SP,Sudeste,FIOCRUZ/ASTRAZENECA,1259,1164,95
Suzanápolis,355255,SP,Sudeste,BUTANTAN/SINOVAC,1045,537,508
Suzanápolis,355255,SP,Sudeste,PFIZER/BIONTECH,97,96,1
Suzano,355250,SP,Sudeste,BUTANTAN/SINOVAC,45195,24029,21166
Suzano,355250,SP,Sudeste,FIOCRUZ/ASTRAZENECA,42713,40575,2138
Suzano,355250,SP,Sudeste,PFIZER/BIONTECH,4628,4623,5
Tabaí,432085,RS,Sul,FIOCRUZ/ASTRAZENECA,1072,1029,43
Tabaí,432085,RS,Sul,BUTANTAN/SINOVAC,1026,558,468
Tabaí,432085,RS,Sul,PFIZER/BIONTECH,60,60,0
Tabaporã,510794,MT,Centro-Oeste,BUTANTAN/SINOVAC,1229,655,574
Tabaporã,510794,MT,Centro-Oeste,FIOCRUZ/ASTRAZENECA,1087,828,259
Tabapuã,355260,SP,Sudeste,BUTANTAN/SINOVAC,2907,1568,1339
Tabapuã,355260,SP,Sudeste,FIOCRUZ/ASTRAZENECA,2906,2619,287
Tabapuã,355260,SP,Sudeste,PFIZER/BIONTECH,130,130,0
Tabatinga,130406,AM,Norte,BUTANTAN/SINOVAC,12653,8489,4164
Tabatinga,130406,AM,Norte,FIOCRUZ/ASTRAZENECA,2713,2417,296
Tabatinga,355270,SP,Sudeste,FIOCRUZ/ASTRAZENECA,3697,3422,275
Tabatinga,355270,SP,Sudeste,BUTANTAN/SINOVAC,3150,1601,1549
Tabatinga,355270,SP,Sudeste,PFIZER/BIONTECH,123,123,0
Tabira,261460,PE,Nordeste,FIOCRUZ/ASTRAZENECA,6199,5643,556
Tabira,261460,PE,Nordeste,BUTANTAN/SINOVAC,5434,2738,2696
Tabira,261460,PE,Nordeste,PFIZER/BIONTECH,932,930,2
Taboão Da Serra,355280,SP,Sudeste,FIOCRUZ/ASTRAZENECA,57420,52859,4561
Taboão Da Serra,355280,SP,Sudeste,BUTANTAN/SINOVAC,51512,27517,23995
Taboão Da Serra,355280,SP,Sudeste,PFIZER/BIONTECH,1880,1880,0
Tabocas Do Brejo Velho,293090,BA,Nordeste,BUTANTAN/SINOVAC,2360,1407,953
Tabocas Do Brejo Velho,293090,BA,Nordeste,FIOCRUZ/ASTRAZENECA,2100,1874,226
Tabocas Do Brejo Velho,293090,BA,Nordeste,PFIZER/BIONTECH,300,300,0
Taboleiro Grande,241380,RN,Nordeste,BUTANTAN/SINOVAC,975,503,472
Taboleiro Grande,241380,RN,Nordeste,FIOCRUZ/ASTRAZENECA,887,870,17
Taboleiro Grande,241380,RN,Nordeste,PFIZER/BIONTECH,83,82,1
Tabuleiro,316790,MG,Sudeste,FIOCRUZ/ASTRAZENECA,1433,1339,94
Tabuleiro,316790,MG,Sudeste,BUTANTAN/SINOVAC,1116,568,548
Tabuleiro,316790,MG,Sudeste,PFIZER/BIONTECH,48,48,0
Tabuleiro Do Norte,231310,CE,Nordeste,BUTANTAN/SINOVAC,5109,2688,2421
Tabuleiro Do Norte,231310,CE,Nordeste,FIOCRUZ/ASTRAZENECA,2622,2430,192
Tacaimbó,261470,PE,Nordeste,FIOCRUZ/ASTRAZENECA,2576,2404,172
Tacaimbó,261470,PE,Nordeste,BUTANTAN/SINOVAC,2182,1208,974
Tacaimbó,261470,PE,Nordeste,PFIZER/BIONTECH,271,271,0
Tacaratu,261480,PE,Nordeste,BUTANTAN/SINOVAC,5346,2800,2546
Tacaratu,261480,PE,Nordeste,FIOCRUZ/ASTRAZENECA,4746,4353,393
Tacaratu,261480,PE,Nordeste,PFIZER/BIONTECH,391,391,0
Taciba,355290,SP,Sudeste,FIOCRUZ/ASTRAZENECA,1712,1590,122
Taciba,355290,SP,Sudeste,BUTANTAN/SINOVAC,1301,665,636
Taciba,355290,SP,Sudeste,PFIZER/BIONTECH,193,193,0
Tacima,251640,PB,Nordeste,BUTANTAN/SINOVAC,1966,1132,834
Tacima,251640,PB,Nordeste,FIOCRUZ/ASTRAZENECA,854,710,144
Tacima,251640,PB,Nordeste,PFIZER/BIONTECH,84,84,0
Tacuru,500795,MS,Centro-Oeste,BUTANTAN/SINOVAC,5447,2814,2633
Tacuru,500795,MS,Centro-Oeste,FIOCRUZ/ASTRAZENECA,2279,2051,228
Tacuru,500795,MS,Centro-Oeste,PFIZER/BIONTECH,287,287,0
Taguaí,355300,SP,Sudeste,FIOCRUZ/ASTRAZENECA,2553,2375,178
Taguaí,355300,SP,Sudeste,BUTANTAN/SINOVAC,2308,1184,1124
Taguaí,355300,SP,Sudeste,PFIZER/BIONTECH,223,223,0
Taguatinga,172090,TO,Norte,BUTANTAN/SINOVAC,2900,1474,1426
Taguatinga,172090,TO,Norte,FIOCRUZ/ASTRAZENECA,2717,2582,135
Taiaçu,355310,SP,Sudeste,BUTANTAN/SINOVAC,1577,888,689
Taiaçu,355310,SP,Sudeste,FIOCRUZ/ASTRAZENECA,1387,1250,137
Taiaçu,355310,SP,Sudeste,PFIZER/BIONTECH,120,120,0
Tailândia,150795,PA,Norte,FIOCRUZ/ASTRAZENECA,6772,5446,1326
Tailândia,150795,PA,Norte,BUTANTAN/SINOVAC,5354,2858,2496
Taió,421780,SC,Sul,FIOCRUZ/ASTRAZENECA,4146,3756,390
Taió,421780,SC,Sul,BUTANTAN/SINOVAC,3734,2008,1726
Taió,421780,SC,Sul,PFIZER/BIONTECH,395,394,1
Taiobeiras,316800,MG,Sudeste,BUTANTAN/SINOVAC,5682,3348,2334
Taiobeiras,316800,MG,Sudeste,FIOCRUZ/ASTRAZENECA,2954,2907,47
Taiobeiras,316800,MG,Sudeste,PFIZER/BIONTECH,28,28,0
Taipas Do Tocantins,172093,TO,Norte,BUTANTAN/SINOVAC,479,257,222
Taipas Do Tocantins,172093,TO,Norte,FIOCRUZ/ASTRAZENECA,323,291,32
Taipu,241390,RN,Nordeste,FIOCRUZ/ASTRAZENECA,3419,3240,179
Taipu,241390,RN,Nordeste,BUTANTAN/SINOVAC,3230,1895,1335
Taipu,241390,RN,Nordeste,PFIZER/BIONTECH,375,375,0
Taiúva,355320,SP,Sudeste,BUTANTAN/SINOVAC,1908,985,923
Taiúva,355320,SP,Sudeste,FIOCRUZ/ASTRAZENECA,1583,1375,208
Taiúva,355320,SP,Sudeste,PFIZER/BIONTECH,131,131,0
Talismã,172097,TO,Norte,BUTANTAN/SINOVAC,538,277,261
Talismã,172097,TO,Norte,FIOCRUZ/ASTRAZENECA,475,444,31
Tamandaré,261485,PE,Nordeste,BUTANTAN/SINOVAC,3686,1961,1725
Tamandaré,261485,PE,Nordeste,FIOCRUZ/ASTRAZENECA,3384,3148,236
Tamandaré,261485,PE,Nordeste,PFIZER/BIONTECH,123,123,0
Tamarana,412667,PR,Sul,BUTANTAN/SINOVAC,4564,2386,2178
Tamarana,412667,PR,Sul,FIOCRUZ/ASTRAZENECA,3085,2960,125
Tambaú,355330,SP,Sudeste,BUTANTAN/SINOVAC,5297,2784,2513
Tambaú,355330,SP,Sudeste,FIOCRUZ/ASTRAZENECA,4151,3730,421
Tambaú,355330,SP,Sudeste,PFIZER/BIONTECH,386,386,0
Tamboara,412670,PR,Sul,BUTANTAN/SINOVAC,1181,623,558
Tamboara,412670,PR,Sul,FIOCRUZ/ASTRAZENECA,1168,1063,105
Tamboara,412670,PR,Sul,PFIZER/BIONTECH,17,17,0
Tamboril,231320,CE,Nordeste,BUTANTAN/SINOVAC,6290,3218,3072
Tamboril,231320,CE,Nordeste,FIOCRUZ/ASTRAZENECA,3422,2655,767
Tamboril Do Piauí,221095,PI,Nordeste,BUTANTAN/SINOVAC,505,262,243
Tamboril Do Piauí,221095,PI,Nordeste,FIOCRUZ/ASTRAZENECA,495,464,31
Tamboril Do Piauí,221095,PI,Nordeste,PFIZER/BIONTECH,18,18,0
Tanabi,355340,SP,Sudeste,BUTANTAN/SINOVAC,7127,4060,3067
Tanabi,355340,SP,Sudeste,FIOCRUZ/ASTRAZENECA,6529,5913,616
Tanabi,355340,SP,Sudeste,PFIZER/BIONTECH,521,521,0
Tangará,241400,RN,Nordeste,BUTANTAN/SINOVAC,2776,1395,1381
Tangará,241400,RN,Nordeste,FIOCRUZ/ASTRAZENECA,2632,2370,262
Tangará,241400,RN,Nordeste,PFIZER/BIONTECH,255,255,0
Tangará,421790,SC,Sul,BUTANTAN/SINOVAC,2081,1068,1013
Tangará,421790,SC,Sul,FIOCRUZ/ASTRAZENECA,1943,1741,202
Tangará,421790,SC,Sul,PFIZER/BIONTECH,112,112,0
Tangará Da Serra,510795,MT,Centro-Oeste,FIOCRUZ/ASTRAZENECA,13431,12295,1136
Tangará Da Serra,510795,MT,Centro-Oeste,BUTANTAN/SINOVAC,13253,6759,6494
Tangará Da Serra,510795,MT,Centro-Oeste,PFIZER/BIONTECH,1378,1377,1
Tanguá,330575,RJ,Sudeste,BUTANTAN/SINOVAC,6208,3510,2698
Tanguá,330575,RJ,Sudeste,FIOCRUZ/ASTRAZENECA,5589,5264,325
Tanguá,330575,RJ,Sudeste,PFIZER/BIONTECH,353,353,0
Tanhaçu,293100,BA,Nordeste,BUTANTAN/SINOVAC,1145,886,259
Tanhaçu,293100,BA,Nordeste,FIOCRUZ/ASTRAZENECA,245,245,0
Tanque D'Arca,270900,AL,Nordeste,BUTANTAN/SINOVAC,1284,693,591
Tanque D'Arca,270900,AL,Nordeste,FIOCRUZ/ASTRAZENECA,1267,1136,131
Tanque Do Piauí,221097,PI,Nordeste,BUTANTAN/SINOVAC,512,269,243
Tanque Do Piauí,221097,PI,Nordeste,FIOCRUZ/ASTRAZENECA,500,452,48
Tanque Do Piauí,221097,PI,Nordeste,PFIZER/BIONTECH,70,70,0
Tanque Novo,293105,BA,Nordeste,BUTANTAN/SINOVAC,4174,2419,1755
Tanque Novo,293105,BA,Nordeste,FIOCRUZ/ASTRAZENECA,3832,3476,356
Tanque Novo,293105,BA,Nordeste,PFIZER/BIONTECH,100,99,1
Tanquinho,293110,BA,Nordeste,BUTANTAN/SINOVAC,2050,1069,981
Tanquinho,293110,BA,Nordeste,FIOCRUZ/ASTRAZENECA,1612,1470,142
Tanquinho,293110,BA,Nordeste,PFIZER/BIONTECH,311,311,0
Taparuba,316805,MG,Sudeste,BUTANTAN/SINOVAC,903,450,453
Taparuba,316805,MG,Sudeste,FIOCRUZ/ASTRAZENECA,686,659,27
Taparuba,316805,MG,Sudeste,PFIZER/BIONTECH,51,51,0
Tapauá,130410,AM,Norte,BUTANTAN/SINOVAC,543,406,137
Tapauá,130410,AM,Norte,FIOCRUZ/ASTRAZENECA,345,275,70
Tapauá,130410,AM,Norte,PFIZER/BIONTECH,1,1,0
Tapejara,412680,PR,Sul,FIOCRUZ/ASTRAZENECA,3378,3184,194
Tapejara,412680,PR,Sul,BUTANTAN/SINOVAC,2585,1318,1267
Tapejara,412680,PR,Sul,PFIZER/BIONTECH,379,379,0
Tapejara,432090,RS,Sul,FIOCRUZ/ASTRAZENECA,6029,5587,442
Tapejara,432090,RS,Sul,BUTANTAN/SINOVAC,4863,2444,2419
Tapejara,432090,RS,Sul,PFIZER/BIONTECH,881,881,0
Tapera,432100,RS,Sul,BUTANTAN/SINOVAC,2795,1456,1339
Tapera,432100,RS,Sul,FIOCRUZ/ASTRAZENECA,2301,2026,275
Tapera,432100,RS,Sul,PFIZER/BIONTECH,275,275,0
Taperoá,251650,PB,Nordeste,BUTANTAN/SINOVAC,3406,1792,1614
Taperoá,251650,PB,Nordeste,FIOCRUZ/ASTRAZENECA,2458,2197,261
Taperoá,251650,PB,Nordeste,PFIZER/BIONTECH,83,83,0
Taperoá,293120,BA,Nordeste,FIOCRUZ/ASTRAZENECA,3291,3069,222
Taperoá,293120,BA,Nordeste,BUTANTAN/SINOVAC,2943,1628,1315
Taperoá,293120,BA,Nordeste,PFIZER/BIONTECH,229,229,0
Tapes,432110,RS,Sul,BUTANTAN/SINOVAC,4827,2361,2466
Tapes,432110,RS,Sul,FIOCRUZ/ASTRAZENECA,4454,4116,338
Tapes,432110,RS,Sul,PFIZER/BIONTECH,359,359,0
Tapira,316810,MG,Sudeste,FIOCRUZ/ASTRAZENECA,1407,1315,92
Tapira,316810,MG,Sudeste,BUTANTAN/SINOVAC,1132,611,521
Tapira,316810,MG,Sudeste,PFIZER/BIONTECH,59,59,0
Tapira,412690,PR,Sul,FIOCRUZ/ASTRAZENECA,2014,1883,131
Tapira,412690,PR,Sul,BUTANTAN/SINOVAC,1521,774,747
Tapiraí,316820,MG,Sudeste,BUTANTAN/SINOVAC,875,478,397
Tapiraí,316820,MG,Sudeste,FIOCRUZ/ASTRAZENECA,787,703,84
Tapiraí,316820,MG,Sudeste,PFIZER/BIONTECH,21,21,0
Tapiraí,355350,SP,Sudeste,FIOCRUZ/ASTRAZENECA,2375,2240,135
Tapiraí,355350,SP,Sudeste,BUTANTAN/SINOVAC,1932,1012,920
Tapiraí,355350,SP,Sudeste,PFIZER/BIONTECH,188,188,0
Tapiramutá,293130,BA,Nordeste,FIOCRUZ/ASTRAZENECA,2787,2504,283
Tapiramutá,293130,BA,Nordeste,BUTANTAN/SINOVAC,2467,1305,1162
Tapiramutá,293130,BA,Nordeste,PFIZER/BIONTECH,362,361,1
Tapiratiba,355360,SP,Sudeste,FIOCRUZ/ASTRAZENECA,3021,2722,299
Tapiratiba,355360,SP,Sudeste,BUTANTAN/SINOVAC,2933,1369,1564
Tapiratiba,355360,SP,Sudeste,PFIZER/BIONTECH,129,129,0
Tapurah,510800,MT,Centro-Oeste,FIOCRUZ/ASTRAZENECA,1287,1205,82
Tapurah,510800,MT,Centro-Oeste,BUTANTAN/SINOVAC,853,443,410
Tapurah,510800,MT,Centro-Oeste,PFIZER/BIONTECH,19,19,0
Taquara,432120,RS,Sul,FIOCRUZ/ASTRAZENECA,14655,13628,1027
Taquara,432120,RS,Sul,BUTANTAN/SINOVAC,13384,6829,6555
Taquara,432120,RS,Sul,PFIZER/BIONTECH,790,789,1
Taquaraçu De Minas,316830,MG,Sudeste,BUTANTAN/SINOVAC,883,443,440
Taquaraçu De Minas,316830,MG,Sudeste,FIOCRUZ/ASTRAZENECA,278,229,49
Taquaral,355365,SP,Sudeste,FIOCRUZ/ASTRAZENECA,737,676,61
Taquaral,355365,SP,Sudeste,BUTANTAN/SINOVAC,648,318,330
Taquaral,355365,SP,Sudeste,PFIZER/BIONTECH,53,53,0
Taquaral De Goiás,522100,GO,Centro-Oeste,FIOCRUZ/ASTRAZENECA,1009,947,62
Taquaral De Goiás,522100,GO,Centro-Oeste,BUTANTAN/SINOVAC,856,442,414
Taquaral De Goiás,522100,GO,Centro-Oeste,PFIZER/BIONTECH,51,51,0
Taquarana,270910,AL,Nordeste,FIOCRUZ/ASTRAZENECA,4397,3963,434
Taquarana,270910,AL,Nordeste,BUTANTAN/SINOVAC,3437,1762,1675
Taquari,432130,RS,Sul,BUTANTAN/SINOVAC,8068,4102,3966
Taquari,432130,RS,Sul,FIOCRUZ/ASTRAZENECA,6655,5965,690
Taquari,432130,RS,Sul,PFIZER/BIONTECH,928,926,2
Taquaritinga,355370,SP,Sudeste,BUTANTAN/SINOVAC,15140,8409,6731
Taquaritinga,355370,SP,Sudeste,FIOCRUZ/ASTRAZENECA,13823,12525,1298
Taquaritinga,355370,SP,Sudeste,PFIZER/BIONTECH,808,807,1
Taquaritinga Do Norte,261500,PE,Nordeste,FIOCRUZ/ASTRAZENECA,4652,4204,448
Taquaritinga Do Norte,261500,PE,Nordeste,BUTANTAN/SINOVAC,3811,1951,1860
Taquaritinga Do Norte,261500,PE,Nordeste,PFIZER/BIONTECH,564,564,0
Taquarituba,355380,SP,Sudeste,FIOCRUZ/ASTRAZENECA,5912,5463,449
Taquarituba,355380,SP,Sudeste,BUTANTAN/SINOVAC,5090,2590,2500
Taquarituba,355380,SP,Sudeste,PFIZER/BIONTECH,651,650,1
Taquarivaí,355385,SP,Sudeste,FIOCRUZ/ASTRAZENECA,1086,1042,44
Taquarivaí,355385,SP,Sudeste,BUTANTAN/SINOVAC,861,469,392
Taquarivaí,355385,SP,Sudeste,PFIZER/BIONTECH,59,59,0
Taquaruçu Do Sul,432132,RS,Sul,BUTANTAN/SINOVAC,1048,552,496
Taquaruçu Do Sul,432132,RS,Sul,FIOCRUZ/ASTRAZENECA,955,870,85
Taquaruçu Do Sul,432132,RS,Sul,PFIZER/BIONTECH,131,131,0
Taquarussu,500797,MS,Centro-Oeste,BUTANTAN/SINOVAC,883,456,427
Taquarussu,500797,MS,Centro-Oeste,FIOCRUZ/ASTRAZENECA,846,777,69
Taquarussu,500797,MS,Centro-Oeste,PFIZER/BIONTECH,138,138,0
Tarabai,355390,SP,Sudeste,FIOCRUZ/ASTRAZENECA,1431,1318,113
Tarabai,355390,SP,Sudeste,BUTANTAN/SINOVAC,1403,706,697
Tarabai,355390,SP,Sudeste,PFIZER/BIONTECH,71,71,0
Tarauacá,120060,AC,Norte,BUTANTAN/SINOVAC,4453,2515,1938
Tarauacá,120060,AC,Norte,FIOCRUZ/ASTRAZENECA,4010,3552,458
Tarrafas,231325,CE,Nordeste,BUTANTAN/SINOVAC,1872,964,908
Tarrafas,231325,CE,Nordeste,FIOCRUZ/ASTRAZENECA,815,679,136
Tartarugalzinho,160070,AP,Norte,BUTANTAN/SINOVAC,2011,1080,931
Tartarugalzinho,160070,AP,Norte,FIOCRUZ/ASTRAZENECA,1312,1216,96
Tartarugalzinho,160070,AP,Norte,PFIZER/BIONTECH,422,421,1
Tarumã,355395,SP,Sudeste,FIOCRUZ/ASTRAZENECA,4116,3914,202
Tarumã,355395,SP,Sudeste,BUTANTAN/SINOVAC,2700,1270,1430
Tarumã,355395,SP,Sudeste,PFIZER/BIONTECH,424,424,0
Tarumirim,316840,MG,Sudeste,BUTANTAN/SINOVAC,3731,1900,1831
Tarumirim,316840,MG,Sudeste,FIOCRUZ/ASTRAZENECA,3226,2926,300
Tarumirim,316840,MG,Sudeste,PFIZER/BIONTECH,393,393,0
Tasso Fragoso,211200,MA,Nordeste,FIOCRUZ/ASTRAZENECA,1058,956,102
Tasso Fragoso,211200,MA,Nordeste,BUTANTAN/SINOVAC,939,476,463
Tatuí,355400,SP,Sudeste,FIOCRUZ/ASTRAZENECA,28178,25875,2303
Tatuí,355400,SP,Sudeste,BUTANTAN/SINOVAC,26308,13427,12881
Tatuí,355400,SP,Sudeste,PFIZER/BIONTECH,1510,1510,0
Tauá,231330,CE,Nordeste,BUTANTAN/SINOVAC,10455,5807,4648
Tauá,231330,CE,Nordeste,FIOCRUZ/ASTRAZENECA,7430,6881,549
Taubaté,355410,SP,Sudeste,FIOCRUZ/ASTRAZENECA,62542,57431,5111
Taubaté,355410,SP,Sudeste,BUTANTAN/SINOVAC,57272,32537,24735
Taubaté,355410,SP,Sudeste,PFIZER/BIONTECH,1484,1478,6
Tavares,251660,PB,Nordeste,BUTANTAN/SINOVAC,3183,1594,1589
Tavares,251660,PB,Nordeste,FIOCRUZ/ASTRAZENECA,2514,2302,212
Tavares,251660,PB,Nordeste,PFIZER/BIONTECH,175,175,0
Tavares,432135,RS,Sul,BUTANTAN/SINOVAC,1824,1051,773
Tavares,432135,RS,Sul,FIOCRUZ/ASTRAZENECA,1325,1137,188
Tavares,432135,RS,Sul,PFIZER/BIONTECH,59,59,0
Tefé,130420,AM,Norte,BUTANTAN/SINOVAC,11764,7800,3964
Tefé,130420,AM,Norte,FIOCRUZ/ASTRAZENECA,9463,7192,2271
Teixeira,251670,PB,Nordeste,BUTANTAN/SINOVAC,4197,2535,1662
Teixeira,251670,PB,Nordeste,FIOCRUZ/ASTRAZENECA,2715,2512,203
Teixeira,251670,PB,Nordeste,PFIZER/BIONTECH,228,228,0
Teixeira De Freitas,293135,BA,Nordeste,BUTANTAN/SINOVAC,24503,12944,11559
Teixeira De Freitas,293135,BA,Nordeste,FIOCRUZ/ASTRAZENECA,20387,18416,1971
Teixeira De Freitas,293135,BA,Nordeste,PFIZER/BIONTECH,1768,1768,0
Teixeira Soares,412700,PR,Sul,FIOCRUZ/ASTRAZENECA,2462,2334,128
Teixeira Soares,412700,PR,Sul,BUTANTAN/SINOVAC,2022,1025,997
Teixeira Soares,412700,PR,Sul,PFIZER/BIONTECH,74,74,0
Teixeiras,316850,MG,Sudeste,BUTANTAN/SINOVAC,3013,1652,1361
Teixeiras,316850,MG,Sudeste,FIOCRUZ/ASTRAZENECA,2410,2263,147
Teixeirópolis,110155,RO,Norte,FIOCRUZ/ASTRAZENECA,1548,1495,53
Teixeirópolis,110155,RO,Norte,BUTANTAN/SINOVAC,1452,758,694
Teixeirópolis,110155,RO,Norte,PFIZER/BIONTECH,156,156,0
Tejuçuoca,231335,CE,Nordeste,BUTANTAN/SINOVAC,425,280,145
Tejuçuoca,231335,CE,Nordeste,FIOCRUZ/ASTRAZENECA,248,248,0
Tejupá,355420,SP,Sudeste,BUTANTAN/SINOVAC,1000,527,473
Tejupá,355420,SP,Sudeste,FIOCRUZ/ASTRAZENECA,939,896,43
Tejupá,355420,SP,Sudeste,PFIZER/BIONTECH,86,86,0
Telêmaco Borba,412710,PR,Sul,FIOCRUZ/ASTRAZENECA,13727,12973,754
Telêmaco Borba,412710,PR,Sul,BUTANTAN/SINOVAC,13000,6723,6277
Telêmaco Borba,412710,PR,Sul,PFIZER/BIONTECH,3799,3797,2
Telha,280730,SE,Nordeste,BUTANTAN/SINOVAC,607,346,261
Telha,280730,SE,Nordeste,FIOCRUZ/ASTRAZENECA,444,444,0
Telha,280730,SE,Nordeste,PFIZER/BIONTECH,39,39,0
Tenente Ananias,241410,RN,Nordeste,FIOCRUZ/ASTRAZENECA,2382,2255,127
Tenente Ananias,241410,RN,Nordeste,BUTANTAN/SINOVAC,2223,1186,1037
Tenente Ananias,241410,RN,Nordeste,PFIZER/BIONTECH,333,333,0
Tenente Laurentino Cruz,241415,RN,Nordeste,BUTANTAN/SINOVAC,1118,641,477
Tenente Laurentino Cruz,241415,RN,Nordeste,FIOCRUZ/ASTRAZENECA,946,910,36
Tenente Laurentino Cruz,241415,RN,Nordeste,PFIZER/BIONTECH,112,112,0
Tenente Portela,432140,RS,Sul,BUTANTAN/SINOVAC,6733,3492,3241
Tenente Portela,432140,RS,Sul,FIOCRUZ/ASTRAZENECA,3696,3076,620
Tenente Portela,432140,RS,Sul,PFIZER/BIONTECH,421,420,1
Tenório,251675,PB,Nordeste,BUTANTAN/SINOVAC,560,274,286
Tenório,251675,PB,Nordeste,FIOCRUZ/ASTRAZENECA,184,165,19
Teodoro Sampaio,293140,BA,Nordeste,BUTANTAN/SINOVAC,1888,984,904
Teodoro Sampaio,293140,BA,Nordeste,FIOCRUZ/ASTRAZENECA,1391,1321,70
Teodoro Sampaio,293140,BA,Nordeste,PFIZER/BIONTECH,201,201,0
Teodoro Sampaio,355430,SP,Sudeste,FIOCRUZ/ASTRAZENECA,5538,5239,299
Teodoro Sampaio,355430,SP,Sudeste,BUTANTAN/SINOVAC,4724,2256,2468
Teodoro Sampaio,355430,SP,Sudeste,PFIZER/BIONTECH,784,784,0
Teofilândia,293150,BA,Nordeste,FIOCRUZ/ASTRAZENECA,4128,3770,358
Teofilândia,293150,BA,Nordeste,BUTANTAN/SINOVAC,3863,1983,1880
Teofilândia,293150,BA,Nordeste,PFIZER/BIONTECH,150,150,0
Teófilo Otoni,316860,MG,Sudeste,BUTANTAN/SINOVAC,28927,15932,12995
Teófilo Otoni,316860,MG,Sudeste,FIOCRUZ/ASTRAZENECA,11636,10925,711
Teófilo Otoni,316860,MG,Sudeste,PFIZER/BIONTECH,789,787,2
Teolândia,293160,BA,Nordeste,BUTANTAN/SINOVAC,819,473,346
Teolândia,293160,BA,Nordeste,FIOCRUZ/ASTRAZENECA,552,508,44
Teolândia,293160,BA,Nordeste,PFIZER/BIONTECH,11,11,0
Teotônio Vilela,270915,AL,Nordeste,FIOCRUZ/ASTRAZENECA,7110,6684,426
Teotônio Vilela,270915,AL,Nordeste,BUTANTAN/SINOVAC,5688,2995,2693
Teotônio Vilela,270915,AL,Nordeste,PFIZER/BIONTECH,958,958,0
Terenos,500800,MS,Centro-Oeste,BUTANTAN/SINOVAC,4166,2376,1790
Terenos,500800,MS,Centro-Oeste,FIOCRUZ/ASTRAZENECA,3629,3290,339
Terenos,500800,MS,Centro-Oeste,PFIZER/BIONTECH,174,173,1
Teresina,221100,PI,Nordeste,FIOCRUZ/ASTRAZENECA,177085,164304,12781
Teresina,221100,PI,Nordeste,BUTANTAN/SINOVAC,150339,76232,74107
Teresina,221100,PI,Nordeste,PFIZER/BIONTECH,50939,50871,68
Teresina De Goiás,522108,GO,Centro-Oeste,BUTANTAN/SINOVAC,1519,798,721
Teresina De Goiás,522108,GO,Centro-Oeste,FIOCRUZ/ASTRAZENECA,592,539,53
Teresópolis,330580,RJ,Sudeste,BUTANTAN/SINOVAC,35816,19126,16690
Teresópolis,330580,RJ,Sudeste,FIOCRUZ/ASTRAZENECA,33229,29932,3297
Teresópolis,330580,RJ,Sudeste,PFIZER/BIONTECH,2330,2295,35
Terezinha,261510,PE,Nordeste,BUTANTAN/SINOVAC,1708,900,808
Terezinha,261510,PE,Nordeste,FIOCRUZ/ASTRAZENECA,1487,1355,132
Terezinha,261510,PE,Nordeste,PFIZER/BIONTECH,232,231,1
Terezópolis De Goiás,522119,GO,Centro-Oeste,FIOCRUZ/ASTRAZENECA,1475,1418,57
Terezópolis De Goiás,522119,GO,Centro-Oeste,BUTANTAN/SINOVAC,908,498,410
Terra Alta,150796,PA,Norte,BUTANTAN/SINOVAC,1427,756,671
Terra Alta,150796,PA,Norte,FIOCRUZ/ASTRAZENECA,1074,1027,47
Terra Boa,412720,PR,Sul,FIOCRUZ/ASTRAZENECA,4126,3910,216
Terra Boa,412720,PR,Sul,BUTANTAN/SINOVAC,3804,2030,1774
Terra Boa,412720,PR,Sul,PFIZER/BIONTECH,513,513,0
Terra De Areia,432143,RS,Sul,BUTANTAN/SINOVAC,3077,1562,1515
Terra De Areia,432143,RS,Sul,FIOCRUZ/ASTRAZENECA,2828,2590,238
Terra De Areia,432143,RS,Sul,PFIZER/BIONTECH,334,330,4
Terra Nova,261520,PE,Nordeste,FIOCRUZ/ASTRAZENECA,2143,1963,180
Terra Nova,261520,PE,Nordeste,BUTANTAN/SINOVAC,1763,892,871
Terra Nova,261520,PE,Nordeste,PFIZER/BIONTECH,228,228,0
Terra Nova,293170,BA,Nordeste,BUTANTAN/SINOVAC,2594,1412,1182
Terra Nova,293170,BA,Nordeste,FIOCRUZ/ASTRAZENECA,2166,2049,117
Terra Nova,293170,BA,Nordeste,PFIZER/BIONTECH,365,365,0
Terra Nova Do Norte,510805,MT,Centro-Oeste,FIOCRUZ/ASTRAZENECA,2084,1963,121
Terra Nova Do Norte,510805,MT,Centro-Oeste,BUTANTAN/SINOVAC,1866,991,875
Terra Nova Do Norte,510805,MT,Centro-Oeste,PFIZER/BIONTECH,24,24,0
Terra Rica,412730,PR,Sul,BUTANTAN/SINOVAC,3979,2059,1920
Terra Rica,412730,PR,Sul,FIOCRUZ/ASTRAZENECA,3951,3709,242
Terra Rica,412730,PR,Sul,PFIZER/BIONTECH,115,115,0
Terra Roxa,355440,SP,Sudeste,FIOCRUZ/ASTRAZENECA,2460,2231,229
Terra Roxa,355440,SP,Sudeste,BUTANTAN/SINOVAC,2051,1089,962
Terra Roxa,355440,SP,Sudeste,PFIZER/BIONTECH,94,94,0
Terra Roxa,412740,PR,Sul,BUTANTAN/SINOVAC,5203,2634,2569
Terra Roxa,412740,PR,Sul,FIOCRUZ/ASTRAZENECA,4735,4338,397
Terra Roxa,412740,PR,Sul,PFIZER/BIONTECH,76,76,0
Terra Santa,150797,PA,Norte,FIOCRUZ/ASTRAZENECA,3786,2973,813
Terra Santa,150797,PA,Norte,BUTANTAN/SINOVAC,825,428,397
Tesouro,510810,MT,Centro-Oeste,BUTANTAN/SINOVAC,1034,599,435
Tesouro,510810,MT,Centro-Oeste,FIOCRUZ/ASTRAZENECA,402,353,49
Tesouro,510810,MT,Centro-Oeste,PFIZER/BIONTECH,6,6,0
Teutônia,432145,RS,Sul,BUTANTAN/SINOVAC,11180,6835,4345
Teutônia,432145,RS,Sul,FIOCRUZ/ASTRAZENECA,7895,7195,700
Teutônia,432145,RS,Sul,PFIZER/BIONTECH,471,471,0
Theobroma,110160,RO,Norte,BUTANTAN/SINOVAC,1871,951,920
Theobroma,110160,RO,Norte,FIOCRUZ/ASTRAZENECA,1286,1248,38
Tianguá,231340,CE,Nordeste,BUTANTAN/SINOVAC,11207,5878,5329
Tianguá,231340,CE,Nordeste,FIOCRUZ/ASTRAZENECA,8009,7263,746
Tianguá,231340,CE,Nordeste,PFIZER/BIONTECH,225,225,0
Tibagi,412750,PR,Sul,FIOCRUZ/ASTRAZENECA,4181,3957,224
Tibagi,412750,PR,Sul,BUTANTAN/SINOVAC,3577,1902,1675
Tibau,241105,RN,Nordeste,BUTANTAN/SINOVAC,1132,634,498
Tibau,241105,RN,Nordeste,FIOCRUZ/ASTRAZENECA,1098,1067,31
Tibau,241105,RN,Nordeste,PFIZER/BIONTECH,207,206,1
Tibau Do Sul,241420,RN,Nordeste,FIOCRUZ/ASTRAZENECA,2654,2385,269
Tibau Do Sul,241420,RN,Nordeste,BUTANTAN/SINOVAC,2043,1089,954
Tibau Do Sul,241420,RN,Nordeste,PFIZER/BIONTECH,185,184,1
Tietê,355450,SP,Sudeste,FIOCRUZ/ASTRAZENECA,9173,8255,918
Tietê,355450,SP,Sudeste,BUTANTAN/SINOVAC,8066,4326,3740
Tietê,355450,SP,Sudeste,PFIZER/BIONTECH,844,844,0
Tigrinhos,421795,SC,Sul,BUTANTAN/SINOVAC,920,542,378
Tigrinhos,421795,SC,Sul,FIOCRUZ/ASTRAZENECA,671,623,48
Tijucas,421800,SC,Sul,FIOCRUZ/ASTRAZENECA,6328,6288,40
Tijucas,421800,SC,Sul,BUTANTAN/SINOVAC,5388,2923,2465
Tijucas,421800,SC,Sul,PFIZER/BIONTECH,701,700,1
Tijucas Do Sul,412760,PR,Sul,FIOCRUZ/ASTRAZENECA,3870,3619,251
Tijucas Do Sul,412760,PR,Sul,BUTANTAN/SINOVAC,3246,1700,1546
Tijucas Do Sul,412760,PR,Sul,PFIZER/BIONTECH,199,199,0
Timbaúba,261530,PE,Nordeste,FIOCRUZ/ASTRAZENECA,9889,9180,709
Timbaúba,261530,PE,Nordeste,BUTANTAN/SINOVAC,8818,4574,4244
Timbaúba,261530,PE,Nordeste,PFIZER/BIONTECH,816,815,1
Timbaúba Dos Batistas,241430,RN,Nordeste,FIOCRUZ/ASTRAZENECA,645,604,41
Timbaúba Dos Batistas,241430,RN,Nordeste,BUTANTAN/SINOVAC,622,318,304
Timbaúba Dos Batistas,241430,RN,Nordeste,PFIZER/BIONTECH,73,72,1
Timbé Do Sul,421810,SC,Sul,FIOCRUZ/ASTRAZENECA,1391,1275,116
Timbé Do Sul,421810,SC,Sul,BUTANTAN/SINOVAC,1334,690,644
Timbé Do Sul,421810,SC,Sul,PFIZER/BIONTECH,103,103,0
Timbiras,211210,MA,Nordeste,BUTANTAN/SINOVAC,4829,2550,2279
Timbiras,211210,MA,Nordeste,FIOCRUZ/ASTRAZENECA,3878,3513,365
Timbiras,211210,MA,Nordeste,PFIZER/BIONTECH,1,1,0
Timbó,421820,SC,Sul,FIOCRUZ/ASTRAZENECA,10147,9889,258
Timbó,421820,SC,Sul,BUTANTAN/SINOVAC,9493,5096,4397
Timbó,421820,SC,Sul,PFIZER/BIONTECH,882,882,0
Timbó Grande,421825,SC,Sul,FIOCRUZ/ASTRAZENECA,1612,1434,178
Timbó Grande,421825,SC,Sul,BUTANTAN/SINOVAC,859,514,345
Timbó Grande,421825,SC,Sul,PFIZER/BIONTECH,12,12,0
Timburi,355460,SP,Sudeste,FIOCRUZ/ASTRAZENECA,868,784,84
Timburi,355460,SP,Sudeste,BUTANTAN/SINOVAC,740,352,388
Timburi,355460,SP,Sudeste,PFIZER/BIONTECH,78,78,0
Timon,211220,MA,Nordeste,FIOCRUZ/ASTRAZENECA,31512,29211,2301
Timon,211220,MA,Nordeste,BUTANTAN/SINOVAC,21995,11425,10570
Timon,211220,MA,Nordeste,PFIZER/BIONTECH,5399,5398,1
Timóteo,316870,MG,Sudeste,BUTANTAN/SINOVAC,16086,8500,7586
Timóteo,316870,MG,Sudeste,FIOCRUZ/ASTRAZENECA,13581,12206,1375
Timóteo,316870,MG,Sudeste,PFIZER/BIONTECH,2171,2171,0
Tio Hugo,432146,RS,Sul,BUTANTAN/SINOVAC,813,410,403
Tio Hugo,432146,RS,Sul,FIOCRUZ/ASTRAZENECA,805,753,52
Tio Hugo,432146,RS,Sul,PFIZER/BIONTECH,128,128,0
Tiradentes,316880,MG,Sudeste,FIOCRUZ/ASTRAZENECA,1650,1583,67
Tiradentes,316880,MG,Sudeste,BUTANTAN/SINOVAC,1326,715,611
Tiradentes,316880,MG,Sudeste,PFIZER/BIONTECH,72,72,0
Tiradentes Do Sul,432147,RS,Sul,BUTANTAN/SINOVAC,2206,1140,1066
Tiradentes Do Sul,432147,RS,Sul,FIOCRUZ/ASTRAZENECA,1364,1213,151
Tiradentes Do Sul,432147,RS,Sul,PFIZER/BIONTECH,167,167,0
Tiros,316890,MG,Sudeste,BUTANTAN/SINOVAC,1748,874,874
Tiros,316890,MG,Sudeste,FIOCRUZ/ASTRAZENECA,1625,1493,132
Tiros,316890,MG,Sudeste,PFIZER/BIONTECH,89,89,0
Tobias Barreto,280740,SE,Nordeste,FIOCRUZ/ASTRAZENECA,10811,9777,1034
Tobias Barreto,280740,SE,Nordeste,BUTANTAN/SINOVAC,9898,5038,4860
Tobias Barreto,280740,SE,Nordeste,PFIZER/BIONTECH,177,177,0
Tocantínia,172110,TO,Norte,BUTANTAN/SINOVAC,3362,1966,1396
Tocantínia,172110,TO,Norte,FIOCRUZ/ASTRAZENECA,527,514,13
Tocantinópolis,172120,TO,Norte,BUTANTAN/SINOVAC,5810,3046,2764
Tocantinópolis,172120,TO,Norte,FIOCRUZ/ASTRAZENECA,2414,2224,190
Tocantins,316900,MG,Sudeste,BUTANTAN/SINOVAC,4145,2148,1997
Tocantins,316900,MG,Sudeste,FIOCRUZ/ASTRAZENECA,3281,3039,242
Tocantins,316900,MG,Sudeste,PFIZER/BIONTECH,135,135,0
Tocos Do Moji,316905,MG,Sudeste,FIOCRUZ/ASTRAZENECA,1232,1148,84
Tocos Do Moji,316905,MG,Sudeste,BUTANTAN/SINOVAC,1152,587,565
Tocos Do Moji,316905,MG,Sudeste,PFIZER/BIONTECH,34,34,0
Toledo,316910,MG,Sudeste,FIOCRUZ/ASTRAZENECA,1646,1504,142
Toledo,316910,MG,Sudeste,BUTANTAN/SINOVAC,1551,772,779
Toledo,316910,MG,Sudeste,PFIZER/BIONTECH,68,68,0
Toledo,412770,PR,Sul,FIOCRUZ/ASTRAZENECA,28922,26865,2057
Toledo,412770,PR,Sul,BUTANTAN/SINOVAC,26799,13607,13192
Toledo,412770,PR,Sul,PFIZER/BIONTECH,6310,6309,1
Tomar Do Geru,280750,SE,Nordeste,BUTANTAN/SINOVAC,2009,1045,964
Tomar Do Geru,280750,SE,Nordeste,FIOCRUZ/ASTRAZENECA,1574,1494,80
Tomar Do Geru,280750,SE,Nordeste,PFIZER/BIONTECH,110,110,0
Tomazina,412780,PR,Sul,FIOCRUZ/ASTRAZENECA,2361,2252,109
Tomazina,412780,PR,Sul,BUTANTAN/SINOVAC,2165,1158,1007
Tomazina,412780,PR,Sul,PFIZER/BIONTECH,114,114,0
Tombos,316920,MG,Sudeste,BUTANTAN/SINOVAC,2249,1163,1086
Tombos,316920,MG,Sudeste,FIOCRUZ/ASTRAZENECA,1769,1641,128
Tombos,316920,MG,Sudeste,PFIZER/BIONTECH,158,158,0
Tomé-Açu,150800,PA,Norte,FIOCRUZ/ASTRAZENECA,8223,6981,1242
Tomé-Açu,150800,PA,Norte,BUTANTAN/SINOVAC,6275,3329,2946
Tonantins,130423,AM,Norte,BUTANTAN/SINOVAC,4439,2438,2001
Tonantins,130423,AM,Norte,FIOCRUZ/ASTRAZENECA,2049,1830,219
Toritama,261540,PE,Nordeste,FIOCRUZ/ASTRAZENECA,5650,5318,332
Toritama,261540,PE,Nordeste,BUTANTAN/SINOVAC,3585,1822,1763
Toritama,261540,PE,Nordeste,PFIZER/BIONTECH,627,627,0
Torixoréu,510820,MT,Centro-Oeste,BUTANTAN/SINOVAC,1264,675,589
Torixoréu,510820,MT,Centro-Oeste,FIOCRUZ/ASTRAZENECA,1187,1163,24
Torixoréu,510820,MT,Centro-Oeste,PFIZER/BIONTECH,67,67,0
Toropi,432149,RS,Sul,FIOCRUZ/ASTRAZENECA,992,867,125
Toropi,432149,RS,Sul,BUTANTAN/SINOVAC,931,488,443
Toropi,432149,RS,Sul,PFIZER/BIONTECH,60,60,0
Torre De Pedra,355465,SP,Sudeste,BUTANTAN/SINOVAC,1199,668,531
Torre De Pedra,355465,SP,Sudeste,FIOCRUZ/ASTRAZENECA,868,794,74
Torre De Pedra,355465,SP,Sudeste,PFIZER/BIONTECH,74,74,0
Torres,432150,RS,Sul,BUTANTAN/SINOVAC,13218,6851,6367
Torres,432150,RS,Sul,FIOCRUZ/ASTRAZENECA,12619,11839,780
Torres,432150,RS,Sul,PFIZER/BIONTECH,1108,1104,4
Torrinha,355470,SP,Sudeste,BUTANTAN/SINOVAC,2755,1299,1456
Torrinha,355470,SP,Sudeste,FIOCRUZ/ASTRAZENECA,2271,2004,267
Torrinha,355470,SP,Sudeste,PFIZER/BIONTECH,146,146,0
Touros,241440,RN,Nordeste,BUTANTAN/SINOVAC,6140,3265,2875
Touros,241440,RN,Nordeste,FIOCRUZ/ASTRAZENECA,4600,4154,446
Touros,241440,RN,Nordeste,PFIZER/BIONTECH,356,355,1
Trabiju,355475,SP,Sudeste,BUTANTAN/SINOVAC,696,365,331
Trabiju,355475,SP,Sudeste,FIOCRUZ/ASTRAZENECA,684,623,61
Trabiju,355475,SP,Sudeste,PFIZER/BIONTECH,25,25,0
Tracuateua,150803,PA,Norte,FIOCRUZ/ASTRAZENECA,4675,3249,1426
Tracuateua,150803,PA,Norte,BUTANTAN/SINOVAC,3410,1891,1519
Tracunhaém,261550,PE,Nordeste,FIOCRUZ/ASTRAZENECA,2283,2152,131
Tracunhaém,261550,PE,Nordeste,BUTANTAN/SINOVAC,1909,1099,810
Tracunhaém,261550,PE,Nordeste,PFIZER/BIONTECH,103,103,0
Traipu,270920,AL,Nordeste,FIOCRUZ/ASTRAZENECA,5289,4864,425
Traipu,270920,AL,Nordeste,BUTANTAN/SINOVAC,3694,1983,1711
Trairão,150805,PA,Norte,FIOCRUZ/ASTRAZENECA,2387,1646,741
Trairão,150805,PA,Norte,BUTANTAN/SINOVAC,965,549,416
Trairi,231350,CE,Nordeste,BUTANTAN/SINOVAC,4372,2884,1488
Trairi,231350,CE,Nordeste,FIOCRUZ/ASTRAZENECA,2210,2059,151
Trairi,231350,CE,Nordeste,PFIZER/BIONTECH,2,2,0
Trajano De Moraes,330590,RJ,Sudeste,BUTANTAN/SINOVAC,1831,1077,754
Trajano De Moraes,330590,RJ,Sudeste,FIOCRUZ/ASTRAZENECA,1789,1633,156
Tramandaí,432160,RS,Sul,BUTANTAN/SINOVAC,18413,11541,6872
Tramandaí,432160,RS,Sul,FIOCRUZ/ASTRAZENECA,15215,14054,1161
Tramandaí,432160,RS,Sul,PFIZER/BIONTECH,512,512,0
Travesseiro,432162,RS,Sul,BUTANTAN/SINOVAC,994,499,495
Travesseiro,432162,RS,Sul,FIOCRUZ/ASTRAZENECA,644,531,113
Travesseiro,432162,RS,Sul,PFIZER/BIONTECH,83,83,0
Tremedal,293180,BA,Nordeste,BUTANTAN/SINOVAC,3612,2042,1570
Tremedal,293180,BA,Nordeste,FIOCRUZ/ASTRAZENECA,2240,2025,215
Tremembé,355480,SP,Sudeste,BUTANTAN/SINOVAC,9462,5038,4424
Tremembé,355480,SP,Sudeste,FIOCRUZ/ASTRAZENECA,8307,7352,955
Tremembé,355480,SP,Sudeste,PFIZER/BIONTECH,344,344,0
Três Arroios,432163,RS,Sul,BUTANTAN/SINOVAC,1186,595,591
Três Arroios,432163,RS,Sul,FIOCRUZ/ASTRAZENECA,767,631,136
Três Arroios,432163,RS,Sul,PFIZER/BIONTECH,120,120,0
Três Barras,421830,SC,Sul,FIOCRUZ/ASTRAZENECA,3715,3486,229
Três Barras,421830,SC,Sul,BUTANTAN/SINOVAC,3201,1752,1449
Três Barras,421830,SC,Sul,PFIZER/BIONTECH,263,263,0
Três Barras Do Paraná,412785,PR,Sul,FIOCRUZ/ASTRAZENECA,2943,2809,134
Três Barras Do Paraná,412785,PR,Sul,BUTANTAN/SINOVAC,2093,1109,984
Três Cachoeiras,432166,RS,Sul,BUTANTAN/SINOVAC,3316,1688,1628
Três Cachoeiras,432166,RS,Sul,FIOCRUZ/ASTRAZENECA,3018,2832,186
Três Cachoeiras,432166,RS,Sul,PFIZER/BIONTECH,438,438,0
Três Corações,316930,MG,Sudeste,BUTANTAN/SINOVAC,12741,6626,6115
Três Corações,316930,MG,Sudeste,FIOCRUZ/ASTRAZENECA,9618,8563,1055
Três Corações,316930,MG,Sudeste,PFIZER/BIONTECH,738,737,1
Três Coroas,432170,RS,Sul,BUTANTAN/SINOVAC,5527,2819,2708
Três Coroas,432170,RS,Sul,FIOCRUZ/ASTRAZENECA,4955,4774,181
Três Coroas,432170,RS,Sul,PFIZER/BIONTECH,486,486,0
Três De Maio,432180,RS,Sul,BUTANTAN/SINOVAC,8579,4750,3829
Três De Maio,432180,RS,Sul,FIOCRUZ/ASTRAZENECA,6544,5987,557
Três De Maio,432180,RS,Sul,PFIZER/BIONTECH,606,605,1
Três Forquilhas,432183,RS,Sul,BUTANTAN/SINOVAC,919,482,437
Três Forquilhas,432183,RS,Sul,FIOCRUZ/ASTRAZENECA,897,837,60
Três Forquilhas,432183,RS,Sul,PFIZER/BIONTECH,104,104,0
Três Fronteiras,355490,SP,Sudeste,FIOCRUZ/ASTRAZENECA,1652,1471,181
Três Fronteiras,355490,SP,Sudeste,BUTANTAN/SINOVAC,1579,848,731
Três Fronteiras,355490,SP,Sudeste,PFIZER/BIONTECH,14,14,0
Três Lagoas,500830,MS,Centro-Oeste,FIOCRUZ/ASTRAZENECA,29137,26088,3049
Três Lagoas,500830,MS,Centro-Oeste,BUTANTAN/SINOVAC,20899,11447,9452
Três Lagoas,500830,MS,Centro-Oeste,PFIZER/BIONTECH,3962,3953,9
Três Marias,316935,MG,Sudeste,FIOCRUZ/ASTRAZENECA,4703,4376,327
Três Marias,316935,MG,Sudeste,BUTANTAN/SINOVAC,4484,2416,2068
Três Marias,316935,MG,Sudeste,PFIZER/BIONTECH,514,514,0
Três Palmeiras,432185,RS,Sul,BUTANTAN/SINOVAC,1869,981,888
Três Palmeiras,432185,RS,Sul,FIOCRUZ/ASTRAZENECA,1183,1103,80
Três Palmeiras,432185,RS,Sul,PFIZER/BIONTECH,114,114,0
Três Passos,432190,RS,Sul,BUTANTAN/SINOVAC,9251,4741,4510
Três Passos,432190,RS,Sul,FIOCRUZ/ASTRAZENECA,6199,5537,662
Três Passos,432190,RS,Sul,PFIZER/BIONTECH,796,796,0
Três Pontas,316940,MG,Sudeste,FIOCRUZ/ASTRAZENECA,11434,10422,1012
Três Pontas,316940,MG,Sudeste,BUTANTAN/SINOVAC,10883,5634,5249
Três Pontas,316940,MG,Sudeste,PFIZER/BIONTECH,1190,1189,1
Três Ranchos,522130,GO,Centro-Oeste,FIOCRUZ/ASTRAZENECA,896,856,40
Três Ranchos,522130,GO,Centro-Oeste,BUTANTAN/SINOVAC,537,283,254
Três Rios,330600,RJ,Sudeste,BUTANTAN/SINOVAC,21100,12027,9073
Três Rios,330600,RJ,Sudeste,FIOCRUZ/ASTRAZENECA,11193,10379,814
Três Rios,330600,RJ,Sudeste,PFIZER/BIONTECH,331,331,0
Treviso,421835,SC,Sul,FIOCRUZ/ASTRAZENECA,1201,1054,147
Treviso,421835,SC,Sul,BUTANTAN/SINOVAC,845,440,405
Treviso,421835,SC,Sul,PFIZER/BIONTECH,143,143,0
Treze De Maio,421840,SC,Sul,BUTANTAN/SINOVAC,1957,1125,832
Treze De Maio,421840,SC,Sul,FIOCRUZ/ASTRAZENECA,1838,1679,159
Treze De Maio,421840,SC,Sul,PFIZER/BIONTECH,76,76,0
Treze Tílias,421850,SC,Sul,FIOCRUZ/ASTRAZENECA,1500,1415,85
Treze Tílias,421850,SC,Sul,BUTANTAN/SINOVAC,1199,637,562
Treze Tílias,421850,SC,Sul,PFIZER/BIONTECH,172,172,0
Trindade,261560,PE,Nordeste,FIOCRUZ/ASTRAZENECA,4349,4032,317
Trindade,261560,PE,Nordeste,BUTANTAN/SINOVAC,4045,2108,1937
Trindade,261560,PE,Nordeste,PFIZER/BIONTECH,551,551,0
Trindade,522140,GO,Centro-Oeste,FIOCRUZ/ASTRAZENECA,23981,22162,1819
Trindade,522140,GO,Centro-Oeste,BUTANTAN/SINOVAC,20440,10842,9598
Trindade,522140,GO,Centro-Oeste,PFIZER/BIONTECH,4538,4536,2
Trindade Do Sul,432195,RS,Sul,FIOCRUZ/ASTRAZENECA,1919,1778,141
Trindade Do Sul,432195,RS,Sul,BUTANTAN/SINOVAC,1826,969,857
Trindade Do Sul,432195,RS,Sul,PFIZER/BIONTECH,163,163,0
Triunfo,251680,PB,Nordeste,BUTANTAN/SINOVAC,2378,1250,1128
Triunfo,251680,PB,Nordeste,FIOCRUZ/ASTRAZENECA,1496,1417,79
Triunfo,261570,PE,Nordeste,FIOCRUZ/ASTRAZENECA,3961,3523,438
Triunfo,261570,PE,Nordeste,BUTANTAN/SINOVAC,3316,1821,1495
Triunfo,261570,PE,Nordeste,PFIZER/BIONTECH,314,314,0
Triunfo,432200,RS,Sul,FIOCRUZ/ASTRAZENECA,6953,6437,516
Triunfo,432200,RS,Sul,BUTANTAN/SINOVAC,5950,2952,2998
Triunfo,432200,RS,Sul,PFIZER/BIONTECH,453,453,0
Triunfo Potiguar,241445,RN,Nordeste,BUTANTAN/SINOVAC,774,419,355
Triunfo Potiguar,241445,RN,Nordeste,FIOCRUZ/ASTRAZENECA,480,453,27
Triunfo Potiguar,241445,RN,Nordeste,PFIZER/BIONTECH,71,71,0
Trizidela Do Vale,211223,MA,Nordeste,FIOCRUZ/ASTRAZENECA,3435,3197,238
Trizidela Do Vale,211223,MA,Nordeste,BUTANTAN/SINOVAC,3384,1853,1531
Trombas,522145,GO,Centro-Oeste,FIOCRUZ/ASTRAZENECA,1260,1195,65
Trombas,522145,GO,Centro-Oeste,BUTANTAN/SINOVAC,627,333,294
Trombudo Central,421860,SC,Sul,FIOCRUZ/ASTRAZENECA,1774,1607,167
Trombudo Central,421860,SC,Sul,BUTANTAN/SINOVAC,1599,831,768
Trombudo Central,421860,SC,Sul,PFIZER/BIONTECH,171,171,0
Tubarão,421870,SC,Sul,BUTANTAN/SINOVAC,26060,13632,12428
Tubarão,421870,SC,Sul,FIOCRUZ/ASTRAZENECA,17959,16090,1869
Tubarão,421870,SC,Sul,PFIZER/BIONTECH,4744,4741,3
Tucano,293190,BA,Nordeste,BUTANTAN/SINOVAC,9675,5114,4561
Tucano,293190,BA,Nordeste,FIOCRUZ/ASTRAZENECA,9587,8835,752
Tucano,293190,BA,Nordeste,PFIZER/BIONTECH,1495,1493,2
Tucumã,150808,PA,Norte,FIOCRUZ/ASTRAZENECA,3711,2497,1214
Tucumã,150808,PA,Norte,BUTANTAN/SINOVAC,3393,1772,1621
Tucunduva,432210,RS,Sul,BUTANTAN/SINOVAC,2190,1093,1097
Tucunduva,432210,RS,Sul,FIOCRUZ/ASTRAZENECA,1498,1363,135
Tucunduva,432210,RS,Sul,PFIZER/BIONTECH,163,163,0
Tucuruí,150810,PA,Norte,FIOCRUZ/ASTRAZENECA,16262,14967,1295
Tucuruí,150810,PA,Norte,BUTANTAN/SINOVAC,7110,3794,3316
Tufilândia,211227,MA,Nordeste,FIOCRUZ/ASTRAZENECA,1360,1261,99
Tufilândia,211227,MA,Nordeste,BUTANTAN/SINOVAC,1024,540,484
Tuiuti,355495,SP,Sudeste,BUTANTAN/SINOVAC,1814,945,869
Tuiuti,355495,SP,Sudeste,FIOCRUZ/ASTRAZENECA,1650,1487,163
Tuiuti,355495,SP,Sudeste,PFIZER/BIONTECH,89,89,0
Tumiritinga,316950,MG,Sudeste,BUTANTAN/SINOVAC,1313,654,659
Tumiritinga,316950,MG,Sudeste,FIOCRUZ/ASTRAZENECA,1166,1061,105
Tumiritinga,316950,MG,Sudeste,PFIZER/BIONTECH,30,30,0
Tunápolis,421875,SC,Sul,FIOCRUZ/ASTRAZENECA,1418,1311,107
Tunápolis,421875,SC,Sul,BUTANTAN/SINOVAC,1303,668,635
Tunápolis,421875,SC,Sul,PFIZER/BIONTECH,109,109,0
Tunas,432215,RS,Sul,FIOCRUZ/ASTRAZENECA,961,890,71
Tunas,432215,RS,Sul,BUTANTAN/SINOVAC,822,426,396
Tunas,432215,RS,Sul,PFIZER/BIONTECH,66,66,0
Tunas Do Paraná,412788,PR,Sul,FIOCRUZ/ASTRAZENECA,1004,932,72
Tunas Do Paraná,412788,PR,Sul,BUTANTAN/SINOVAC,842,465,377
Tuneiras Do Oeste,412790,PR,Sul,FIOCRUZ/ASTRAZENECA,2422,2271,151
Tuneiras Do Oeste,412790,PR,Sul,BUTANTAN/SINOVAC,1710,885,825
Tuneiras Do Oeste,412790,PR,Sul,PFIZER/BIONTECH,36,36,0
Tuntum,211230,MA,Nordeste,FIOCRUZ/ASTRAZENECA,7102,6529,573
Tuntum,211230,MA,Nordeste,BUTANTAN/SINOVAC,6622,3414,3208
Tupã,355500,SP,Sudeste,BUTANTAN/SINOVAC,33771,18846,14925
Tupã,355500,SP,Sudeste,FIOCRUZ/ASTRAZENECA,21279,19229,2050
Tupã,355500,SP,Sudeste,PFIZER/BIONTECH,910,901,9
Tupaciguara,316960,MG,Sudeste,BUTANTAN/SINOVAC,6955,3503,3452
Tupaciguara,316960,MG,Sudeste,FIOCRUZ/ASTRAZENECA,6451,5901,550
Tupaciguara,316960,MG,Sudeste,PFIZER/BIONTECH,359,359,0
Tupanatinga,261580,PE,Nordeste,FIOCRUZ/ASTRAZENECA,4233,3807,426
Tupanatinga,261580,PE,Nordeste,BUTANTAN/SINOVAC,3228,1669,1559
Tupanatinga,261580,PE,Nordeste,PFIZER/BIONTECH,129,129,0
Tupanci Do Sul,432218,RS,Sul,FIOCRUZ/ASTRAZENECA,498,441,57
Tupanci Do Sul,432218,RS,Sul,BUTANTAN/SINOVAC,445,223,222
Tupanci Do Sul,432218,RS,Sul,PFIZER/BIONTECH,76,76,0
Tupanciretã,432220,RS,Sul,FIOCRUZ/ASTRAZENECA,6706,6226,480
Tupanciretã,432220,RS,Sul,BUTANTAN/SINOVAC,5276,2680,2596
Tupanciretã,432220,RS,Sul,PFIZER/BIONTECH,580,580,0
Tupandi,432225,RS,Sul,FIOCRUZ/ASTRAZENECA,915,847,68
Tupandi,432225,RS,Sul,BUTANTAN/SINOVAC,825,431,394
Tupandi,432225,RS,Sul,PFIZER/BIONTECH,136,136,0
Tuparendi,432230,RS,Sul,BUTANTAN/SINOVAC,3496,1795,1701
Tuparendi,432230,RS,Sul,FIOCRUZ/ASTRAZENECA,2542,2277,265
Tuparendi,432230,RS,Sul,PFIZER/BIONTECH,332,332,0
Tuparetama,261590,PE,Nordeste,BUTANTAN/SINOVAC,2619,1328,1291
Tuparetama,261590,PE,Nordeste,FIOCRUZ/ASTRAZENECA,1726,1481,245
Tuparetama,261590,PE,Nordeste,PFIZER/BIONTECH,135,135,0
Tupãssi,412795,PR,Sul,BUTANTAN/SINOVAC,2396,1223,1173
Tupãssi,412795,PR,Sul,FIOCRUZ/ASTRAZENECA,2025,1888,137
Tupãssi,412795,PR,Sul,PFIZER/BIONTECH,98,98,0
Tupi Paulista,355510,SP,Sudeste,BUTANTAN/SINOVAC,5366,2759,2607
Tupi Paulista,355510,SP,Sudeste,FIOCRUZ/ASTRAZENECA,3821,3113,708
Tupi Paulista,355510,SP,Sudeste,PFIZER/BIONTECH,176,176,0
Tupirama,172125,TO,Norte,BUTANTAN/SINOVAC,383,210,173
Tupirama,172125,TO,Norte,FIOCRUZ/ASTRAZENECA,304,283,21
Tupiratins,172130,TO,Norte,BUTANTAN/SINOVAC,434,230,204
Tupiratins,172130,TO,Norte,FIOCRUZ/ASTRAZENECA,378,370,8
Turiaçu,211240,MA,Nordeste,FIOCRUZ/ASTRAZENECA,6619,6364,255
Turiaçu,211240,MA,Nordeste,BUTANTAN/SINOVAC,3680,1903,1777
Turilândia,211245,MA,Nordeste,FIOCRUZ/ASTRAZENECA,3304,3007,297
Turilândia,211245,MA,Nordeste,BUTANTAN/SINOVAC,2298,1229,1069
Turiúba,355520,SP,Sudeste,BUTANTAN/SINOVAC,737,351,386
Turiúba,355520,SP,Sudeste,FIOCRUZ/ASTRAZENECA,616,572,44
Turiúba,355520,SP,Sudeste,PFIZER/BIONTECH,62,62,0
Turmalina,316970,MG,Sudeste,FIOCRUZ/ASTRAZENECA,5099,4800,299
Turmalina,316970,MG,Sudeste,BUTANTAN/SINOVAC,3621,1834,1787
Turmalina,316970,MG,Sudeste,PFIZER/BIONTECH,311,310,1
Turmalina,355530,SP,Sudeste,BUTANTAN/SINOVAC,858,452,406
Turmalina,355530,SP,Sudeste,FIOCRUZ/ASTRAZENECA,756,676,80
Turmalina,355530,SP,Sudeste,PFIZER/BIONTECH,54,54,0
Turuçu,432232,RS,Sul,BUTANTAN/SINOVAC,1063,541,522
Turuçu,432232,RS,Sul,FIOCRUZ/ASTRAZENECA,851,812,39
Turuçu,432232,RS,Sul,PFIZER/BIONTECH,115,115,0
Tururu,231355,CE,Nordeste,FIOCRUZ/ASTRAZENECA,2616,2491,125
Tururu,231355,CE,Nordeste,BUTANTAN/SINOVAC,2597,1502,1095
Tururu,231355,CE,Nordeste,PFIZER/BIONTECH,1,0,1
Turvânia,522150,GO,Centro-Oeste,FIOCRUZ/ASTRAZENECA,1293,1211,82
Turvânia,522150,GO,Centro-Oeste,BUTANTAN/SINOVAC,1156,620,536
Turvelândia,522155,GO,Centro-Oeste,BUTANTAN/SINOVAC,710,361,349
Turvelândia,522155,GO,Centro-Oeste,FIOCRUZ/ASTRAZENECA,488,458,30
Turvo,412796,PR,Sul,FIOCRUZ/ASTRAZENECA,3384,3217,167
Turvo,412796,PR,Sul,BUTANTAN/SINOVAC,2958,1556,1402
Turvo,412796,PR,Sul,PFIZER/BIONTECH,165,165,0
Turvo,421880,SC,Sul,BUTANTAN/SINOVAC,2589,1335,1254
Turvo,421880,SC,Sul,FIOCRUZ/ASTRAZENECA,2359,2239,120
Turvo,421880,SC,Sul,PFIZER/BIONTECH,112,112,0
Turvolândia,316980,MG,Sudeste,BUTANTAN/SINOVAC,292,175,117
Turvolândia,316980,MG,Sudeste,FIOCRUZ/ASTRAZENECA,125,93,32
Tutóia,211250,MA,Nordeste,FIOCRUZ/ASTRAZENECA,11020,10621,399
Tutóia,211250,MA,Nordeste,BUTANTAN/SINOVAC,6100,3246,2854
Uarini,130426,AM,Norte,BUTANTAN/SINOVAC,1733,1084,649
Uarini,130426,AM,Norte,FIOCRUZ/ASTRAZENECA,1173,1027,146
Uauá,293200,BA,Nordeste,FIOCRUZ/ASTRAZENECA,6478,5981,497
Uauá,293200,BA,Nordeste,BUTANTAN/SINOVAC,5712,2945,2767
Uauá,293200,BA,Nordeste,PFIZER/BIONTECH,132,132,0
Ubá,316990,MG,Sudeste,BUTANTAN/SINOVAC,21668,11289,10379
Ubá,316990,MG,Sudeste,FIOCRUZ/ASTRAZENECA,18660,17337,1323
Ubá,316990,MG,Sudeste,PFIZER/BIONTECH,2566,2562,4
Ubaí,317000,MG,Sudeste,BUTANTAN/SINOVAC,1849,1266,583
Ubaí,317000,MG,Sudeste,FIOCRUZ/ASTRAZENECA,759,699,60
Ubaí,317000,MG,Sudeste,PFIZER/BIONTECH,89,89,0
Ubaíra,293210,BA,Nordeste,BUTANTAN/SINOVAC,2511,1388,1123
Ubaíra,293210,BA,Nordeste,FIOCRUZ/ASTRAZENECA,1498,1378,120
Ubaíra,293210,BA,Nordeste,PFIZER/BIONTECH,186,186,0
Ubaitaba,293220,BA,Nordeste,FIOCRUZ/ASTRAZENECA,4314,3981,333
Ubaitaba,293220,BA,Nordeste,BUTANTAN/SINOVAC,3457,1939,1518
Ubaitaba,293220,BA,Nordeste,PFIZER/BIONTECH,373,373,0
Ubajara,231360,CE,Nordeste,BUTANTAN/SINOVAC,4563,2506,2057
Ubajara,231360,CE,Nordeste,FIOCRUZ/ASTRAZENECA,3752,3490,262
Ubaporanga,317005,MG,Sudeste,BUTANTAN/SINOVAC,1695,857,838
Ubaporanga,317005,MG,Sudeste,FIOCRUZ/ASTRAZENECA,1258,1197,61
Ubarana,355535,SP,Sudeste,FIOCRUZ/ASTRAZENECA,1181,1115,66
Ubarana,355535,SP,Sudeste,BUTANTAN/SINOVAC,936,538,398
Ubarana,355535,SP,Sudeste,PFIZER/BIONTECH,126,126,0
Ubatã,293230,BA,Nordeste,BUTANTAN/SINOVAC,3841,2062,1779
Ubatã,293230,BA,Nordeste,FIOCRUZ/ASTRAZENECA,3124,2896,228
Ubatã,293230,BA,Nordeste,PFIZER/BIONTECH,1,1,0
Ubatuba,355540,SP,Sudeste,BUTANTAN/SINOVAC,20854,11639,9215
Ubatuba,355540,SP,Sudeste,FIOCRUZ/ASTRAZENECA,20264,18743,1521
Ubatuba,355540,SP,Sudeste,PFIZER/BIONTECH,1494,1493,1
Uberaba,317010,MG,Sudeste,BUTANTAN/SINOVAC,64763,34161,30602
Uberaba,317010,MG,Sudeste,FIOCRUZ/ASTRAZENECA,54149,48470,5679
Uberaba,317010,MG,Sudeste,PFIZER/BIONTECH,3456,3455,1
Uberlândia,317020,MG,Sudeste,FIOCRUZ/ASTRAZENECA,171298,157948,13350
Uberlândia,317020,MG,Sudeste,BUTANTAN/SINOVAC,167983,86899,81084
Uberlândia,317020,MG,Sudeste,PFIZER/BIONTECH,11259,11259,0
Ubirajara,355550,SP,Sudeste,FIOCRUZ/ASTRAZENECA,1075,966,109
Ubirajara,355550,SP,Sudeste,BUTANTAN/SINOVAC,395,163,232
Ubirajara,355550,SP,Sudeste,PFIZER/BIONTECH,48,48,0
Ubiratã,412800,PR,Sul,FIOCRUZ/ASTRAZENECA,8076,7537,539
Ubiratã,412800,PR,Sul,BUTANTAN/SINOVAC,6178,3050,3128
Ubiratã,412800,PR,Sul,PFIZER/BIONTECH,586,586,0
Ubiretama,432234,RS,Sul,FIOCRUZ/ASTRAZENECA,646,601,45
Ubiretama,432234,RS,Sul,BUTANTAN/SINOVAC,583,285,298
Ubiretama,432234,RS,Sul,PFIZER/BIONTECH,83,83,0
Uchoa,355560,SP,Sudeste,BUTANTAN/SINOVAC,2611,1361,1250
Uchoa,355560,SP,Sudeste,FIOCRUZ/ASTRAZENECA,2436,2142,294
Uchoa,355560,SP,Sudeste,PFIZER/BIONTECH,146,146,0
Uibaí,293240,BA,Nordeste,FIOCRUZ/ASTRAZENECA,3439,3081,358
Uibaí,293240,BA,Nordeste,BUTANTAN/SINOVAC,2838,1490,1348
Uibaí,293240,BA,Nordeste,PFIZER/BIONTECH,113,113,0
Uiramutã,140070,RR,Norte,BUTANTAN/SINOVAC,6966,4078,2888
Uiramutã,140070,RR,Norte,FIOCRUZ/ASTRAZENECA,212,212,0
Uirapuru,522157,GO,Centro-Oeste,FIOCRUZ/ASTRAZENECA,1007,980,27
Uirapuru,522157,GO,Centro-Oeste,BUTANTAN/SINOVAC,982,574,408
Uiraúna,251690,PB,Nordeste,BUTANTAN/SINOVAC,3847,2057,1790
Uiraúna,251690,PB,Nordeste,FIOCRUZ/ASTRAZENECA,2840,2680,160
Uiraúna,251690,PB,Nordeste,PFIZER/BIONTECH,115,115,0
Ulianópolis,150812,PA,Norte,FIOCRUZ/ASTRAZENECA,4471,4071,400
Ulianópolis,150812,PA,Norte,BUTANTAN/SINOVAC,3766,2014,1752
Umari,231370,CE,Nordeste,BUTANTAN/SINOVAC,1812,925,887
Umari,231370,CE,Nordeste,FIOCRUZ/ASTRAZENECA,904,815,89
Umarizal,241450,RN,Nordeste,BUTANTAN/SINOVAC,2781,1514,1267
Umarizal,241450,RN,Nordeste,FIOCRUZ/ASTRAZENECA,2388,2262,126
Umarizal,241450,RN,Nordeste,PFIZER/BIONTECH,195,195,0
Umbaúba,280760,SE,Nordeste,BUTANTAN/SINOVAC,3091,1836,1255
Umbaúba,280760,SE,Nordeste,FIOCRUZ/ASTRAZENECA,773,773,0
Umburanas,293245,BA,Nordeste,FIOCRUZ/ASTRAZENECA,2746,2450,296
Umburanas,293245,BA,Nordeste,BUTANTAN/SINOVAC,2344,1201,1143
Umburanas,293245,BA,Nordeste,PFIZER/BIONTECH,145,144,1
Umburatiba,317030,MG,Sudeste,BUTANTAN/SINOVAC,827,418,409
Umburatiba,317030,MG,Sudeste,FIOCRUZ/ASTRAZENECA,594,536,58
Umburatiba,317030,MG,Sudeste,PFIZER/BIONTECH,1,1,0
Umbuzeiro,251700,PB,Nordeste,BUTANTAN/SINOVAC,2600,1325,1275
Umbuzeiro,251700,PB,Nordeste,FIOCRUZ/ASTRAZENECA,1893,1728,165
Umbuzeiro,251700,PB,Nordeste,PFIZER/BIONTECH,192,192,0
Umirim,231375,CE,Nordeste,BUTANTAN/SINOVAC,2555,1450,1105
Umirim,231375,CE,Nordeste,FIOCRUZ/ASTRAZENECA,868,658,210
Umuarama,412810,PR,Sul,BUTANTAN/SINOVAC,25110,12890,12220
Umuarama,412810,PR,Sul,FIOCRUZ/ASTRAZENECA,24193,21559,2634
Umuarama,412810,PR,Sul,PFIZER/BIONTECH,5194,5193,1
Una,293250,BA,Nordeste,FIOCRUZ/ASTRAZENECA,4462,4191,271
Una,293250,BA,Nordeste,BUTANTAN/SINOVAC,4206,2040,2166
Una,293250,BA,Nordeste,PFIZER/BIONTECH,86,86,0
Unaí,317040,MG,Sudeste,BUTANTAN/SINOVAC,14696,7764,6932
Unaí,317040,MG,Sudeste,FIOCRUZ/ASTRAZENECA,10773,9734,1039
Unaí,317040,MG,Sudeste,PFIZER/BIONTECH,1202,1201,1
União,221110,PI,Nordeste,BUTANTAN/SINOVAC,8477,4621,3856
União,221110,PI,Nordeste,FIOCRUZ/ASTRAZENECA,5804,5095,709
União Da Serra,432235,RS,Sul,BUTANTAN/SINOVAC,506,259,247
União Da Serra,432235,RS,Sul,FIOCRUZ/ASTRAZENECA,333,332,1
União Da Serra,432235,RS,Sul,PFIZER/BIONTECH,12,12,0
União Da Vitória,412820,PR,Sul,BUTANTAN/SINOVAC,11161,5959,5202
União Da Vitória,412820,PR,Sul,FIOCRUZ/ASTRAZENECA,10384,9768,616
União Da Vitória,412820,PR,Sul,PFIZER/BIONTECH,3041,3041,0
União De Minas,317043,MG,Sudeste,FIOCRUZ/ASTRAZENECA,984,902,82
União De Minas,317043,MG,Sudeste,BUTANTAN/SINOVAC,914,469,445
União De Minas,317043,MG,Sudeste,PFIZER/BIONTECH,60,60,0
União Do Oeste,421885,SC,Sul,BUTANTAN/SINOVAC,868,473,395
União Do Oeste,421885,SC,Sul,FIOCRUZ/ASTRAZENECA,826,749,77
União Do Oeste,421885,SC,Sul,PFIZER/BIONTECH,60,60,0
União Do Sul,510830,MT,Centro-Oeste,BUTANTAN/SINOVAC,726,387,339
União Do Sul,510830,MT,Centro-Oeste,FIOCRUZ/ASTRAZENECA,642,612,30
União Do Sul,510830,MT,Centro-Oeste,PFIZER/BIONTECH,8,8,0
União Dos Palmares,270930,AL,Nordeste,FIOCRUZ/ASTRAZENECA,12141,10407,1734
União Dos Palmares,270930,AL,Nordeste,BUTANTAN/SINOVAC,9503,4877,4626
União Dos Palmares,270930,AL,Nordeste,PFIZER/BIONTECH,1401,1401,0
União Paulista,355570,SP,Sudeste,BUTANTAN/SINOVAC,407,214,193
União Paulista,355570,SP,Sudeste,FIOCRUZ/ASTRAZENECA,361,325,36
União Paulista,355570,SP,Sudeste,PFIZER/BIONTECH,60,60,0
Uniflor,412830,PR,Sul,FIOCRUZ/ASTRAZENECA,838,778,60
Uniflor,412830,PR,Sul,BUTANTAN/SINOVAC,653,336,317
Uniflor,412830,PR,Sul,PFIZER/BIONTECH,6,6,0
Unistalda,432237,RS,Sul,FIOCRUZ/ASTRAZENECA,817,682,135
Unistalda,432237,RS,Sul,BUTANTAN/SINOVAC,801,405,396
Unistalda,432237,RS,Sul,PFIZER/BIONTECH,113,113,0
Upanema,241460,RN,Nordeste,FIOCRUZ/ASTRAZENECA,2728,2630,98
Upanema,241460,RN,Nordeste,BUTANTAN/SINOVAC,2686,1364,1322
Upanema,241460,RN,Nordeste,PFIZER/BIONTECH,294,290,4
Uraí,412840,PR,Sul,FIOCRUZ/ASTRAZENECA,3290,3047,243
Uraí,412840,PR,Sul,BUTANTAN/SINOVAC,2947,1516,1431
Urandi,293260,BA,Nordeste,BUTANTAN/SINOVAC,2300,1798,502
Urandi,293260,BA,Nordeste,FIOCRUZ/ASTRAZENECA,1310,1305,5
Urânia,355580,SP,Sudeste,BUTANTAN/SINOVAC,2626,1322,1304
Urânia,355580,SP,Sudeste,FIOCRUZ/ASTRAZENECA,2404,2143,261
Urânia,355580,SP,Sudeste,PFIZER/BIONTECH,67,67,0
Urbano Santos,211260,MA,Nordeste,FIOCRUZ/ASTRAZENECA,4123,3883,240
Urbano Santos,211260,MA,Nordeste,BUTANTAN/SINOVAC,3331,1772,1559
Uru,355590,SP,Sudeste,BUTANTAN/SINOVAC,814,469,345
Uru,355590,SP,Sudeste,FIOCRUZ/ASTRAZENECA,608,517,91
Uru,355590,SP,Sudeste,PFIZER/BIONTECH,57,57,0
Uruaçu,522160,GO,Centro-Oeste,FIOCRUZ/ASTRAZENECA,10991,10339,652
Uruaçu,522160,GO,Centro-Oeste,BUTANTAN/SINOVAC,8381,4544,3837
Uruana,522170,GO,Centro-Oeste,FIOCRUZ/ASTRAZENECA,4072,3882,190
Uruana,522170,GO,Centro-Oeste,BUTANTAN/SINOVAC,2238,1296,942
Uruana,522170,GO,Centro-Oeste,PFIZER/BIONTECH,177,176,1
Uruana De Minas,317047,MG,Sudeste,BUTANTAN/SINOVAC,795,400,395
Uruana De Minas,317047,MG,Sudeste,FIOCRUZ/ASTRAZENECA,783,748,35
Uruana De Minas,317047,MG,Sudeste,PFIZER/BIONTECH,40,40,0
Uruará,150815,PA,Norte,BUTANTAN/SINOVAC,3419,1795,1624
Uruará,150815,PA,Norte,FIOCRUZ/ASTRAZENECA,3344,3116,228
Urubici,421890,SC,Sul,FIOCRUZ/ASTRAZENECA,2840,2633,207
Urubici,421890,SC,Sul,BUTANTAN/SINOVAC,2489,1343,1146
Urubici,421890,SC,Sul,PFIZER/BIONTECH,165,165,0
Uruburetama,231380,CE,Nordeste,FIOCRUZ/ASTRAZENECA,3229,2939,290
Uruburetama,231380,CE,Nordeste,BUTANTAN/SINOVAC,2958,1535,1423
Uruburetama,231380,CE,Nordeste,PFIZER/BIONTECH,90,90,0
Urucânia,317050,MG,Sudeste,FIOCRUZ/ASTRAZENECA,2334,2180,154
Urucânia,317050,MG,Sudeste,BUTANTAN/SINOVAC,2022,1036,986
Urucânia,317050,MG,Sudeste,PFIZER/BIONTECH,105,105,0
Urucará,130430,AM,Norte,FIOCRUZ/ASTRAZENECA,4146,3527,619
Urucará,130430,AM,Norte,BUTANTAN/SINOVAC,2238,1182,1056
Uruçuca,293270,BA,Nordeste,BUTANTAN/SINOVAC,3989,2088,1901
Uruçuca,293270,BA,Nordeste,FIOCRUZ/ASTRAZENECA,3697,3443,254
Uruçuca,293270,BA,Nordeste,PFIZER/BIONTECH,29,29,0
Uruçuí,221120,PI,Nordeste,FIOCRUZ/ASTRAZENECA,3090,2978,112
Uruçuí,221120,PI,Nordeste,BUTANTAN/SINOVAC,1979,1020,959
Urucuia,317052,MG,Sudeste,BUTANTAN/SINOVAC,2185,1135,1050
Urucuia,317052,MG,Sudeste,FIOCRUZ/ASTRAZENECA,2036,1870,166
Urucuia,317052,MG,Sudeste,PFIZER/BIONTECH,136,136,0
Urucurituba,130440,AM,Norte,BUTANTAN/SINOVAC,1474,853,621
Urucurituba,130440,AM,Norte,FIOCRUZ/ASTRAZENECA,1345,1023,322
Uruguaiana,432240,RS,Sul,FIOCRUZ/ASTRAZENECA,27975,26061,1914
Uruguaiana,432240,RS,Sul,BUTANTAN/SINOVAC,25862,13481,12381
Uruguaiana,432240,RS,Sul,PFIZER/BIONTECH,2595,2593,2
Uruoca,231390,CE,Nordeste,BUTANTAN/SINOVAC,2232,1188,1044
Uruoca,231390,CE,Nordeste,FIOCRUZ/ASTRAZENECA,1468,1313,155
Uruoca,231390,CE,Nordeste,PFIZER/BIONTECH,6,6,0
Urupá,110170,RO,Norte,BUTANTAN/SINOVAC,2524,1493,1031
Urupá,110170,RO,Norte,FIOCRUZ/ASTRAZENECA,2319,2242,77
Urupá,110170,RO,Norte,PFIZER/BIONTECH,171,171,0
Urupema,421895,SC,Sul,BUTANTAN/SINOVAC,800,406,394
Urupema,421895,SC,Sul,FIOCRUZ/ASTRAZENECA,759,709,50
Urupês,355600,SP,Sudeste,BUTANTAN/SINOVAC,3307,1756,1551
Urupês,355600,SP,Sudeste,FIOCRUZ/ASTRAZENECA,3262,2926,336
Urupês,355600,SP,Sudeste,PFIZER/BIONTECH,113,113,0
Urussanga,421900,SC,Sul,FIOCRUZ/ASTRAZENECA,5904,5392,512
Urussanga,421900,SC,Sul,BUTANTAN/SINOVAC,4195,2268,1927
Urussanga,421900,SC,Sul,PFIZER/BIONTECH,251,251,0
Urutaí,522180,GO,Centro-Oeste,FIOCRUZ/ASTRAZENECA,1035,957,78
Urutaí,522180,GO,Centro-Oeste,BUTANTAN/SINOVAC,635,330,305
Utinga,293280,BA,Nordeste,FIOCRUZ/ASTRAZENECA,3555,3303,252
Utinga,293280,BA,Nordeste,BUTANTAN/SINOVAC,3232,1699,1533
Utinga,293280,BA,Nordeste,PFIZER/BIONTECH,18,18,0
Vacaria,432250,RS,Sul,FIOCRUZ/ASTRAZENECA,16250,14949,1301
Vacaria,432250,RS,Sul,BUTANTAN/SINOVAC,14429,7456,6973
Vacaria,432250,RS,Sul,PFIZER/BIONTECH,482,482,0
Vale De São Domingos,510835,MT,Centro-Oeste,FIOCRUZ/ASTRAZENECA,663,623,40
Vale De São Domingos,510835,MT,Centro-Oeste,BUTANTAN/SINOVAC,599,302,297
Vale Do Anari,110175,RO,Norte,BUTANTAN/SINOVAC,1649,840,809
Vale Do Anari,110175,RO,Norte,FIOCRUZ/ASTRAZENECA,1386,1361,25
Vale Do Anari,110175,RO,Norte,PFIZER/BIONTECH,47,47,0
Vale Do Paraíso,110180,RO,Norte,BUTANTAN/SINOVAC,1464,750,714
Vale Do Paraíso,110180,RO,Norte,FIOCRUZ/ASTRAZENECA,705,663,42
Vale Do Paraíso,110180,RO,Norte,PFIZER/BIONTECH,19,19,0
Vale Do Sol,432253,RS,Sul,BUTANTAN/SINOVAC,2798,1429,1369
Vale Do Sol,432253,RS,Sul,FIOCRUZ/ASTRAZENECA,2773,2612,161
Vale Do Sol,432253,RS,Sul,PFIZER/BIONTECH,296,296,0
Vale Real,432254,RS,Sul,FIOCRUZ/ASTRAZENECA,1195,1107,88
Vale Real,432254,RS,Sul,BUTANTAN/SINOVAC,1016,513,503
Vale Real,432254,RS,Sul,PFIZER/BIONTECH,71,71,0
Vale Verde,432252,RS,Sul,FIOCRUZ/ASTRAZENECA,1057,864,193
Vale Verde,432252,RS,Sul,BUTANTAN/SINOVAC,993,516,477
Vale Verde,432252,RS,Sul,PFIZER/BIONTECH,133,133,0
Valença,293290,BA,Nordeste,BUTANTAN/SINOVAC,11478,6056,5422
Valença,293290,BA,Nordeste,FIOCRUZ/ASTRAZENECA,11335,10597,738
Valença,293290,BA,Nordeste,PFIZER/BIONTECH,62,62,0
Valença,330610,RJ,Sudeste,BUTANTAN/SINOVAC,19600,10063,9537
Valença,330610,RJ,Sudeste,FIOCRUZ/ASTRAZENECA,13310,12595,715
Valença Do Piauí,221130,PI,Nordeste,FIOCRUZ/ASTRAZENECA,5559,4667,892
Valença Do Piauí,221130,PI,Nordeste,BUTANTAN/SINOVAC,4991,2534,2457
Valente,293300,BA,Nordeste,FIOCRUZ/ASTRAZENECA,5503,4698,805
Valente,293300,BA,Nordeste,BUTANTAN/SINOVAC,5212,2758,2454
Valente,293300,BA,Nordeste,PFIZER/BIONTECH,800,800,0
Valentim Gentil,355610,SP,Sudeste,BUTANTAN/SINOVAC,2392,1246,1146
Valentim Gentil,355610,SP,Sudeste,FIOCRUZ/ASTRAZENECA,2106,1915,191
Valentim Gentil,355610,SP,Sudeste,PFIZER/BIONTECH,128,127,1
Valinhos,355620,SP,Sudeste,BUTANTAN/SINOVAC,29161,16637,12524
Valinhos,355620,SP,Sudeste,FIOCRUZ/ASTRAZENECA,28247,26638,1609
Valinhos,355620,SP,Sudeste,PFIZER/BIONTECH,926,926,0
Valparaíso,355630,SP,Sudeste,BUTANTAN/SINOVAC,5233,2919,2314
Valparaíso,355630,SP,Sudeste,FIOCRUZ/ASTRAZENECA,4449,3919,530
Valparaíso,355630,SP,Sudeste,PFIZER/BIONTECH,230,230,0
Valparaíso De Goiás,522185,GO,Centro-Oeste,FIOCRUZ/ASTRAZENECA,20016,18930,1086
Valparaíso De Goiás,522185,GO,Centro-Oeste,BUTANTAN/SINOVAC,15470,8054,7416
Vanini,432255,RS,Sul,FIOCRUZ/ASTRAZENECA,620,572,48
Vanini,432255,RS,Sul,BUTANTAN/SINOVAC,499,251,248
Vanini,432255,RS,Sul,PFIZER/BIONTECH,78,78,0
Vargeão,421910,SC,Sul,FIOCRUZ/ASTRAZENECA,955,853,102
Vargeão,421910,SC,Sul,BUTANTAN/SINOVAC,889,493,396
Vargeão,421910,SC,Sul,PFIZER/BIONTECH,64,64,0
Vargem,355635,SP,Sudeste,BUTANTAN/SINOVAC,2846,1428,1418
Vargem,355635,SP,Sudeste,FIOCRUZ/ASTRAZENECA,2074,1835,239
Vargem,355635,SP,Sudeste,PFIZER/BIONTECH,95,95,0
Vargem,421915,SC,Sul,FIOCRUZ/ASTRAZENECA,691,660,31
Vargem,421915,SC,Sul,BUTANTAN/SINOVAC,652,341,311
Vargem,421915,SC,Sul,PFIZER/BIONTECH,54,54,0
Vargem Alegre,317057,MG,Sudeste,BUTANTAN/SINOVAC,1330,708,622
Vargem Alegre,317057,MG,Sudeste,FIOCRUZ/ASTRAZENECA,303,257,46
Vargem Alta,320503,ES,Sudeste,BUTANTAN/SINOVAC,4712,2554,2158
Vargem Alta,320503,ES,Sudeste,FIOCRUZ/ASTRAZENECA,4030,3852,178
Vargem Alta,320503,ES,Sudeste,PFIZER/BIONTECH,556,556,0
Vargem Bonita,317060,MG,Sudeste,BUTANTAN/SINOVAC,592,315,277
Vargem Bonita,317060,MG,Sudeste,FIOCRUZ/ASTRAZENECA,583,528,55
Vargem Bonita,317060,MG,Sudeste,PFIZER/BIONTECH,28,28,0
Vargem Bonita,421917,SC,Sul,FIOCRUZ/ASTRAZENECA,1021,934,87
Vargem Bonita,421917,SC,Sul,BUTANTAN/SINOVAC,919,469,450
Vargem Bonita,421917,SC,Sul,PFIZER/BIONTECH,110,110,0
Vargem Grande,211270,MA,Nordeste,BUTANTAN/SINOVAC,4446,2641,1805
Vargem Grande,211270,MA,Nordeste,FIOCRUZ/ASTRAZENECA,3689,3400,289
Vargem Grande Do Rio Pardo,317065,MG,Sudeste,BUTANTAN/SINOVAC,846,440,406
Vargem Grande Do Rio Pardo,317065,MG,Sudeste,FIOCRUZ/ASTRAZENECA,672,646,26
Vargem Grande Do Rio Pardo,317065,MG,Sudeste,PFIZER/BIONTECH,102,102,0
Vargem Grande Do Sul,355640,SP,Sudeste,FIOCRUZ/ASTRAZENECA,11520,10298,1222
Vargem Grande Do Sul,355640,SP,Sudeste,BUTANTAN/SINOVAC,10535,5091,5444
Vargem Grande Do Sul,355640,SP,Sudeste,PFIZER/BIONTECH,522,522,0
Vargem Grande Paulista,355645,SP,Sudeste,BUTANTAN/SINOVAC,8172,4462,3710
Vargem Grande Paulista,355645,SP,Sudeste,FIOCRUZ/ASTRAZENECA,6233,5728,505
Vargem Grande Paulista,355645,SP,Sudeste,PFIZER/BIONTECH,431,431,0
Varginha,317070,MG,Sudeste,FIOCRUZ/ASTRAZENECA,25286,22716,2570
Varginha,317070,MG,Sudeste,BUTANTAN/SINOVAC,24822,12600,12222
Varginha,317070,MG,Sudeste,PFIZER/BIONTECH,1637,1637,0
Varjão,522190,GO,Centro-Oeste,FIOCRUZ/ASTRAZENECA,1316,1233,83
Varjão,522190,GO,Centro-Oeste,BUTANTAN/SINOVAC,973,526,447
Varjão De Minas,317075,MG,Sudeste,BUTANTAN/SINOVAC,1918,1002,916
Varjão De Minas,317075,MG,Sudeste,FIOCRUZ/ASTRAZENECA,1534,1435,99
Varjão De Minas,317075,MG,Sudeste,PFIZER/BIONTECH,196,196,0
Varjota,231395,CE,Nordeste,BUTANTAN/SINOVAC,2256,1616,640
Varjota,231395,CE,Nordeste,FIOCRUZ/ASTRAZENECA,1371,1342,29
Varre-Sai,330615,RJ,Sudeste,BUTANTAN/SINOVAC,1810,1032,778
Varre-Sai,330615,RJ,Sudeste,FIOCRUZ/ASTRAZENECA,643,574,69
Várzea,241470,RN,Nordeste,BUTANTAN/SINOVAC,1305,711,594
Várzea,241470,RN,Nordeste,FIOCRUZ/ASTRAZENECA,863,782,81
Várzea,241470,RN,Nordeste,PFIZER/BIONTECH,148,148,0
Várzea,251710,PB,Nordeste,FIOCRUZ/ASTRAZENECA,974,911,63
Várzea,251710,PB,Nordeste,BUTANTAN/SINOVAC,911,458,453
Várzea,251710,PB,Nordeste,PFIZER/BIONTECH,102,102,0
Várzea Alegre,231400,CE,Nordeste,BUTANTAN/SINOVAC,9297,5143,4154
Várzea Alegre,231400,CE,Nordeste,FIOCRUZ/ASTRAZENECA,2671,2114,557
Várzea Branca,221135,PI,Nordeste,FIOCRUZ/ASTRAZENECA,1202,1160,42
Várzea Branca,221135,PI,Nordeste,BUTANTAN/SINOVAC,781,384,397
Várzea Da Palma,317080,MG,Sudeste,FIOCRUZ/ASTRAZENECA,6233,5860,373
Várzea Da Palma,317080,MG,Sudeste,BUTANTAN/SINOVAC,5967,3028,2939
Várzea Da Palma,317080,MG,Sudeste,PFIZER/BIONTECH,356,356,0
Várzea Da Roça,293305,BA,Nordeste,BUTANTAN/SINOVAC,3027,1563,1464
Várzea Da Roça,293305,BA,Nordeste,FIOCRUZ/ASTRAZENECA,2636,2340,296
Várzea Da Roça,293305,BA,Nordeste,PFIZER/BIONTECH,169,169,0
Várzea Do Poço,293310,BA,Nordeste,BUTANTAN/SINOVAC,2204,1115,1089
Várzea Do Poço,293310,BA,Nordeste,FIOCRUZ/ASTRAZENECA,2017,1814,203
Várzea Do Poço,293310,BA,Nordeste,PFIZER/BIONTECH,183,183,0
Várzea Grande,221140,PI,Nordeste,BUTANTAN/SINOVAC,759,419,340
Várzea Grande,221140,PI,Nordeste,FIOCRUZ/ASTRAZENECA,584,539,45
Várzea Grande,510840,MT,Centro-Oeste,BUTANTAN/SINOVAC,40996,21198,19798
Várzea Grande,510840,MT,Centro-Oeste,FIOCRUZ/ASTRAZENECA,36453,33616,2837
Várzea Grande,510840,MT,Centro-Oeste,PFIZER/BIONTECH,8910,8895,15
Várzea Nova,293315,BA,Nordeste,BUTANTAN/SINOVAC,2825,1442,1383
Várzea Nova,293315,BA,Nordeste,FIOCRUZ/ASTRAZENECA,2508,2281,227
Várzea Nova,293315,BA,Nordeste,PFIZER/BIONTECH,35,35,0
Várzea Paulista,355650,SP,Sudeste,FIOCRUZ/ASTRAZENECA,17968,16889,1079
Várzea Paulista,355650,SP,Sudeste,BUTANTAN/SINOVAC,14518,7731,6787
Várzea Paulista,355650,SP,Sudeste,PFIZER/BIONTECH,1687,1686,1
Varzedo,293317,BA,Nordeste,FIOCRUZ/ASTRAZENECA,1926,1703,223
Varzedo,293317,BA,Nordeste,BUTANTAN/SINOVAC,1851,964,887
Varzedo,293317,BA,Nordeste,PFIZER/BIONTECH,337,337,0
Varzelândia,317090,MG,Sudeste,FIOCRUZ/ASTRAZENECA,3317,3111,206
Varzelândia,317090,MG,Sudeste,BUTANTAN/SINOVAC,2888,1524,1364
Varzelândia,317090,MG,Sudeste,PFIZER/BIONTECH,64,64,0
Vassouras,330620,RJ,Sudeste,BUTANTAN/SINOVAC,5353,3187,2166
Vassouras,330620,RJ,Sudeste,FIOCRUZ/ASTRAZENECA,3943,3809,134
Vassouras,330620,RJ,Sudeste,PFIZER/BIONTECH,761,758,3
Vazante,317100,MG,Sudeste,FIOCRUZ/ASTRAZENECA,6711,5979,732
Vazante,317100,MG,Sudeste,BUTANTAN/SINOVAC,3841,1950,1891
Vazante,317100,MG,Sudeste,PFIZER/BIONTECH,52,52,0
Venâncio Aires,432260,RS,Sul,BUTANTAN/SINOVAC,17328,9008,8320
Venâncio Aires,432260,RS,Sul,FIOCRUZ/ASTRAZENECA,17181,15640,1541
Venâncio Aires,432260,RS,Sul,PFIZER/BIONTECH,1994,1993,1
Venda Nova Do Imigrante,320506,ES,Sudeste,BUTANTAN/SINOVAC,6449,3353,3096
Venda Nova Do Imigrante,320506,ES,Sudeste,FIOCRUZ/ASTRAZENECA,4742,4537,205
Venda Nova Do Imigrante,320506,ES,Sudeste,PFIZER/BIONTECH,1518,1517,1
Venha-Ver,241475,RN,Nordeste,BUTANTAN/SINOVAC,767,415,352
Venha-Ver,241475,RN,Nordeste,FIOCRUZ/ASTRAZENECA,573,553,20
Venha-Ver,241475,RN,Nordeste,PFIZER/BIONTECH,40,40,0
Ventania,412853,PR,Sul,FIOCRUZ/ASTRAZENECA,2332,2218,114
Ventania,412853,PR,Sul,BUTANTAN/SINOVAC,1903,996,907
Ventania,412853,PR,Sul,PFIZER/BIONTECH,129,129,0
Venturosa,261600,PE,Nordeste,BUTANTAN/SINOVAC,3014,1531,1483
Venturosa,261600,PE,Nordeste,FIOCRUZ/ASTRAZENECA,2516,2289,227
Venturosa,261600,PE,Nordeste,PFIZER/BIONTECH,195,195,0
Vera,510850,MT,Centro-Oeste,FIOCRUZ/ASTRAZENECA,1689,1638,51
Vera,510850,MT,Centro-Oeste,BUTANTAN/SINOVAC,1543,790,753
Vera,510850,MT,Centro-Oeste,PFIZER/BIONTECH,120,120,0
Vera Cruz,241480,RN,Nordeste,BUTANTAN/SINOVAC,2073,1102,971
Vera Cruz,241480,RN,Nordeste,FIOCRUZ/ASTRAZENECA,1603,1495,108
Vera Cruz,241480,RN,Nordeste,PFIZER/BIONTECH,355,355,0
Vera Cruz,293320,BA,Nordeste,BUTANTAN/SINOVAC,5009,3761,1248
Vera Cruz,293320,BA,Nordeste,FIOCRUZ/ASTRAZENECA,2651,2569,82
Vera Cruz,293320,BA,Nordeste,PFIZER/BIONTECH,222,222,0
Vera Cruz,355660,SP,Sudeste,BUTANTAN/SINOVAC,2860,1430,1430
Vera Cruz,355660,SP,Sudeste,FIOCRUZ/ASTRAZENECA,2530,2238,292
Vera Cruz,432270,RS,Sul,BUTANTAN/SINOVAC,6536,3604,2932
Vera Cruz,432270,RS,Sul,FIOCRUZ/ASTRAZENECA,4532,4300,232
Vera Cruz,432270,RS,Sul,PFIZER/BIONTECH,247,247,0
Vera Cruz Do Oeste,412855,PR,Sul,FIOCRUZ/ASTRAZENECA,2725,2579,146
Vera Cruz Do Oeste,412855,PR,Sul,BUTANTAN/SINOVAC,2028,1089,939
Vera Mendes,221150,PI,Nordeste,FIOCRUZ/ASTRAZENECA,885,875,10
Vera Mendes,221150,PI,Nordeste,BUTANTAN/SINOVAC,801,453,348
Veranópolis,432280,RS,Sul,FIOCRUZ/ASTRAZENECA,7027,6040,987
Veranópolis,432280,RS,Sul,BUTANTAN/SINOVAC,6949,3532,3417
Veranópolis,432280,RS,Sul,PFIZER/BIONTECH,610,609,1
Verdejante,261610,PE,Nordeste,FIOCRUZ/ASTRAZENECA,2433,2214,219
Verdejante,261610,PE,Nordeste,BUTANTAN/SINOVAC,2108,1072,1036
Verdejante,261610,PE,Nordeste,PFIZER/BIONTECH,136,136,0
Verdelândia,317103,MG,Sudeste,FIOCRUZ/ASTRAZENECA,2040,1976,64
Verdelândia,317103,MG,Sudeste,BUTANTAN/SINOVAC,1072,543,529
Verdelândia,317103,MG,Sudeste,PFIZER/BIONTECH,25,25,0
Verê,412860,PR,Sul,FIOCRUZ/ASTRAZENECA,2236,2134,102
Verê,412860,PR,Sul,BUTANTAN/SINOVAC,1922,985,937
Verê,412860,PR,Sul,PFIZER/BIONTECH,106,106,0
Vereda,293325,BA,Nordeste,BUTANTAN/SINOVAC,1609,825,784
Vereda,293325,BA,Nordeste,FIOCRUZ/ASTRAZENECA,1110,1003,107
Vereda,293325,BA,Nordeste,PFIZER/BIONTECH,54,54,0
Veredinha,317107,MG,Sudeste,FIOCRUZ/ASTRAZENECA,1253,1131,122
Veredinha,317107,MG,Sudeste,BUTANTAN/SINOVAC,1094,555,539
Veredinha,317107,MG,Sudeste,PFIZER/BIONTECH,148,148,0
Veríssimo,317110,MG,Sudeste,BUTANTAN/SINOVAC,894,459,435
Veríssimo,317110,MG,Sudeste,FIOCRUZ/ASTRAZENECA,839,773,66
Vermelho Novo,317115,MG,Sudeste,BUTANTAN/SINOVAC,1404,705,699
Vermelho Novo,317115,MG,Sudeste,FIOCRUZ/ASTRAZENECA,769,652,117
Vertente Do Lério,261618,PE,Nordeste,FIOCRUZ/ASTRAZENECA,1733,1570,163
Vertente Do Lério,261618,PE,Nordeste,BUTANTAN/SINOVAC,1732,866,866
Vertente Do Lério,261618,PE,Nordeste,PFIZER/BIONTECH,215,215,0
Vertentes,261620,PE,Nordeste,BUTANTAN/SINOVAC,3242,1743,1499
Vertentes,261620,PE,Nordeste,FIOCRUZ/ASTRAZENECA,3101,2778,323
Vertentes,261620,PE,Nordeste,PFIZER/BIONTECH,232,232,0
Vespasiano,317120,MG,Sudeste,BUTANTAN/SINOVAC,11162,6981,4181
Vespasiano,317120,MG,Sudeste,FIOCRUZ/ASTRAZENECA,8036,7665,371
Vespasiano,317120,MG,Sudeste,PFIZER/BIONTECH,276,274,2
Vespasiano Correa,432285,RS,Sul,BUTANTAN/SINOVAC,801,427,374
Vespasiano Correa,432285,RS,Sul,FIOCRUZ/ASTRAZENECA,553,465,88
Vespasiano Correa,432285,RS,Sul,PFIZER/BIONTECH,72,72,0
Viadutos,432290,RS,Sul,BUTANTAN/SINOVAC,1785,902,883
Viadutos,432290,RS,Sul,FIOCRUZ/ASTRAZENECA,1551,1327,224
Viadutos,432290,RS,Sul,PFIZER/BIONTECH,210,210,0
Viamão,432300,RS,Sul,BUTANTAN/SINOVAC,58559,29552,29007
Viamão,432300,RS,Sul,FIOCRUZ/ASTRAZENECA,53768,50338,3430
Viamão,432300,RS,Sul,PFIZER/BIONTECH,3445,3430,15
Viana,211280,MA,Nordeste,FIOCRUZ/ASTRAZENECA,13410,12584,826
Viana,211280,MA,Nordeste,BUTANTAN/SINOVAC,7161,3711,3450
Viana,211280,MA,Nordeste,PFIZER/BIONTECH,135,135,0
Viana,320510,ES,Sudeste,FIOCRUZ/ASTRAZENECA,15670,15324,346
Viana,320510,ES,Sudeste,BUTANTAN/SINOVAC,13498,7286,6212
Viana,320510,ES,Sudeste,PFIZER/BIONTECH,584,581,3
Vianópolis,522200,GO,Centro-Oeste,FIOCRUZ/ASTRAZENECA,2970,2742,228
Vianópolis,522200,GO,Centro-Oeste,BUTANTAN/SINOVAC,2418,1282,1136
Vicência,261630,PE,Nordeste,FIOCRUZ/ASTRAZENECA,7281,6415,866
Vicência,261630,PE,Nordeste,BUTANTAN/SINOVAC,4083,2124,1959
Vicência,261630,PE,Nordeste,PFIZER/BIONTECH,563,563,0
Vicente Dutra,432310,RS,Sul,BUTANTAN/SINOVAC,1309,673,636
Vicente Dutra,432310,RS,Sul,FIOCRUZ/ASTRAZENECA,734,681,53
Vicente Dutra,432310,RS,Sul,PFIZER/BIONTECH,70,70,0
Vicentina,500840,MS,Centro-Oeste,FIOCRUZ/ASTRAZENECA,2082,1744,338
Vicentina,500840,MS,Centro-Oeste,BUTANTAN/SINOVAC,1832,965,867
Vicentina,500840,MS,Centro-Oeste,PFIZER/BIONTECH,283,283,0
Vicentinópolis,522205,GO,Centro-Oeste,FIOCRUZ/ASTRAZENECA,1895,1795,100
Vicentinópolis,522205,GO,Centro-Oeste,BUTANTAN/SINOVAC,1334,690,644
Vicentinópolis,522205,GO,Centro-Oeste,PFIZER/BIONTECH,144,144,0
Viçosa,241490,RN,Nordeste,BUTANTAN/SINOVAC,64,64,0
Viçosa,270940,AL,Nordeste,FIOCRUZ/ASTRAZENECA,5242,4851,391
Viçosa,270940,AL,Nordeste,BUTANTAN/SINOVAC,4457,2285,2172
Viçosa,270940,AL,Nordeste,PFIZER/BIONTECH,10,10,0
Viçosa,317130,MG,Sudeste,FIOCRUZ/ASTRAZENECA,16108,13794,2314
Viçosa,317130,MG,Sudeste,BUTANTAN/SINOVAC,15303,8157,7146
Viçosa,317130,MG,Sudeste,PFIZER/BIONTECH,1829,1829,0
Viçosa Do Ceará,231410,CE,Nordeste,BUTANTAN/SINOVAC,8757,4658,4099
Viçosa Do Ceará,231410,CE,Nordeste,FIOCRUZ/ASTRAZENECA,4737,3972,765
Victor Graeff,432320,RS,Sul,BUTANTAN/SINOVAC,925,533,392
Victor Graeff,432320,RS,Sul,FIOCRUZ/ASTRAZENECA,848,766,82
Victor Graeff,432320,RS,Sul,PFIZER/BIONTECH,58,58,0
Vidal Ramos,421920,SC,Sul,FIOCRUZ/ASTRAZENECA,1524,1447,77
Vidal Ramos,421920,SC,Sul,BUTANTAN/SINOVAC,1238,659,579
Vidal Ramos,421920,SC,Sul,PFIZER/BIONTECH,42,42,0
Videira,421930,SC,Sul,FIOCRUZ/ASTRAZENECA,10279,9456,823
Videira,421930,SC,Sul,BUTANTAN/SINOVAC,8237,4296,3941
Videira,421930,SC,Sul,PFIZER/BIONTECH,693,693,0
Vieiras,317140,MG,Sudeste,FIOCRUZ/ASTRAZENECA,980,890,90
Vieiras,317140,MG,Sudeste,BUTANTAN/SINOVAC,952,472,480
Vieiras,317140,MG,Sudeste,PFIZER/BIONTECH,52,52,0
Vieirópolis,251720,PB,Nordeste,BUTANTAN/SINOVAC,1897,962,935
Vieirópolis,251720,PB,Nordeste,FIOCRUZ/ASTRAZENECA,974,868,106
Vigia,150820,PA,Norte,BUTANTAN/SINOVAC,5199,3621,1578
Vigia,150820,PA,Norte,FIOCRUZ/ASTRAZENECA,5003,4799,204
Vila Bela Da Santíssima Trindade,510550,MT,Centro-Oeste,FIOCRUZ/ASTRAZENECA,2942,2751,191
Vila Bela Da Santíssima Trindade,510550,MT,Centro-Oeste,BUTANTAN/SINOVAC,1971,1099,872
Vila Bela Da Santíssima Trindade,510550,MT,Centro-Oeste,PFIZER/BIONTECH,151,150,1
Vila Boa,522220,GO,Centro-Oeste,BUTANTAN/SINOVAC,992,501,491
Vila Boa,522220,GO,Centro-Oeste,FIOCRUZ/ASTRAZENECA,991,931,60
Vila Flor,241500,RN,Nordeste,BUTANTAN/SINOVAC,515,270,245
Vila Flor,241500,RN,Nordeste,FIOCRUZ/ASTRAZENECA,353,330,23
Vila Flor,241500,RN,Nordeste,PFIZER/BIONTECH,27,27,0
Vila Flores,432330,RS,Sul,FIOCRUZ/ASTRAZENECA,1129,1012,117
Vila Flores,432330,RS,Sul,BUTANTAN/SINOVAC,1022,515,507
Vila Flores,432330,RS,Sul,PFIZER/BIONTECH,103,103,0
Vila Lângaro,432335,RS,Sul,BUTANTAN/SINOVAC,686,355,331
Vila Lângaro,432335,RS,Sul,FIOCRUZ/ASTRAZENECA,598,506,92
Vila Lângaro,432335,RS,Sul,PFIZER/BIONTECH,104,104,0
Vila Maria,432340,RS,Sul,BUTANTAN/SINOVAC,1299,660,639
Vila Maria,432340,RS,Sul,FIOCRUZ/ASTRAZENECA,1170,1064,106
Vila Maria,432340,RS,Sul,PFIZER/BIONTECH,132,132,0
Vila Nova Do Piauí,221160,PI,Nordeste,BUTANTAN/SINOVAC,622,318,304
Vila Nova Do Piauí,221160,PI,Nordeste,FIOCRUZ/ASTRAZENECA,584,543,41
Vila Nova Do Sul,432345,RS,Sul,FIOCRUZ/ASTRAZENECA,1831,1416,415
Vila Nova Do Sul,432345,RS,Sul,BUTANTAN/SINOVAC,1338,680,658
Vila Nova Do Sul,432345,RS,Sul,PFIZER/BIONTECH,183,183,0
Vila Nova Dos Martírios,211285,MA,Nordeste,FIOCRUZ/ASTRAZENECA,1969,1717,252
Vila Nova Dos Martírios,211285,MA,Nordeste,BUTANTAN/SINOVAC,1426,756,670
Vila Pavão,320515,ES,Sudeste,BUTANTAN/SINOVAC,2232,1169,1063
Vila Pavão,320515,ES,Sudeste,FIOCRUZ/ASTRAZENECA,2195,2099,96
Vila Pavão,320515,ES,Sudeste,PFIZER/BIONTECH,323,322,1
Vila Propício,522230,GO,Centro-Oeste,FIOCRUZ/ASTRAZENECA,1447,1399,48
Vila Propício,522230,GO,Centro-Oeste,BUTANTAN/SINOVAC,819,430,389
Vila Rica,510860,MT,Centro-Oeste,BUTANTAN/SINOVAC,3359,1969,1390
Vila Rica,510860,MT,Centro-Oeste,FIOCRUZ/ASTRAZENECA,1954,1820,134
Vila Rica,510860,MT,Centro-Oeste,PFIZER/BIONTECH,183,183,0
Vila Valério,320517,ES,Sudeste,BUTANTAN/SINOVAC,2934,1763,1171
Vila Valério,320517,ES,Sudeste,FIOCRUZ/ASTRAZENECA,2834,2727,107
Vila Valério,320517,ES,Sudeste,PFIZER/BIONTECH,461,461,0
Vila Velha,320520,ES,Sudeste,FIOCRUZ/ASTRAZENECA,143255,129062,14193
Vila Velha,320520,ES,Sudeste,BUTANTAN/SINOVAC,96218,52272,43946
Vila Velha,320520,ES,Sudeste,PFIZER/BIONTECH,4997,4996,1
Vilhena,110030,RO,Norte,BUTANTAN/SINOVAC,16802,8648,8154
Vilhena,110030,RO,Norte,FIOCRUZ/ASTRAZENECA,14881,14153,728
Vilhena,110030,RO,Norte,PFIZER/BIONTECH,1257,1257,0
Vinhedo,355670,SP,Sudeste,BUTANTAN/SINOVAC,15751,8145,7606
Vinhedo,355670,SP,Sudeste,FIOCRUZ/ASTRAZENECA,14775,13639,1136
Vinhedo,355670,SP,Sudeste,PFIZER/BIONTECH,314,313,1
Viradouro,355680,SP,Sudeste,FIOCRUZ/ASTRAZENECA,4764,4302,462
Viradouro,355680,SP,Sudeste,BUTANTAN/SINOVAC,4329,2287,2042
Viradouro,355680,SP,Sudeste,PFIZER/BIONTECH,365,365,0
Virgem Da Lapa,317160,MG,Sudeste,FIOCRUZ/ASTRAZENECA,3489,3315,174
Virgem Da Lapa,317160,MG,Sudeste,BUTANTAN/SINOVAC,2536,1295,1241
Virgínia,317170,MG,Sudeste,BUTANTAN/SINOVAC,790,569,221
Virgínia,317170,MG,Sudeste,FIOCRUZ/ASTRAZENECA,91,69,22
Virginópolis,317180,MG,Sudeste,BUTANTAN/SINOVAC,1915,1167,748
Virginópolis,317180,MG,Sudeste,FIOCRUZ/ASTRAZENECA,1274,1215,59
Virgolândia,317190,MG,Sudeste,BUTANTAN/SINOVAC,1337,722,615
Virgolândia,317190,MG,Sudeste,FIOCRUZ/ASTRAZENECA,1104,987,117
Virgolândia,317190,MG,Sudeste,PFIZER/BIONTECH,55,55,0
Virmond,412865,PR,Sul,FIOCRUZ/ASTRAZENECA,1166,1104,62
Virmond,412865,PR,Sul,BUTANTAN/SINOVAC,761,405,356
Virmond,412865,PR,Sul,PFIZER/BIONTECH,23,23,0
Visconde Do Rio Branco,317200,MG,Sudeste,BUTANTAN/SINOVAC,9251,4880,4371
Visconde Do Rio Branco,317200,MG,Sudeste,FIOCRUZ/ASTRAZENECA,5568,5081,487
Visconde Do Rio Branco,317200,MG,Sudeste,PFIZER/BIONTECH,12,12,0
Viseu,150830,PA,Norte,FIOCRUZ/ASTRAZENECA,6312,5961,351
Viseu,150830,PA,Norte,BUTANTAN/SINOVAC,5141,2778,2363
Vista Alegre,432350,RS,Sul,BUTANTAN/SINOVAC,987,498,489
Vista Alegre,432350,RS,Sul,FIOCRUZ/ASTRAZENECA,753,698,55
Vista Alegre,432350,RS,Sul,PFIZER/BIONTECH,89,89,0
Vista Alegre Do Alto,355690,SP,Sudeste,BUTANTAN/SINOVAC,1389,743,646
Vista Alegre Do Alto,355690,SP,Sudeste,FIOCRUZ/ASTRAZENECA,1173,1052,121
Vista Alegre Do Alto,355690,SP,Sudeste,PFIZER/BIONTECH,176,176,0
Vista Alegre Do Prata,432360,RS,Sul,FIOCRUZ/ASTRAZENECA,531,441,90
Vista Alegre Do Prata,432360,RS,Sul,BUTANTAN/SINOVAC,520,261,259
Vista Alegre Do Prata,432360,RS,Sul,PFIZER/BIONTECH,52,52,0
Vista Gaúcha,432370,RS,Sul,BUTANTAN/SINOVAC,891,453,438
Vista Gaúcha,432370,RS,Sul,FIOCRUZ/ASTRAZENECA,777,721,56
Vista Gaúcha,432370,RS,Sul,PFIZER/BIONTECH,63,63,0
Vista Serrana,250550,PB,Nordeste,BUTANTAN/SINOVAC,814,426,388
Vista Serrana,250550,PB,Nordeste,FIOCRUZ/ASTRAZENECA,489,419,70
Vista Serrana,250550,PB,Nordeste,PFIZER/BIONTECH,14,14,0
Vitor Meireles,421935,SC,Sul,BUTANTAN/SINOVAC,1237,669,568
Vitor Meireles,421935,SC,Sul,FIOCRUZ/ASTRAZENECA,958,906,52
Vitor Meireles,421935,SC,Sul,PFIZER/BIONTECH,63,63,0
Vitória,320530,ES,Sudeste,BUTANTAN/SINOVAC,118894,60204,58690
Vitória,320530,ES,Sudeste,FIOCRUZ/ASTRAZENECA,101705,89164,12541
Vitória,320530,ES,Sudeste,PFIZER/BIONTECH,43767,43733,34
Vitória Brasil,355695,SP,Sudeste,BUTANTAN/SINOVAC,532,269,263
Vitória Brasil,355695,SP,Sudeste,FIOCRUZ/ASTRAZENECA,519,480,39
Vitória Brasil,355695,SP,Sudeste,PFIZER/BIONTECH,52,52,0
Vitória Da Conquista,293330,BA,Nordeste,BUTANTAN/SINOVAC,55728,29213,26515
Vitória Da Conquista,293330,BA,Nordeste,FIOCRUZ/ASTRAZENECA,48934,45928,3006
Vitória Da Conquista,293330,BA,Nordeste,PFIZER/BIONTECH,195,195,0
Vitória Das Missões,432375,RS,Sul,BUTANTAN/SINOVAC,1156,588,568
Vitória Das Missões,432375,RS,Sul,FIOCRUZ/ASTRAZENECA,849,793,56
Vitória Das Missões,432375,RS,Sul,PFIZER/BIONTECH,120,120,0
Vitória De Santo Antão,261640,PE,Nordeste,BUTANTAN/SINOVAC,24869,14148,10721
Vitória De Santo Antão,261640,PE,Nordeste,FIOCRUZ/ASTRAZENECA,21766,19803,1963
Vitória De Santo Antão,261640,PE,Nordeste,PFIZER/BIONTECH,1293,1290,3
Vitória Do Jari,160080,AP,Norte,FIOCRUZ/ASTRAZENECA,2153,2042,111
Vitória Do Jari,160080,AP,Norte,BUTANTAN/SINOVAC,1598,822,776
Vitória Do Jari,160080,AP,Norte,PFIZER/BIONTECH,509,509,0
Vitória Do Mearim,211290,MA,Nordeste,FIOCRUZ/ASTRAZENECA,7667,7305,362
Vitória Do Mearim,211290,MA,Nordeste,BUTANTAN/SINOVAC,4433,2324,2109
Vitória Do Xingu,150835,PA,Norte,FIOCRUZ/ASTRAZENECA,3509,3225,284
Vitória Do Xingu,150835,PA,Norte,BUTANTAN/SINOVAC,1718,995,723
Vitorino,412870,PR,Sul,BUTANTAN/SINOVAC,1514,769,745
Vitorino,412870,PR,Sul,FIOCRUZ/ASTRAZENECA,1445,1341,104
Vitorino,412870,PR,Sul,PFIZER/BIONTECH,36,36,0
Vitorino Freire,211300,MA,Nordeste,FIOCRUZ/ASTRAZENECA,5024,4638,386
Vitorino Freire,211300,MA,Nordeste,BUTANTAN/SINOVAC,4874,2579,2295
Volta Grande,317210,MG,Sudeste,BUTANTAN/SINOVAC,1199,620,579
Volta Grande,317210,MG,Sudeste,FIOCRUZ/ASTRAZENECA,848,788,60
Volta Redonda,330630,RJ,Sudeste,FIOCRUZ/ASTRAZENECA,70551,65131,5420
Volta Redonda,330630,RJ,Sudeste,BUTANTAN/SINOVAC,65394,33857,31537
Volta Redonda,330630,RJ,Sudeste,PFIZER/BIONTECH,9167,9160,7
Votorantim,355700,SP,Sudeste,BUTANTAN/SINOVAC,20436,10761,9675
Votorantim,355700,SP,Sudeste,FIOCRUZ/ASTRAZENECA,19257,17510,1747
Votorantim,355700,SP,Sudeste,PFIZER/BIONTECH,2815,2810,5
Votuporanga,355710,SP,Sudeste,BUTANTAN/SINOVAC,27520,15015,12505
Votuporanga,355710,SP,Sudeste,FIOCRUZ/ASTRAZENECA,23648,21696,1952
Votuporanga,355710,SP,Sudeste,PFIZER/BIONTECH,1470,1469,1
Wagner,293340,BA,Nordeste,FIOCRUZ/ASTRAZENECA,1919,1679,240
Wagner,293340,BA,Nordeste,BUTANTAN/SINOVAC,1902,972,930
Wagner,293340,BA,Nordeste,PFIZER/BIONTECH,105,105,0
Wall Ferraz,221170,PI,Nordeste,FIOCRUZ/ASTRAZENECA,1117,1031,86
Wall Ferraz,221170,PI,Nordeste,BUTANTAN/SINOVAC,695,379,316
Wanderlândia,172208,TO,Norte,BUTANTAN/SINOVAC,1803,932,871
Wanderlândia,172208,TO,Norte,FIOCRUZ/ASTRAZENECA,1386,1332,54
Wanderley,293345,BA,Nordeste,FIOCRUZ/ASTRAZENECA,2216,2115,101
Wanderley,293345,BA,Nordeste,BUTANTAN/SINOVAC,1878,1038,840
Wenceslau Braz,317220,MG,Sudeste,FIOCRUZ/ASTRAZENECA,755,703,52
Wenceslau Braz,317220,MG,Sudeste,BUTANTAN/SINOVAC,677,344,333
Wenceslau Braz,317220,MG,Sudeste,PFIZER/BIONTECH,30,30,0
Wenceslau Braz,412850,PR,Sul,FIOCRUZ/ASTRAZENECA,5059,4749,310
Wenceslau Braz,412850,PR,Sul,BUTANTAN/SINOVAC,4239,2174,2065
Wenceslau Braz,412850,PR,Sul,PFIZER/BIONTECH,1,1,0
Wenceslau Guimarães,293350,BA,Nordeste,FIOCRUZ/ASTRAZENECA,3559,3368,191
Wenceslau Guimarães,293350,BA,Nordeste,BUTANTAN/SINOVAC,3110,1756,1354
Wenceslau Guimarães,293350,BA,Nordeste,PFIZER/BIONTECH,190,190,0
Westfalia,432377,RS,Sul,BUTANTAN/SINOVAC,882,449,433
Westfalia,432377,RS,Sul,FIOCRUZ/ASTRAZENECA,759,655,104
Westfalia,432377,RS,Sul,PFIZER/BIONTECH,124,124,0
Witmarsum,421940,SC,Sul,FIOCRUZ/ASTRAZENECA,1036,928,108
Witmarsum,421940,SC,Sul,BUTANTAN/SINOVAC,773,420,353
Witmarsum,421940,SC,Sul,PFIZER/BIONTECH,101,101,0
Xambioá,172210,TO,Norte,FIOCRUZ/ASTRAZENECA,2369,2265,104
Xambioá,172210,TO,Norte,BUTANTAN/SINOVAC,1916,998,918
Xambrê,412880,PR,Sul,FIOCRUZ/ASTRAZENECA,1594,1468,126
Xambrê,412880,PR,Sul,BUTANTAN/SINOVAC,1568,811,757
Xambrê,412880,PR,Sul,PFIZER/BIONTECH,27,27,0
Xangri-Lá,432380,RS,Sul,BUTANTAN/SINOVAC,3918,2009,1909
Xangri-Lá,432380,RS,Sul,FIOCRUZ/ASTRAZENECA,3364,3162,202
Xangri-Lá,432380,RS,Sul,PFIZER/BIONTECH,309,309,0
Xanxerê,421950,SC,Sul,FIOCRUZ/ASTRAZENECA,11342,10331,1011
Xanxerê,421950,SC,Sul,BUTANTAN/SINOVAC,9208,4919,4289
Xanxerê,421950,SC,Sul,PFIZER/BIONTECH,591,591,0
Xapuri,120070,AC,Norte,BUTANTAN/SINOVAC,3668,2098,1570
Xapuri,120070,AC,Norte,FIOCRUZ/ASTRAZENECA,2011,1754,257
Xavantina,421960,SC,Sul,BUTANTAN/SINOVAC,1148,592,556
Xavantina,421960,SC,Sul,FIOCRUZ/ASTRAZENECA,1061,963,98
Xavantina,421960,SC,Sul,PFIZER/BIONTECH,100,100,0
Xaxim,421970,SC,Sul,BUTANTAN/SINOVAC,6206,3174,3032
Xaxim,421970,SC,Sul,FIOCRUZ/ASTRAZENECA,3939,3816,123
Xaxim,421970,SC,Sul,PFIZER/BIONTECH,224,224,0
Xexéu,261650,PE,Nordeste,BUTANTAN/SINOVAC,2027,1080,947
Xexéu,261650,PE,Nordeste,FIOCRUZ/ASTRAZENECA,1651,1534,117
Xexéu,261650,PE,Nordeste,PFIZER/BIONTECH,182,182,0
Xinguara,150840,PA,Norte,FIOCRUZ/ASTRAZENECA,6817,5289,1528
Xinguara,150840,PA,Norte,BUTANTAN/SINOVAC,4558,2434,2124
Xique-Xique,293360,BA,Nordeste,BUTANTAN/SINOVAC,6224,3671,2553
Xique-Xique,293360,BA,Nordeste,FIOCRUZ/ASTRAZENECA,2928,2926,2
Zabelê,251740,PB,Nordeste,BUTANTAN/SINOVAC,553,277,276
Zabelê,251740,PB,Nordeste,FIOCRUZ/ASTRAZENECA,430,386,44
Zabelê,251740,PB,Nordeste,PFIZER/BIONTECH,41,41,0
Zacarias,355715,SP,Sudeste,FIOCRUZ/ASTRAZENECA,790,723,67
Zacarias,355715,SP,Sudeste,BUTANTAN/SINOVAC,677,319,358
Zacarias,355715,SP,Sudeste,PFIZER/BIONTECH,72,72,0
Zé Doca,211400,MA,Nordeste,FIOCRUZ/ASTRAZENECA,10935,10467,468
Zé Doca,211400,MA,Nordeste,BUTANTAN/SINOVAC,7192,3661,3531
Zé Doca,211400,MA,Nordeste,PFIZER/BIONTECH,1908,1908,0
Zortéa,421985,SC,Sul,BUTANTAN/SINOVAC,1017,593,424
Zortéa,421985,SC,Sul,FIOCRUZ/ASTRAZENECA,721,682,39
Zortéa,421985,SC,Sul,PFIZER/BIONTECH,42,42,0
-,110000,RO,Norte,-,0,0,0
-,120000,AC,Norte,-,0,0,0
-,130000,AM,Norte,-,0,0,0
-,140000,RR,Norte,-,0,0,0
-,150000,PA,Norte,-,0,0,0
-,160000,AP,Norte,-,0,0,0
-,170000,TO,Norte,-,0,0,0
-,210000,MA,Nordeste,-,0,0,0
-,220000,PI,Nordeste,-,0,0,0
-,230000,CE,Nordeste,-,0,0,0
-,240000,RN,Nordeste,-,0,0,0
-,250000,PB,Nordeste,-,0,0,0
-,260000,PE,Nordeste,-,0,0,0
-,270000,AL,Nordeste,-,0,0,0
-,280000,SE,Nordeste,-,0,0,0
-,290000,BA,Nordeste,-,0,0,0
-,310000,MG,Sudeste,-,0,0,0
-,320000,ES,Sudeste,-,0,0,0
-,330000,RJ,Sudeste,-,0,0,0
-,350000,SP,Sudeste,-,0,0,0
-,410000,PR,Sul,-,0,0,0
-,420000,SC,Sul,-,0,0,0
-,430000,RS,Sul,-,0,0,0
-,500000,MS,Centro-Oeste,-,0,0,0
-,510000,MT,Centro-Oeste,-,0,0,0
-,520000,GO,Centro-Oeste,-,0,0,0
-,530000,DF,Centro-Oeste,-,0,0,0
